"aa" = (/turf/unsimulated/wall,/area/tranquility/walls1)
"ab" = (/turf/unsimulated/wall{tag = "icon-rock-dark"; icon_state = "rock-dark"},/area/tranquility/walls1)
"ac" = (/turf/space,/area/space)
"ad" = (/obj/effect/landmark/test/space_turf,/turf/space,/area/space)
"ae" = (/turf/unsimulated/wall,/area/tranquility/shaft)
"af" = (/obj/structure/sign/deck/fourth,/turf/unsimulated/wall,/area/tranquility/shaft)
"ag" = (/turf/simulated/open,/area/tranquility/shaft)
"ah" = (/obj/machinery/light/spot{dir = 1},/turf/simulated/open,/area/tranquility/shaft)
"ai" = (/obj/structure/lattice,/turf/simulated/open,/area/tranquility/shaft)
"aj" = (/turf/unsimulated/mask,/area/turbolift/tranquility_level4)
"ak" = (/obj/structure/lattice,/turf/unsimulated/mask,/area/turbolift/tranquility_level4)
"al" = (/turf/unsimulated/wall,/area/tranquility/infirmary)
"am" = (/turf/unsimulated/wall{tag = "icon-0"; icon_state = "0"},/area/tranquility/maint4)
"an" = (/turf/unsimulated/wall,/area/tranquility/maint2)
"ao" = (/obj/structure/table/standard,/obj/item/weapon/storage/firstaid/toxin,/turf/simulated/floor/tiled/white,/area/tranquility/infirmary)
"ap" = (/obj/structure/table/standard,/obj/effect/decal/cleanable/dirt,/obj/item/weapon/storage/firstaid/erk,/turf/simulated/floor/tiled/white,/area/tranquility/infirmary)
"aq" = (/obj/structure/table/standard,/obj/item/weapon/storage/firstaid/regular,/obj/machinery/light{dir = 1},/turf/simulated/floor/tiled/white,/area/tranquility/infirmary)
"ar" = (/obj/structure/table/standard,/obj/item/roller,/obj/item/roller,/turf/simulated/floor/tiled/white,/area/tranquility/infirmary)
"as" = (/obj/effect/decal/cleanable/dirt,/turf/unsimulated/floor{tag = "icon-plating"; icon_state = "plating"},/area/tranquility/maint4)
"at" = (/turf/unsimulated/floor{tag = "icon-plating"; icon_state = "plating"},/area/tranquility/maint4)
"au" = (/obj/effect/decal/cleanable/cobweb2,/turf/unsimulated/floor{tag = "icon-plating"; icon_state = "plating"},/area/tranquility/maint4)
"av" = (/obj/effect/decal/cleanable/dirt,/turf/unsimulated/floor{tag = "icon-plating"; icon_state = "plating"},/area/tranquility/maint2)
"aw" = (/turf/unsimulated/floor{tag = "icon-plating"; icon_state = "plating"},/area/tranquility/maint2)
"ax" = (/obj/structure/closet/secure_closet/paramedic,/turf/simulated/floor/tiled/white,/area/tranquility/infirmary)
"ay" = (/obj/effect/decal/cleanable/dirt,/turf/simulated/floor/tiled/white,/area/tranquility/infirmary)
"az" = (/turf/simulated/floor/tiled/white,/area/tranquility/infirmary)
"aA" = (/obj/structure/closet/medical_wall/filled,/turf/unsimulated/wall,/area/tranquility/infirmary)
"aB" = (/obj/structure/sign/halo_floorsign/maint{tag = "icon-maint (EAST)"; icon_state = "maint"; dir = 4},/turf/unsimulated/floor{tag = "icon-plating"; icon_state = "plating"},/area/tranquility/maint4)
"aC" = (/obj/structure/ladder,/turf/unsimulated/floor{tag = "icon-plating"; icon_state = "plating"},/area/tranquility/maint4)
"aD" = (/obj/effect/decal/cleanable/dirt,/obj/machinery/light/small{dir = 4},/turf/unsimulated/floor{tag = "icon-plating"; icon_state = "plating"},/area/tranquility/maint4)
"aE" = (/obj/structure/ladder,/turf/unsimulated/floor{tag = "icon-plating"; icon_state = "plating"},/area/tranquility/maint2)
"aF" = (/obj/machinery/light/spot{dir = 8},/turf/simulated/open,/area/tranquility/shaft)
"aG" = (/obj/machinery/light/spot{dir = 4},/turf/simulated/open,/area/tranquility/shaft)
"aH" = (/obj/effect/decal/cleanable/dirt,/obj/machinery/vending/medical,/turf/simulated/floor/tiled/white,/area/tranquility/infirmary)
"aI" = (/obj/machinery/vending/wallmed1,/turf/unsimulated/wall,/area/tranquility/infirmary)
"aJ" = (/obj/structure/sign/halo_floorsign/maint{tag = "icon-maint (NORTH)"; icon_state = "maint"; dir = 1},/turf/unsimulated/floor{tag = "icon-plating"; icon_state = "plating"},/area/tranquility/maint2)
"aK" = (/obj/effect/decal/cleanable/dirt,/obj/structure/closet/secure_closet/medical3,/obj/machinery/light{dir = 8},/turf/simulated/floor/tiled/white,/area/tranquility/infirmary)
"aL" = (/obj/machinery/space_heater,/turf/simulated/floor/tiled/white,/area/tranquility/infirmary)
"aM" = (/turf/unsimulated/wall,/area/tranquility/halls1)
"aN" = (/obj/machinery/vending/wallmed1,/turf/unsimulated/wall,/area/tranquility/halls1)
"aO" = (/obj/machinery/door/airlock/halo_maint,/turf/unsimulated/floor{tag = "icon-plating"; icon_state = "plating"},/area/tranquility/maint2)
"aP" = (/obj/structure/sign/warning/moving_parts,/turf/simulated/wall/r_wall,/area/tranquility/shaft)
"aQ" = (/obj/effect/decal/cleanable/dirt,/obj/effect/floor_decal/industrial/warning{icon_state = "warning"; dir = 1},/turf/unsimulated/floor{tag = "icon-dark"; icon_state = "dark"},/area/tranquility/halls1)
"aR" = (/obj/effect/floor_decal/industrial/warning{icon_state = "warning"; dir = 1},/turf/unsimulated/floor{tag = "icon-dark"; icon_state = "dark"},/area/tranquility/halls1)
"aS" = (/obj/structure/sign/warning/fall,/turf/unsimulated/wall,/area/tranquility/shaft)
"aT" = (/obj/structure/grille,/obj/structure/window/reinforced/full,/turf/simulated/floor/plating,/area/tranquility/infirmary)
"aU" = (/obj/machinery/door/airlock/halo_lifepod,/turf/unsimulated/floor{tag = "icon-plating"; icon_state = "plating"},/area/tranquility/infirmary)
"aV" = (/obj/structure/sign/bluecross_2,/turf/simulated/wall/r_wall,/area/tranquility/infirmary)
"aW" = (/turf/unsimulated/wall,/area/tranquility/maint4)
"aX" = (/turf/unsimulated/floor{tag = "icon-dark"; icon_state = "dark"},/area/tranquility/halls1)
"aY" = (/obj/effect/decal/cleanable/dirt,/turf/unsimulated/floor{tag = "icon-dark"; icon_state = "dark"},/area/tranquility/halls1)
"aZ" = (/obj/effect/floor_decal/industrial/warning{dir = 4},/turf/unsimulated/floor{tag = "icon-dark"; icon_state = "dark"},/area/tranquility/halls1)
"ba" = (/obj/effect/floor_decal/industrial/warning{dir = 8},/turf/unsimulated/floor{tag = "icon-dark"; icon_state = "dark"},/area/tranquility/halls1)
"bb" = (/obj/effect/floor_decal/sign/m,/turf/unsimulated/floor{tag = "icon-dark"; icon_state = "dark"},/area/tranquility/halls1)
"bc" = (/obj/machinery/door/airlock/halo_maint,/turf/unsimulated/floor{tag = "icon-plating"; icon_state = "plating"},/area/tranquility/maint4)
"bd" = (/turf/unsimulated/wall{tag = "icon-0"; icon_state = "0"},/area/tranquility/maint3)
"be" = (/obj/machinery/light,/turf/unsimulated/floor{tag = "icon-dark"; icon_state = "dark"},/area/tranquility/halls1)
"bf" = (/obj/effect/decal/cleanable/dirt,/obj/machinery/light,/turf/unsimulated/floor{tag = "icon-dark"; icon_state = "dark"},/area/tranquility/halls1)
"bg" = (/turf/unsimulated/floor{tag = "icon-plating"; icon_state = "plating"},/area/tranquility/maint3)
"bh" = (/obj/machinery/light/small/red{tag = "icon-bulb1 (NORTH)"; icon_state = "bulb1"; dir = 1},/turf/unsimulated/floor{tag = "icon-plating"; icon_state = "plating"},/area/tranquility/maint3)
"bi" = (/obj/effect/decal/cleanable/cobweb2,/turf/unsimulated/floor{tag = "icon-plating"; icon_state = "plating"},/area/tranquility/maint3)
"bj" = (/turf/unsimulated/wall{tag = "icon-0"; icon_state = "0"},/area/tranquility/maint1)
"bk" = (/turf/unsimulated/wall,/area/tranquility/maint1)
"bl" = (/obj/machinery/door/airlock/halo_maint,/turf/unsimulated/floor{tag = "icon-plating"; icon_state = "plating"},/area/tranquility/maint1)
"bm" = (/obj/structure/extinguisher_cabinet,/turf/unsimulated/wall,/area/tranquility/halls1)
"bn" = (/turf/unsimulated/wall,/area/tranquility/janitor)
"bo" = (/obj/structure/sign/halo_floorsign/cargobay{tag = "icon-cargobay (NORTH)"; icon_state = "cargobay"; dir = 1},/turf/unsimulated/floor{tag = "icon-dark"; icon_state = "dark"},/area/tranquility/halls1)
"bp" = (/obj/effect/decal/cleanable/dirt,/turf/unsimulated/floor{tag = "icon-plating"; icon_state = "plating"},/area/tranquility/maint3)
"bq" = (/obj/structure/ladder,/turf/unsimulated/floor{tag = "icon-plating"; icon_state = "plating"},/area/tranquility/maint3)
"br" = (/obj/effect/decal/cleanable/dirt,/turf/unsimulated/floor{tag = "icon-plating"; icon_state = "plating"},/area/tranquility/maint1)
"bs" = (/turf/unsimulated/floor{tag = "icon-plating"; icon_state = "plating"},/area/tranquility/maint1)
"bt" = (/obj/structure/mopbucket,/obj/effect/decal/cleanable/cobweb,/obj/item/weapon/mop,/turf/unsimulated/floor{tag = "icon-dark"; icon_state = "dark"},/area/tranquility/janitor)
"bu" = (/obj/structure/toilet,/turf/unsimulated/floor{tag = "icon-dark"; icon_state = "dark"},/area/tranquility/janitor)
"bv" = (/obj/machinery/light{dir = 8},/turf/unsimulated/floor{tag = "icon-dark"; icon_state = "dark"},/area/tranquility/halls1)
"bw" = (/obj/structure/sign/halo_floorsign/maint{tag = "icon-maint (NORTH)"; icon_state = "maint"; dir = 1},/turf/unsimulated/floor{tag = "icon-plating"; icon_state = "plating"},/area/tranquility/maint3)
"bx" = (/turf/unsimulated/wall,/area/tranquility/armory2)
"by" = (/obj/effect/decal/cleanable/generic,/obj/machinery/light/small{dir = 8},/turf/unsimulated/floor{tag = "icon-dark"; icon_state = "dark"},/area/tranquility/janitor)
"bz" = (/obj/structure/sink{dir = 4; icon_state = "sink"; pixel_x = 10; tag = "icon-sink (EAST)"},/turf/unsimulated/floor{tag = "icon-dark"; icon_state = "dark"},/area/tranquility/janitor)
"bA" = (/obj/structure/mirror,/turf/unsimulated/wall,/area/tranquility/janitor)
"bB" = (/obj/structure/sign/directions/supply{tag = "icon-direction_supply (NORTH)"; icon_state = "direction_supply"; dir = 1},/turf/unsimulated/wall,/area/tranquility/janitor)
"bC" = (/obj/effect/decal/cleanable/blood/oil,/turf/unsimulated/floor{tag = "icon-dark"; icon_state = "dark"},/area/tranquility/halls1)
"bD" = (/obj/structure/sign/directions/infirmary{tag = "icon-direction_infirm (EAST)"; icon_state = "direction_infirm"; dir = 4},/turf/unsimulated/wall,/area/tranquility/halls1)
"bE" = (/obj/effect/decal/cleanable/cobweb,/turf/unsimulated/floor{tag = "icon-plating"; icon_state = "plating"},/area/tranquility/maint1)
"bF" = (/obj/structure/table/rack,/obj/item/weapon/gun/projectile/m6d_magnum,/obj/effect/decal/cleanable/cobweb,/turf/unsimulated/floor{tag = "icon-dark"; icon_state = "dark"},/area/tranquility/armory2)
"bG" = (/obj/structure/table/rack,/obj/item/weapon/gun/projectile/m6d_magnum,/turf/unsimulated/floor{tag = "icon-dark"; icon_state = "dark"},/area/tranquility/armory2)
"bH" = (/obj/structure/table/rack,/obj/item/weapon/gun/projectile/ma5b_ar/MA37,/obj/effect/decal/cleanable/dirt,/turf/unsimulated/floor{tag = "icon-dark"; icon_state = "dark"},/area/tranquility/armory2)
"bI" = (/turf/unsimulated/wall,/area/tranquility/checkpoint)
"bJ" = (/obj/machinery/door/airlock/halo,/turf/unsimulated/floor{tag = "icon-plating"; icon_state = "plating"},/area/tranquility/checkpoint)
"bK" = (/obj/structure/extinguisher_cabinet,/turf/unsimulated/wall,/area/tranquility/checkpoint)
"bL" = (/obj/effect/decal/cleanable/cobweb,/turf/unsimulated/floor{tag = "icon-plating"; icon_state = "plating"},/area/tranquility/maint3)
"bM" = (/turf/unsimulated/wall{tag = "icon-rock-dark"; icon_state = "rock-dark"},/area/tranquility/maint3)
"bN" = (/obj/structure/sign/halo_floorsign/maint{tag = "icon-maint (EAST)"; icon_state = "maint"; dir = 4},/turf/unsimulated/floor{tag = "icon-plating"; icon_state = "plating"},/area/tranquility/maint1)
"bO" = (/obj/structure/ladder,/turf/unsimulated/floor{tag = "icon-plating"; icon_state = "plating"},/area/tranquility/maint1)
"bP" = (/obj/machinery/light/small{dir = 4},/turf/unsimulated/floor{tag = "icon-plating"; icon_state = "plating"},/area/tranquility/maint1)
"bQ" = (/obj/machinery/light{dir = 8},/turf/unsimulated/floor{tag = "icon-dark"; icon_state = "dark"},/area/tranquility/armory2)
"bR" = (/obj/effect/decal/cleanable/dirt,/turf/unsimulated/floor{tag = "icon-dark"; icon_state = "dark"},/area/tranquility/armory2)
"bS" = (/obj/machinery/door/airlock/halo_lifepod,/turf/unsimulated/floor{tag = "icon-plating"; icon_state = "plating"},/area/tranquility/checkpoint)
"bT" = (/turf/unsimulated/floor{tag = "icon-steel"; icon_state = "steel"},/area/tranquility/checkpoint)
"bU" = (/obj/machinery/light{dir = 4; icon_state = "tube1"},/turf/unsimulated/floor{tag = "icon-dark"; icon_state = "dark"},/area/tranquility/halls1)
"bV" = (/obj/machinery/light/small/red{tag = "icon-bulb1 (WEST)"; icon_state = "bulb1"; dir = 8},/turf/unsimulated/floor{tag = "icon-plating"; icon_state = "plating"},/area/tranquility/maint3)
"bW" = (/obj/structure/sign/halo_floorsign/maint{tag = "icon-maint (WEST)"; icon_state = "maint"; dir = 8},/turf/unsimulated/floor{tag = "icon-plating"; icon_state = "plating"},/area/tranquility/maint3)
"bX" = (/obj/structure/table/rack,/obj/item/ammo_magazine/m127_saphe,/obj/item/ammo_magazine/m127_saphe,/turf/unsimulated/floor{tag = "icon-dark"; icon_state = "dark"},/area/tranquility/armory2)
"bY" = (/obj/structure/table/rack,/obj/item/ammo_magazine/m762_ap/MA37,/obj/item/ammo_magazine/m762_ap/MA37,/turf/unsimulated/floor{tag = "icon-dark"; icon_state = "dark"},/area/tranquility/armory2)
"bZ" = (/obj/structure/filingcabinet/chestdrawer,/turf/unsimulated/floor{tag = "icon-steel"; icon_state = "steel"},/area/tranquility/checkpoint)
"ca" = (/obj/effect/decal/cleanable/dirt,/turf/unsimulated/floor{tag = "icon-steel"; icon_state = "steel"},/area/tranquility/checkpoint)
"cb" = (/obj/structure/grille,/obj/structure/window/reinforced/full,/turf/simulated/floor/plating,/area/tranquility/checkpoint)
"cc" = (/obj/machinery/vending/security,/turf/unsimulated/floor{tag = "icon-steel"; icon_state = "steel"},/area/tranquility/checkpoint)
"cd" = (/obj/structure/filingcabinet/security,/obj/machinery/light{dir = 4; icon_state = "tube1"},/turf/unsimulated/floor{tag = "icon-steel"; icon_state = "steel"},/area/tranquility/checkpoint)
"ce" = (/obj/machinery/door/blast/regular/triple{id = 2},/turf/unsimulated/floor{tag = "icon-dark"; icon_state = "dark"},/area/tranquility/entrance)
"cf" = (/obj/effect/decal/cleanable/dirt,/turf/unsimulated/floor{tag = "icon-dark"; icon_state = "dark"},/area/tranquility/entrance)
"cg" = (/turf/unsimulated/wall,/area/tranquility/entrance)
"ch" = (/turf/unsimulated/wall{tag = "icon-0"; icon_state = "0"},/area/tranquility/maint2)
"ci" = (/obj/machinery/space_heater,/obj/machinery/light{dir = 8},/turf/unsimulated/floor{tag = "icon-steel"; icon_state = "steel"},/area/tranquility/checkpoint)
"cj" = (/obj/structure/bed/chair{tag = "icon-chair_preview (EAST)"; icon_state = "chair_preview"; dir = 4},/turf/unsimulated/floor{tag = "icon-steel"; icon_state = "steel"},/area/tranquility/checkpoint)
"ck" = (/obj/machinery/door/window/eastleft,/obj/structure/table/steel,/obj/item/weapon/paper_bin,/obj/item/weapon/pen/red,/turf/simulated/floor/plating,/area/tranquility/checkpoint)
"cl" = (/turf/unsimulated/floor{tag = "icon-dark"; icon_state = "dark"},/area/tranquility/entrance)
"cm" = (/obj/machinery/light{dir = 4; icon_state = "tube1"},/turf/unsimulated/floor{tag = "icon-dark"; icon_state = "dark"},/area/tranquility/entrance)
"cn" = (/obj/structure/grille/broken,/turf/unsimulated/floor{tag = "icon-plating"; icon_state = "plating"},/area/tranquility/maint3)
"co" = (/turf/unsimulated/wall{tag = "icon-rock-dark"; icon_state = "rock-dark"},/area/tranquility/maint2)
"cp" = (/obj/machinery/vending/cigarette,/turf/unsimulated/floor{tag = "icon-steel"; icon_state = "steel"},/area/tranquility/checkpoint)
"cq" = (/obj/machinery/door/window/eastright,/obj/structure/table/steel,/obj/effect/decal/cleanable/generic,/turf/simulated/floor/plating,/area/tranquility/checkpoint)
"cr" = (/obj/machinery/vending/wallmed1,/turf/unsimulated/wall,/area/tranquility/entrance)
"cs" = (/obj/structure/sign/halo_floorsign/maint{tag = "icon-maint (EAST)"; icon_state = "maint"; dir = 4},/turf/unsimulated/floor{tag = "icon-plating"; icon_state = "plating"},/area/tranquility/maint2)
"ct" = (/obj/machinery/light/small/red{tag = "icon-bulb1 (EAST)"; icon_state = "bulb1"; dir = 4},/turf/unsimulated/floor{tag = "icon-plating"; icon_state = "plating"},/area/tranquility/maint2)
"cu" = (/obj/structure/reagent_dispensers/peppertank,/turf/unsimulated/wall,/area/tranquility/checkpoint)
"cv" = (/obj/machinery/recharger/wallcharger,/turf/unsimulated/wall,/area/tranquility/checkpoint)
"cw" = (/obj/machinery/button/remote/blast_door{id = 2},/turf/unsimulated/wall,/area/tranquility/checkpoint)
"cx" = (/obj/machinery/light{dir = 8},/turf/unsimulated/floor{tag = "icon-dark"; icon_state = "dark"},/area/tranquility/entrance)
"cy" = (/obj/machinery/door/blast/regular/triple,/obj/effect/decal/cleanable/dirt,/turf/unsimulated/floor{tag = "icon-plating"; icon_state = "plating"},/area/tranquility/entrance)
"cz" = (/turf/unsimulated/floor{tag = "icon-plating"; icon_state = "plating"},/area/tranquility/entrance)
"cA" = (/obj/effect/decal/cleanable/dirt,/turf/unsimulated/floor{tag = "icon-plating"; icon_state = "plating"},/area/tranquility/entrance)
"cB" = (/obj/structure/sign/warning/secure_area,/turf/unsimulated/wall,/area/tranquility/entrance)
"cC" = (/obj/machinery/light/small/red{tag = "icon-bulb1 (WEST)"; icon_state = "bulb1"; dir = 8},/turf/unsimulated/floor{tag = "icon-plating"; icon_state = "plating"},/area/tranquility/entrance)
"cD" = (/obj/machinery/button/remote/blast_door{id = 1},/turf/unsimulated/wall,/area/tranquility/entrance)
"cE" = (/turf/unsimulated/wall{tag = "icon-rock-dark"; icon_state = "rock-dark"},/area/tranquility/entrance)
"cF" = (/obj/effect/decal/cleanable/cobweb2,/obj/effect/decal/cleanable/dirt,/turf/unsimulated/floor{tag = "icon-plating"; icon_state = "plating"},/area/tranquility/maint2)
"cG" = (/obj/structure/sign/halo_floorsign/maint,/turf/unsimulated/floor{tag = "icon-plating"; icon_state = "plating"},/area/tranquility/maint3)
"cH" = (/obj/structure/sign/warning/hot_exhaust,/turf/unsimulated/wall{tag = "icon-rock-dark"; icon_state = "rock-dark"},/area/tranquility/maint3)
"cI" = (/obj/structure/sign/warning/high_voltage,/turf/unsimulated/wall{tag = "icon-rock-dark"; icon_state = "rock-dark"},/area/tranquility/maint2)
"cJ" = (/obj/effect/floor_decal/snow,/turf/unsimulated/floor{tag = "icon-plating"; icon_state = "plating"},/area/tranquility/entrance)
"cK" = (/obj/effect/decal/cleanable/dirt,/obj/machinery/light/small/red,/turf/unsimulated/floor{tag = "icon-plating"; icon_state = "plating"},/area/tranquility/maint3)
"cL" = (/obj/structure/grille,/turf/unsimulated/floor{tag = "icon-plating"; icon_state = "plating"},/area/tranquility/maint2)
"cM" = (/turf/unsimulated/floor{tag = "icon-snow"; icon_state = "snow"},/area/tranquility/outside)
"cN" = (/turf/unsimulated/floor{tag = "icon-snow"; icon_state = "snow"},/area/tranquility/random2)
"cO" = (/obj/structure/grille,/obj/effect/decal/cleanable/dirt,/turf/unsimulated/floor{tag = "icon-plating"; icon_state = "plating"},/area/tranquility/maint3)
"cP" = (/obj/effect/landmark/drop_pod_landing,/turf/unsimulated/floor{tag = "icon-snow"; icon_state = "snow"},/area/tranquility/random2)
"cQ" = (/obj/effect/landmark/drop_pod_landing,/turf/unsimulated/floor{tag = "icon-snow"; icon_state = "snow"},/area/tranquility/outside)
"cR" = (/obj/effect/landmark/test/safe_turf,/turf/unsimulated/floor{tag = "icon-snow"; icon_state = "snow"},/area/tranquility/outside)
"cS" = (/obj/effect/landmark/map_data{height = 4},/turf/unsimulated/floor{tag = "icon-snow"; icon_state = "snow"},/area/tranquility/outside)

(1,1,1) = {"
aaaaaaaaaaababababababababababababababababababababababababababababababababababababababababababababab
aaacacacaaababababababababababababababababababababababababababababababababababababababababababababab
aaacadacaaabababababababababababaeaeaeaeaeafaeaeaeaeaeababababababababababababababababababababababab
aaacacacaaabababababababababababaeagagagahaiahagagagaeababababababababababababababababababababababab
aaaaaaaaaaabababababababababababaeagagajajakajajagagaealalalalalabababababamamamamamabababababababab
ababababababababababababananananaeagagajajajajajagagaeaoapaqaralamamamamamamasatauamabababababababab
ababababababababababababanavavawaeaiaiakajajajakaiaiaeaxayazazaAamatatasasataBaCaDamabababababababab
ababababababababababababanawaEavaeaFagajajajajajagaGaeaHayayayaIamasamamamamatatasamabababababababab
ababababababababababababanawaJavaeagagajajajajajagagaeaKazazaLalamasamababamamamamamabababababababab
abababababaMaMaNaMaMaMaMananaOanaeaeaPaeaQaQaRaeaSaeaeaTaTaUaValaWasamababababababababababababababab
abababababaMaXaYaYaXaXaYaXaXaXaYaXaYaYaZaYaYaYbaaXaXaXaYaYaYaXbbbcatamababababababababbdbdbdbdbdabab
abababababaMaXbbbeaXaYaYaXbfaYaYaYaYbeaZaXaXaXbaaXbeaXaYaXaXbeaXaWamamababababababababbdbgbhbibdabab
ababababbjbkbkblbkaMaMbmaMaMaMbnbnbnbnbnboaXboaMaMaMaMaMaMaNaMbmaMababababababababababbdbpbqbpbdabab
ababababbjbrbsbsbjababababababbnbtbubnbnbvaXaXaMabababababababababababababababababababbdbgbwbpbdabab
ababababbjbrbjbjbjbjbxbxbxbxbxbnbybzbAbBaXaYbCbDabbdbdbdbdbdabababababababababababababbdbdbgbdbdabab
ababababbjbrbjbEbrbrbxbFbGbHbIbIbJbIbKbIaXaYaYaMabbdbLbgbgbdbMbMbMbMbMabababbMbMbMbMbMbMbMbpbMababab
ababababbjbsbsbNbObPbxbQbRbRbSbTbTbTbTbJaXaYbUaMabbdbVbqbWbgbpbpbgbibMabababbMbLbpbpbgbgbpbpbMababab
ababababbjbjbjbrbrbsbxbXbXbYbIbZbTcabTcbaYaYaXaMabbdbgbpbpbdbMbMbMbgbMabababbMbgbMbMbMbMbMbMbMababab
ababababababbjbjbjbjbxbxbxbxbIccbTcacdbIcecfcfcgabbdbdbdbdbdababbMbgbMbMbMbMbMbgbMababababababababab
abababababchchchchchababababbIcicabTcjckclcfcmcgababababababababbMbgbgbpbpbpcnbgbMababababababababab
abcocococochavavavchababababbIcpbTbTcjcqcfcfcfcrababababababababbMbMbMcnbMbMbMbgbMbMbMababababababab
abcoavawawawcsaEctchababababbIbIcucvcwbIcxcfcfcgababababababababababbMbgbMabbMbpbpbibMababababababab
abcoavcocochawavawchabababababababababcgcyczcAcgababababababababababbMbpbMabbMbMbMbgbMababababababab
abcoavcoabchchchchchabababababababababcBcCcAczcDababababababababababbMbpbMabababbMbpbMbMbMbMbMababab
abcoawcoabababababababababababababababcEczcAcAcEababababababababababbMbgbMabababbMbpbgbpbpbpbMababab
abcoawcococoabababababababababababababcEcAcAcAcEabababababababababbdbdbgbdbdababbMbMbMbMbMbgbMababab
abcoavavcFcoabababababababababababababcEcAczcAcEabababababababababbdbLcGbgbdababababababbMbgcHbMabab
abcococoawcocIcoabababababababababababcEczczczcEabababababababababbdbgbqbpbdababababababbMbpbibMabab
ababcocoavavcFcoabababababababababababcEcJcJcJcEabababababababababbdbgcKbpbdababababababbMbMbgbMabab
abababcococoavcoabababababababababababcEcJcJcJcEabababababababababbdbdbdbdbdabababababababbMbpbMabab
ababababcococLcoabababababababababcMcMcMcMcMcMabcNabcNcNabababababababababababababababababbMbpbMabab
ababababababcMcMcMababababababcMcMcMcMcMcMcMcMcNcNcNcNcNcNababababababababcNcNababababababbMcObMabab
ababcMcMcMcMcMcMcMcMcMcMcMcMcMcMcMcMcMcMcMcMcMcNcNcNcNcNcNcNababababababcNcNcNcNababababcNcNcNcNabab
cMcMcMcMcMcMcMcMcMcMcMcMcMcMcMcMcMcMcMcMcMcMcMcNcNcNcNcNcNcNcNcNcNcNcNcNcNcNcNcNcNcNcNcNcNcNcNcNcNcN
cMcMcMcMcMcMcMcMcMcMcMcMcMcMcMcMcMcMcMcMcMcMcMcNcNcNcNcNcNcNcNcNcNcNcNcNcNcNcNcNcNcNcNcNcNcNcNcNcNcN
cMcMcMcMcMcMcMcMcMcMcMcMcMcMcMcMcMcMcMcMcMcMcMcNcNcNcNcNcNcNcNcNcNcNcNcNcNcNcNcNcNcNcNcNcNcNcNcNcNcN
cMcMcMcMcMcMcMcMcMcMcMcMcMcMcMcMcMcMcMcMcMcMcMcNcNcPcNcNcNcNcNcNcNcNcNcNcNcNcNcNcNcNcNcNcNcNcNcNcNcN
cMcMcMcMcMcQcMcMcMcMcMcMcMcMcMcMcMcMcMcMcMcMcMcNcNcNcNcNcNcNcNcNcNcNcNcNcNcNcNcNcNcNcNcNcNcPcNcNcNcN
cMcMcMcMcMcMcMcMcMcMcMcMcMcMcMcMcMcMcMcMcMcMcMcNcNcNcNcNcNcNcNcNcNcNcNcNcNcNcNcNcNcNcNcNcNcNcNcNcNcN
cMcMcMcMcMcMcMcMcMcMcMcMcMcMcMcMcMcMcMcMcMcMcMcNcNcNcNcNcNcNcNcNcNcNcNcNcNcNcNcNcNcNcNcNcNcNcNcNcNcN
cMcMcMcMcMcMcMcMcMcMcMcMcMcMcMcMcMcMcMcMcMcMcMcNcNcNcNcNcNcNcNcNcNcNcNcNcNcNcNcNcNcNcNcNcNcNcNcNcNcN
cMcMcMcMcMcMcMcMcMcMcMcMcMcMcMcMcMcMcMcMcMcMcMcNcNcNcNcNcNcNcNcNcNcNcNcNcNcNcNcNcNcNcNcNcNcNcNcNcNcN
cMcMcMcMcMcMcMcMcMcMcMcMcMcMcMcMcMcMcMcMcMcMcMcNcNcNcNcNcNcNcNcNcNcNcNcNcNcNcNcNcNcNcNcNcNcNcNcNcNcN
cMcMcMcMcMcMcMcMcMcMcMcMcMcMcQcMcMcMcMcMcMcMcMcNcNcNcNcNcNcNcNcNcNcNcNcNcNcPcNcNcNcNcNcNcNcNcNcNcNcN
cMcMcMcMcMcQcMcMcMcMcMcMcMcMcMcMcMcMcMcMcMcMcMcNcNcNcNcNcNcNcNcNcNcNcNcNcNcNcNcNcNcNcNcNcNcNcNcNcNcN
cMcMcMcMcMcMcMcMcMcMcMcMcMcMcMcMcMcMcMcMcMcMcMcNcNcNcNcNcNcNcNcNcNcNcNcNcNcNcNcNcNcNcNcNcNcNcNcNcNcN
cMcMcMcMcMcMcMcMcMcMcMcMcMcMcMcMcMcMcMcMcMcMcMcNcNcNcNcNcNcNcNcNcNcNcNcNcNcNcNcNcNcNcNcNcNcNcNcNcNcN
cMcMcMcMcRcMcMcMcMcMcMcMcMcMcMcMcMcMcMcMcMcMcMcNcNcNcPcNcNcNcNcNcNcNcNcNcNcNcNcNcNcNcNcNcNcNcNcNcNcN
cMcScMcMcMcMcMcMcMcMcMcMcMcMcMcMcMcMcMcMcMcMcMcNcNcNcNcNcNcNcNcNcNcNcNcNcNcNcNcNcNcNcNcNcNcNcNcNcNcN
cMcMcMcMcMcMcMcMcMcMcMcMcMcMcMcMcMcMcMcMcMcMcMcNcNcNcNcNcNcNcNcNcNcNcNcNcNcNcNcNcNcNcNcNcNcNcNcNcNcN
"}
