"aa" = (/turf/unsimulated/wall,/area/tranquility/walls1)
"ab" = (/turf/unsimulated/wall{tag = "icon-rock-dark"; icon_state = "rock-dark"},/area/tranquility/walls1)
"ac" = (/turf/space,/area/space)
"ad" = (/obj/effect/landmark/test/space_turf,/turf/space,/area/space)
"ae" = (/turf/unsimulated/wall,/area/tranquility/shaft)
"af" = (/obj/structure/sign/deck/fourth,/turf/unsimulated/wall,/area/tranquility/shaft)
"ag" = (/turf/simulated/open,/area/tranquility/shaft)
"ah" = (/obj/machinery/light/spot{dir = 1},/turf/simulated/open,/area/tranquility/shaft)
"ai" = (/obj/structure/lattice,/turf/simulated/open,/area/tranquility/shaft)
"aj" = (/turf/unsimulated/wall,/area/tranquility/shaftmaint)
"ak" = (/obj/structure/sign/deck/fourth,/turf/unsimulated/wall,/area/tranquility/shaftmaint)
"al" = (/turf/unsimulated/mask,/area/turbolift/tranquility_level4)
"am" = (/obj/structure/lattice,/turf/unsimulated/mask,/area/turbolift/tranquility_level4)
"an" = (/turf/unsimulated/wall,/area/tranquility/infirmary)
"ao" = (/turf/unsimulated/wall{tag = "icon-0"; icon_state = "0"},/area/tranquility/maint4)
"ap" = (/obj/effect/decal/cleanable/dirt,/turf/unsimulated/floor{tag = "icon-plating"; icon_state = "plating"},/area/tranquility/shaftmaint)
"aq" = (/obj/machinery/light/small{dir = 1},/turf/unsimulated/floor{tag = "icon-plating"; icon_state = "plating"},/area/tranquility/shaftmaint)
"ar" = (/turf/unsimulated/floor{tag = "icon-plating"; icon_state = "plating"},/area/tranquility/shaftmaint)
"as" = (/obj/structure/table/standard,/obj/item/weapon/storage/firstaid/toxin,/turf/simulated/floor/tiled/white,/area/tranquility/infirmary)
"at" = (/obj/structure/table/standard,/obj/effect/decal/cleanable/dirt,/obj/item/weapon/storage/firstaid/erk,/turf/simulated/floor/tiled/white,/area/tranquility/infirmary)
"au" = (/obj/structure/table/standard,/obj/item/weapon/storage/firstaid/regular,/obj/machinery/light{dir = 1},/turf/simulated/floor/tiled/white,/area/tranquility/infirmary)
"av" = (/obj/structure/table/standard,/obj/item/roller,/obj/item/roller,/turf/simulated/floor/tiled/white,/area/tranquility/infirmary)
"aw" = (/obj/effect/decal/cleanable/dirt,/turf/unsimulated/floor{tag = "icon-plating"; icon_state = "plating"},/area/tranquility/maint4)
"ax" = (/turf/unsimulated/floor{tag = "icon-plating"; icon_state = "plating"},/area/tranquility/maint4)
"ay" = (/obj/effect/decal/cleanable/cobweb2,/turf/unsimulated/floor{tag = "icon-plating"; icon_state = "plating"},/area/tranquility/maint4)
"az" = (/obj/structure/ladder,/turf/unsimulated/floor{tag = "icon-plating"; icon_state = "plating"},/area/tranquility/shaftmaint)
"aA" = (/obj/structure/closet/secure_closet/paramedic,/turf/simulated/floor/tiled/white,/area/tranquility/infirmary)
"aB" = (/obj/effect/decal/cleanable/dirt,/turf/simulated/floor/tiled/white,/area/tranquility/infirmary)
"aC" = (/turf/simulated/floor/tiled/white,/area/tranquility/infirmary)
"aD" = (/obj/structure/closet/medical_wall/filled,/turf/unsimulated/wall,/area/tranquility/infirmary)
"aE" = (/obj/structure/sign/halo_floorsign/maint{tag = "icon-maint (EAST)"; icon_state = "maint"; dir = 4},/turf/unsimulated/floor{tag = "icon-plating"; icon_state = "plating"},/area/tranquility/maint4)
"aF" = (/obj/structure/ladder,/turf/unsimulated/floor{tag = "icon-plating"; icon_state = "plating"},/area/tranquility/maint4)
"aG" = (/obj/effect/decal/cleanable/dirt,/obj/machinery/light/small{dir = 4},/turf/unsimulated/floor{tag = "icon-plating"; icon_state = "plating"},/area/tranquility/maint4)
"aH" = (/obj/structure/sign/halo_floorsign/maint{tag = "icon-maint (NORTH)"; icon_state = "maint"; dir = 1},/turf/unsimulated/floor{tag = "icon-plating"; icon_state = "plating"},/area/tranquility/shaftmaint)
"aI" = (/obj/machinery/light/spot{dir = 8},/turf/simulated/open,/area/tranquility/shaft)
"aJ" = (/obj/machinery/light/spot{dir = 4},/turf/simulated/open,/area/tranquility/shaft)
"aK" = (/obj/effect/decal/cleanable/dirt,/obj/machinery/vending/medical,/turf/simulated/floor/tiled/white,/area/tranquility/infirmary)
"aL" = (/obj/machinery/vending/wallmed1,/turf/unsimulated/wall,/area/tranquility/infirmary)
"aM" = (/obj/effect/decal/cleanable/dirt,/obj/structure/closet/secure_closet/medical3,/obj/machinery/light{dir = 8},/turf/simulated/floor/tiled/white,/area/tranquility/infirmary)
"aN" = (/obj/machinery/space_heater,/turf/simulated/floor/tiled/white,/area/tranquility/infirmary)
"aO" = (/turf/unsimulated/wall,/area/tranquility/halls1)
"aP" = (/obj/machinery/vending/wallmed1,/turf/unsimulated/wall,/area/tranquility/halls1)
"aQ" = (/obj/machinery/door/airlock/halo_maint,/turf/unsimulated/floor{tag = "icon-plating"; icon_state = "plating"},/area/tranquility/shaftmaint)
"aR" = (/obj/structure/sign/warning/moving_parts,/turf/simulated/wall/r_wall,/area/tranquility/shaft)
"aS" = (/obj/effect/floor_decal/corner/yellow{tag = "icon-corner_white (NORTHWEST)"; icon_state = "corner_white"; dir = 9},/obj/effect/floor_decal/industrial/warning/dust{tag = "icon-warning_dust (NORTH)"; icon_state = "warning_dust"; dir = 1},/obj/effect/decal/cleanable/dirt,/turf/unsimulated/floor{tag = "icon-dark"; icon_state = "dark"},/area/tranquility/halls1)
"aT" = (/obj/effect/floor_decal/industrial/warning/dust{tag = "icon-warning_dust (NORTH)"; icon_state = "warning_dust"; dir = 1},/obj/effect/decal/cleanable/dirt,/turf/unsimulated/floor{tag = "icon-dark"; icon_state = "dark"},/area/tranquility/halls1)
"aU" = (/obj/effect/floor_decal/corner/yellow{tag = "icon-corner_white (SOUTHEAST)"; icon_state = "corner_white"; dir = 6},/obj/effect/floor_decal/industrial/warning/dust{tag = "icon-warning_dust (NORTH)"; icon_state = "warning_dust"; dir = 1},/turf/unsimulated/floor{tag = "icon-dark"; icon_state = "dark"},/area/tranquility/halls1)
"aV" = (/obj/structure/sign/warning/fall,/turf/unsimulated/wall,/area/tranquility/shaft)
"aW" = (/obj/structure/grille,/obj/structure/window/reinforced/full,/turf/simulated/floor/plating,/area/tranquility/infirmary)
"aX" = (/obj/machinery/door/airlock/halo_lifepod{name = "Airlock"},/turf/unsimulated/floor{tag = "icon-plating"; icon_state = "plating"},/area/tranquility/infirmary)
"aY" = (/obj/structure/sign/bluecross_2,/turf/simulated/wall/r_wall,/area/tranquility/infirmary)
"aZ" = (/turf/unsimulated/wall,/area/tranquility/maint4)
"ba" = (/turf/unsimulated/floor{tag = "icon-dark"; icon_state = "dark"},/area/tranquility/halls1)
"bb" = (/obj/effect/decal/cleanable/dirt,/turf/unsimulated/floor{tag = "icon-dark"; icon_state = "dark"},/area/tranquility/halls1)
"bc" = (/obj/effect/floor_decal/industrial/warning/dust{tag = "icon-warning_dust (EAST)"; icon_state = "warning_dust"; dir = 4},/turf/unsimulated/floor{tag = "icon-dark"; icon_state = "dark"},/area/tranquility/halls1)
"bd" = (/obj/effect/floor_decal/corner/yellow{tag = "icon-corner_white (NORTHWEST)"; icon_state = "corner_white"; dir = 9},/obj/effect/decal/cleanable/dirt,/turf/unsimulated/floor{tag = "icon-dark"; icon_state = "dark"},/area/tranquility/halls1)
"be" = (/obj/effect/floor_decal/corner/yellow{tag = "icon-corner_white (SOUTHEAST)"; icon_state = "corner_white"; dir = 6},/obj/effect/decal/cleanable/dirt,/turf/unsimulated/floor{tag = "icon-dark"; icon_state = "dark"},/area/tranquility/halls1)
"bf" = (/obj/effect/floor_decal/industrial/warning/dust{tag = "icon-warning_dust (WEST)"; icon_state = "warning_dust"; dir = 8},/turf/unsimulated/floor{tag = "icon-dark"; icon_state = "dark"},/area/tranquility/halls1)
"bg" = (/obj/effect/floor_decal/sign/m,/turf/unsimulated/floor{tag = "icon-dark"; icon_state = "dark"},/area/tranquility/halls1)
"bh" = (/obj/machinery/door/airlock/halo_maint,/turf/unsimulated/floor{tag = "icon-plating"; icon_state = "plating"},/area/tranquility/maint4)
"bi" = (/turf/unsimulated/wall{tag = "icon-0"; icon_state = "0"},/area/tranquility/maint3)
"bj" = (/obj/machinery/light,/turf/unsimulated/floor{tag = "icon-dark"; icon_state = "dark"},/area/tranquility/halls1)
"bk" = (/obj/effect/decal/cleanable/dirt,/obj/machinery/light,/turf/unsimulated/floor{tag = "icon-dark"; icon_state = "dark"},/area/tranquility/halls1)
"bl" = (/obj/effect/floor_decal/corner/yellow{tag = "icon-corner_white (NORTHWEST)"; icon_state = "corner_white"; dir = 9},/turf/unsimulated/floor{tag = "icon-dark"; icon_state = "dark"},/area/tranquility/halls1)
"bm" = (/obj/effect/floor_decal/corner/yellow{tag = "icon-corner_white (SOUTHEAST)"; icon_state = "corner_white"; dir = 6},/turf/unsimulated/floor{tag = "icon-dark"; icon_state = "dark"},/area/tranquility/halls1)
"bn" = (/turf/unsimulated/floor{tag = "icon-plating"; icon_state = "plating"},/area/tranquility/maint3)
"bo" = (/obj/machinery/light/small/red{tag = "icon-bulb1 (NORTH)"; icon_state = "bulb1"; dir = 1},/turf/unsimulated/floor{tag = "icon-plating"; icon_state = "plating"},/area/tranquility/maint3)
"bp" = (/obj/effect/decal/cleanable/cobweb2,/turf/unsimulated/floor{tag = "icon-plating"; icon_state = "plating"},/area/tranquility/maint3)
"bq" = (/turf/unsimulated/wall{tag = "icon-0"; icon_state = "0"},/area/tranquility/maint1)
"br" = (/turf/unsimulated/wall,/area/tranquility/maint1)
"bs" = (/obj/machinery/door/airlock/halo_maint,/turf/unsimulated/floor{tag = "icon-plating"; icon_state = "plating"},/area/tranquility/maint1)
"bt" = (/obj/structure/extinguisher_cabinet,/turf/unsimulated/wall,/area/tranquility/halls1)
"bu" = (/turf/unsimulated/wall,/area/tranquility/janitor)
"bv" = (/obj/structure/sign/halo_floorsign/cargobay{tag = "icon-cargobay (NORTH)"; icon_state = "cargobay"; dir = 1},/obj/effect/floor_decal/corner/yellow{tag = "icon-corner_white (NORTH)"; icon_state = "corner_white"; dir = 1},/turf/unsimulated/floor{tag = "icon-dark"; icon_state = "dark"},/area/tranquility/halls1)
"bw" = (/obj/structure/sign/halo_floorsign/cargobay{tag = "icon-cargobay (NORTH)"; icon_state = "cargobay"; dir = 1},/obj/effect/floor_decal/corner/yellow{tag = "icon-corner_white (EAST)"; icon_state = "corner_white"; dir = 4},/turf/unsimulated/floor{tag = "icon-dark"; icon_state = "dark"},/area/tranquility/halls1)
"bx" = (/obj/effect/decal/cleanable/dirt,/turf/unsimulated/floor{tag = "icon-plating"; icon_state = "plating"},/area/tranquility/maint3)
"by" = (/obj/structure/ladder,/turf/unsimulated/floor{tag = "icon-plating"; icon_state = "plating"},/area/tranquility/maint3)
"bz" = (/obj/effect/decal/cleanable/dirt,/turf/unsimulated/floor{tag = "icon-plating"; icon_state = "plating"},/area/tranquility/maint1)
"bA" = (/turf/unsimulated/floor{tag = "icon-plating"; icon_state = "plating"},/area/tranquility/maint1)
"bB" = (/obj/structure/mopbucket,/obj/effect/decal/cleanable/cobweb,/obj/item/weapon/mop,/turf/unsimulated/floor{tag = "icon-dark"; icon_state = "dark"},/area/tranquility/janitor)
"bC" = (/obj/structure/toilet,/turf/unsimulated/floor{tag = "icon-dark"; icon_state = "dark"},/area/tranquility/janitor)
"bD" = (/obj/machinery/light{dir = 8},/turf/unsimulated/floor{tag = "icon-dark"; icon_state = "dark"},/area/tranquility/halls1)
"bE" = (/obj/structure/sign/halo_floorsign/maint{tag = "icon-maint (NORTH)"; icon_state = "maint"; dir = 1},/turf/unsimulated/floor{tag = "icon-plating"; icon_state = "plating"},/area/tranquility/maint3)
"bF" = (/turf/unsimulated/wall,/area/tranquility/armory2)
"bG" = (/obj/effect/decal/cleanable/generic,/obj/machinery/light/small{dir = 8},/turf/unsimulated/floor{tag = "icon-dark"; icon_state = "dark"},/area/tranquility/janitor)
"bH" = (/obj/structure/sink{dir = 4; icon_state = "sink"; pixel_x = 10; tag = "icon-sink (EAST)"},/turf/unsimulated/floor{tag = "icon-dark"; icon_state = "dark"},/area/tranquility/janitor)
"bI" = (/obj/structure/mirror,/turf/unsimulated/wall,/area/tranquility/janitor)
"bJ" = (/obj/structure/sign/directions/supply{tag = "icon-direction_supply (NORTH)"; icon_state = "direction_supply"; dir = 1},/turf/unsimulated/wall,/area/tranquility/janitor)
"bK" = (/obj/effect/decal/cleanable/blood/oil,/turf/unsimulated/floor{tag = "icon-dark"; icon_state = "dark"},/area/tranquility/halls1)
"bL" = (/obj/structure/sign/directions/infirmary{tag = "icon-direction_infirm (EAST)"; icon_state = "direction_infirm"; dir = 4},/turf/unsimulated/wall,/area/tranquility/halls1)
"bM" = (/obj/structure/sign/warning/vent_port,/turf/unsimulated/wall{tag = "icon-0"; icon_state = "0"},/area/tranquility/maint3)
"bN" = (/obj/effect/decal/cleanable/cobweb,/turf/unsimulated/floor{tag = "icon-plating"; icon_state = "plating"},/area/tranquility/maint1)
"bO" = (/obj/structure/table/rack,/obj/item/weapon/gun/projectile/m6d_magnum,/obj/effect/decal/cleanable/cobweb,/turf/unsimulated/floor{tag = "icon-dark"; icon_state = "dark"},/area/tranquility/armory2)
"bP" = (/obj/structure/table/rack,/obj/item/weapon/gun/projectile/m6d_magnum,/turf/unsimulated/floor{tag = "icon-dark"; icon_state = "dark"},/area/tranquility/armory2)
"bQ" = (/obj/structure/table/rack,/obj/item/weapon/gun/projectile/ma5b_ar/MA37,/obj/effect/decal/cleanable/dirt,/turf/unsimulated/floor{tag = "icon-dark"; icon_state = "dark"},/area/tranquility/armory2)
"bR" = (/turf/unsimulated/wall,/area/tranquility/checkpoint)
"bS" = (/obj/machinery/door/airlock/halo,/turf/unsimulated/floor{tag = "icon-plating"; icon_state = "plating"},/area/tranquility/checkpoint)
"bT" = (/obj/structure/extinguisher_cabinet,/turf/unsimulated/wall,/area/tranquility/checkpoint)
"bU" = (/turf/unsimulated/wall{tag = "icon-rock-dark"; icon_state = "rock-dark"},/area/tranquility/maint3)
"bV" = (/obj/structure/sign/halo_floorsign/maint{tag = "icon-maint (EAST)"; icon_state = "maint"; dir = 4},/turf/unsimulated/floor{tag = "icon-plating"; icon_state = "plating"},/area/tranquility/maint1)
"bW" = (/obj/structure/ladder,/turf/unsimulated/floor{tag = "icon-plating"; icon_state = "plating"},/area/tranquility/maint1)
"bX" = (/obj/machinery/light/small{dir = 4},/turf/unsimulated/floor{tag = "icon-plating"; icon_state = "plating"},/area/tranquility/maint1)
"bY" = (/obj/machinery/light{dir = 8},/turf/unsimulated/floor{tag = "icon-dark"; icon_state = "dark"},/area/tranquility/armory2)
"bZ" = (/obj/effect/decal/cleanable/dirt,/turf/unsimulated/floor{tag = "icon-dark"; icon_state = "dark"},/area/tranquility/armory2)
"ca" = (/obj/machinery/door/airlock/halo_lifepod{name = "Airlock"},/turf/unsimulated/floor{tag = "icon-plating"; icon_state = "plating"},/area/tranquility/checkpoint)
"cb" = (/turf/unsimulated/floor{tag = "icon-steel"; icon_state = "steel"},/area/tranquility/checkpoint)
"cc" = (/obj/machinery/light{dir = 4; icon_state = "tube1"},/turf/unsimulated/floor{tag = "icon-dark"; icon_state = "dark"},/area/tranquility/halls1)
"cd" = (/obj/effect/decal/cleanable/cobweb,/turf/unsimulated/floor{tag = "icon-plating"; icon_state = "plating"},/area/tranquility/maint3)
"ce" = (/obj/structure/table/rack,/obj/item/ammo_magazine/m127_saphe,/obj/item/ammo_magazine/m127_saphe,/turf/unsimulated/floor{tag = "icon-dark"; icon_state = "dark"},/area/tranquility/armory2)
"cf" = (/obj/structure/table/rack,/obj/item/ammo_magazine/m762_ap/MA37,/obj/item/ammo_magazine/m762_ap/MA37,/turf/unsimulated/floor{tag = "icon-dark"; icon_state = "dark"},/area/tranquility/armory2)
"cg" = (/obj/structure/filingcabinet/chestdrawer,/turf/unsimulated/floor{tag = "icon-steel"; icon_state = "steel"},/area/tranquility/checkpoint)
"ch" = (/obj/effect/decal/cleanable/dirt,/turf/unsimulated/floor{tag = "icon-steel"; icon_state = "steel"},/area/tranquility/checkpoint)
"ci" = (/obj/structure/grille,/obj/structure/window/reinforced/full,/turf/simulated/floor/plating,/area/tranquility/checkpoint)
"cj" = (/obj/machinery/vending/security,/turf/unsimulated/floor{tag = "icon-steel"; icon_state = "steel"},/area/tranquility/checkpoint)
"ck" = (/obj/structure/filingcabinet/security,/obj/machinery/light{dir = 4; icon_state = "tube1"},/turf/unsimulated/floor{tag = "icon-steel"; icon_state = "steel"},/area/tranquility/checkpoint)
"cl" = (/obj/machinery/door/blast/regular/triple{id = 2},/turf/unsimulated/floor{tag = "icon-dark"; icon_state = "dark"},/area/tranquility/entrance)
"cm" = (/obj/effect/decal/cleanable/dirt,/turf/unsimulated/floor{tag = "icon-dark"; icon_state = "dark"},/area/tranquility/entrance)
"cn" = (/turf/unsimulated/wall,/area/tranquility/entrance)
"co" = (/turf/unsimulated/wall{tag = "icon-0"; icon_state = "0"},/area/tranquility/maint2)
"cp" = (/obj/machinery/space_heater,/obj/machinery/light{dir = 8},/turf/unsimulated/floor{tag = "icon-steel"; icon_state = "steel"},/area/tranquility/checkpoint)
"cq" = (/obj/structure/bed/chair{tag = "icon-chair_preview (EAST)"; icon_state = "chair_preview"; dir = 4},/turf/unsimulated/floor{tag = "icon-steel"; icon_state = "steel"},/area/tranquility/checkpoint)
"cr" = (/obj/machinery/door/window/eastleft,/obj/structure/table/steel,/obj/item/weapon/paper_bin,/obj/item/weapon/pen/red,/turf/simulated/floor/plating,/area/tranquility/checkpoint)
"cs" = (/turf/unsimulated/floor{tag = "icon-dark"; icon_state = "dark"},/area/tranquility/entrance)
"ct" = (/obj/machinery/light{dir = 4; icon_state = "tube1"},/turf/unsimulated/floor{tag = "icon-dark"; icon_state = "dark"},/area/tranquility/entrance)
"cu" = (/turf/unsimulated/wall{tag = "icon-rock-dark"; icon_state = "rock-dark"},/area/tranquility/maint2)
"cv" = (/obj/structure/sign/warning/vent_port,/turf/unsimulated/wall{tag = "icon-0"; icon_state = "0"},/area/tranquility/maint2)
"cw" = (/obj/effect/decal/cleanable/dirt,/turf/unsimulated/floor{tag = "icon-plating"; icon_state = "plating"},/area/tranquility/maint2)
"cx" = (/obj/machinery/vending/cigarette,/turf/unsimulated/floor{tag = "icon-steel"; icon_state = "steel"},/area/tranquility/checkpoint)
"cy" = (/obj/machinery/door/window/eastright,/obj/structure/table/steel,/obj/effect/decal/cleanable/generic,/obj/item/weapon/reagent_containers/spray/pepper,/turf/simulated/floor/plating,/area/tranquility/checkpoint)
"cz" = (/obj/machinery/vending/wallmed1,/turf/unsimulated/wall,/area/tranquility/entrance)
"cA" = (/turf/unsimulated/floor{tag = "icon-plating"; icon_state = "plating"},/area/tranquility/maint2)
"cB" = (/obj/structure/sign/halo_floorsign/maint{tag = "icon-maint (EAST)"; icon_state = "maint"; dir = 4},/turf/unsimulated/floor{tag = "icon-plating"; icon_state = "plating"},/area/tranquility/maint2)
"cC" = (/obj/structure/ladder,/turf/unsimulated/floor{tag = "icon-plating"; icon_state = "plating"},/area/tranquility/maint2)
"cD" = (/obj/machinery/light/small/red{tag = "icon-bulb1 (EAST)"; icon_state = "bulb1"; dir = 4},/turf/unsimulated/floor{tag = "icon-plating"; icon_state = "plating"},/area/tranquility/maint2)
"cE" = (/obj/structure/reagent_dispensers/peppertank,/turf/unsimulated/wall,/area/tranquility/checkpoint)
"cF" = (/obj/machinery/recharger/wallcharger,/turf/unsimulated/wall,/area/tranquility/checkpoint)
"cG" = (/obj/machinery/button/remote/blast_door{id = 2},/turf/unsimulated/wall,/area/tranquility/checkpoint)
"cH" = (/obj/machinery/light{dir = 8},/turf/unsimulated/floor{tag = "icon-dark"; icon_state = "dark"},/area/tranquility/entrance)
"cI" = (/obj/machinery/door/blast/regular/triple,/obj/effect/decal/cleanable/dirt,/turf/unsimulated/floor{tag = "icon-plating"; icon_state = "plating"},/area/tranquility/entrance)
"cJ" = (/turf/unsimulated/floor{tag = "icon-plating"; icon_state = "plating"},/area/tranquility/entrance)
"cK" = (/obj/effect/decal/cleanable/dirt,/turf/unsimulated/floor{tag = "icon-plating"; icon_state = "plating"},/area/tranquility/entrance)
"cL" = (/obj/structure/sign/warning/detailed{name = "\improper AUTHORIZED PERSONNEL ONLY"},/turf/unsimulated/wall,/area/tranquility/entrance)
"cM" = (/obj/machinery/light/small/red{tag = "icon-bulb1 (WEST)"; icon_state = "bulb1"; dir = 8},/turf/unsimulated/floor{tag = "icon-plating"; icon_state = "plating"},/area/tranquility/entrance)
"cN" = (/obj/machinery/button/remote/blast_door{id = 1},/turf/unsimulated/wall,/area/tranquility/entrance)
"cO" = (/turf/unsimulated/wall{tag = "icon-rock-dark"; icon_state = "rock-dark"},/area/tranquility/entrance)
"cP" = (/obj/effect/decal/cleanable/cobweb2,/obj/effect/decal/cleanable/dirt,/turf/unsimulated/floor{tag = "icon-plating"; icon_state = "plating"},/area/tranquility/maint2)
"cQ" = (/obj/structure/sign/warning/hot_exhaust,/turf/unsimulated/wall{tag = "icon-rock-dark"; icon_state = "rock-dark"},/area/tranquility/maint3)
"cR" = (/obj/structure/sign/warning/hot_exhaust,/turf/unsimulated/wall{tag = "icon-rock-dark"; icon_state = "rock-dark"},/area/tranquility/maint2)
"cS" = (/obj/effect/floor_decal/snow,/turf/unsimulated/floor{tag = "icon-plating"; icon_state = "plating"},/area/tranquility/entrance)
"cT" = (/obj/structure/grille,/turf/unsimulated/floor{tag = "icon-plating"; icon_state = "plating"},/area/tranquility/maint2)
"cU" = (/turf/unsimulated/floor{tag = "icon-snow"; icon_state = "snow"},/area/tranquility/outside)
"cV" = (/turf/unsimulated/floor{tag = "icon-snow"; icon_state = "snow"},/area/tranquility/random2)
"cW" = (/obj/structure/grille,/obj/effect/decal/cleanable/dirt,/turf/unsimulated/floor{tag = "icon-plating"; icon_state = "plating"},/area/tranquility/maint3)
"cX" = (/obj/effect/landmark/drop_pod_landing,/turf/unsimulated/floor{tag = "icon-snow"; icon_state = "snow"},/area/tranquility/outside)
"cY" = (/obj/effect/landmark/drop_pod_landing,/turf/unsimulated/floor{tag = "icon-snow"; icon_state = "snow"},/area/tranquility/random2)
"cZ" = (/obj/effect/landmark/test/safe_turf,/turf/unsimulated/floor{tag = "icon-snow"; icon_state = "snow"},/area/tranquility/outside)
"da" = (/obj/effect/landmark/map_data{height = 4},/turf/unsimulated/floor{tag = "icon-snow"; icon_state = "snow"},/area/tranquility/outside)

(1,1,1) = {"
aaaaaaaaaaababababababababababababababababababababababababababababababababababababababababababababab
aaacacacaaababababababababababababababababababababababababababababababababababababababababababababab
aaacadacaaabababababababababababaeaeaeaeaeafaeaeaeaeaeababababababababababababababababababababababab
aaacacacaaabababababababababababaeagagagahaiahagagagaeababababababababababababababababababababababab
aaaaaaaaaaabababababababajajakajaeagagalalamalalagagaeanananananabababababaoaoaoaoaoabababababababab
ababababababababababababajapaqaraeagagalalalalalagagaeasatauavanaoaoaoaoaoaoawaxayaoabababababababab
ababababababababababababajapazapaeaiaiamalalalamaiaiaeaAaBaCaCaDaoaxaxawawaxaEaFaGaoabababababababab
ababababababababababababajaraHapaeaIagalalalalalagaJaeaKaBaBaBaLaoawaoaoaoaoaxaxawaoabababababababab
ababababababababababababajajarajaeagagalalalalalagagaeaMaCaCaNanaoawaoababaoaoaoaoaoabababababababab
abababababaOaOaPaOaOaOaOajajaQajaeaeaRaeaSaTaUaeaVaeaeaWaWaXaYanaZawaoababababababababababababababab
abababababaObabbbbbababbbabababbbabbbbbcbdbbbebfbabababbbbbbbabgbhaxaoababababababababbibibibibiabab
abababababaObabgbjbabbbbbabkbbbbbbbbbjbcblbbbmbfbabjbabbbababjbaaZaoaoababababababababbibnbobpbiabab
ababababbqbrbrbsbraOaObtaOaOaObubububububvbabwaOaOaOaOaOaOaPaObtaOababababababababababbibxbybxbiabab
ababababbqbzbAbAbqababababababbubBbCbububDbabaaOabababababababababababababababababababbibnbEbxbiabab
ababababbqbzbqbqbqbqbFbFbFbFbFbubGbHbIbJbabbbKbLabababababababababababababababababababbibibnbMbiabab
ababababbqbzbqbNbzbzbFbObPbQbRbRbSbRbTbRbabbbbaOababababababababababababababbUbUbUbUbUbUbUbxbUababab
ababababbqbAbAbVbWbXbFbYbZbZcacbcbcbcbbSbabbccaOababababababababababababababbUcdbxbxbnbnbxbxbUababab
ababababbqbqbqbzbzbAbFcececfbRcgcbchcbcibbbbbaaOababababababababababababababbUbnbUbUbUbUbUbUbUababab
ababababababbqbqbqbqbFbFbFbFbRcjcbchckbRclcmcmcnababababababababababababababbUbxbUababababababababab
abababababcococococoababababbRcpchcbcqcrcscmctcnababababababababababababababbUbxbUababababababababab
abcucucucucvcwcwcwcoababababbRcxcbcbcqcycmcmcmczababababababababababababababbUbnbUbUbUababababababab
abcucwcAcAcAcBcCcDcoababababbRbRcEcFcGbRcHcmcmcnababababababababababababababbUbxbxbpbUababababababab
abcucwcucucocAcwcAcoabababababababababcncIcJcKcnababababababababababababababbUbUbUbnbUababababababab
abcucwcuabcococococoabababababababababcLcMcKcJcNababababababababababababababababbUbxbUbUbUbUbUababab
abcucAcuabababababababababababababababcOcJcKcKcOababababababababababababababababbUbxbnbxbxbxbUababab
abcucAcucucuabababababababababababababcOcKcKcKcOababababababababababababababababbUbUbUbUbUbnbUababab
abcucwcwcPcuabababababababababababababcOcKcJcKcOababababababababababababababababababababbUbncQbUabab
abcucucucAcucRcuabababababababababababcOcJcJcJcOababababababababababababababababababababbUbxbpbUabab
ababcucucwcwcPcuabababababababababababcOcScScScOababababababababababababababababababababbUbUbnbUabab
abababcucucucwcuabababababababababababcOcScScScOabababababababababababababababababababababbUbxbUabab
ababababcucucTcuabababababababababcUcUcUcUcUcUabcVabcVcVabababababababababababababababababbUbxbUabab
ababababababcUcUcUababababababcUcUcUcUcUcUcUcUcVcVcVcVcVcVababababababababcVcVababababababbUcWbUabab
ababcUcUcUcUcUcUcUcUcUcUcUcUcUcUcUcUcUcUcUcUcUcVcVcVcVcVcVcVababababababcVcVcVcVababababcVcVcVcVabab
cUcUcUcUcUcUcUcUcUcUcUcUcUcUcUcUcUcUcUcUcUcUcUcVcVcVcVcVcVcVcVcVcVcVcVcVcVcVcVcVcVcVcVcVcVcVcVcVcVcV
cUcUcUcUcUcUcUcUcUcUcUcUcUcUcUcUcUcUcUcUcUcUcUcVcVcVcVcVcVcVcVcVcVcVcVcVcVcVcVcVcVcVcVcVcVcVcVcVcVcV
cUcUcUcUcUcUcUcUcUcUcUcUcUcUcUcUcUcUcUcUcUcUcUcVcVcVcVcVcVcVcVcVcVcVcVcVcVcVcVcVcVcVcVcVcVcVcVcVcVcV
cUcUcUcUcUcUcUcUcUcUcUcUcUcUcUcUcUcUcUcUcUcUcUcVcVcVcVcVcVcVcVcVcVcVcVcVcVcVcVcVcVcVcVcVcVcVcVcVcVcV
cUcUcUcUcUcXcUcUcUcUcUcUcUcUcUcUcUcUcUcUcUcUcUcVcVcVcVcVcVcVcVcVcVcVcVcVcVcVcVcVcVcVcVcVcVcVcVcVcVcV
cUcUcUcUcUcUcUcUcUcUcUcUcUcUcUcUcUcUcUcUcUcUcUcVcVcYcVcVcVcVcVcVcVcVcVcVcVcVcVcVcVcVcVcYcVcVcVcVcVcV
cUcUcUcUcUcUcUcUcUcUcUcUcUcUcUcUcUcUcUcUcUcUcUcVcVcVcVcVcVcVcVcVcVcVcVcVcVcVcVcVcVcVcVcVcVcVcVcVcVcV
cUcUcUcUcUcUcUcUcUcUcUcUcUcUcUcUcUcUcUcUcUcUcUcVcVcVcVcVcVcVcVcVcVcVcVcVcVcVcVcVcVcVcVcVcVcVcVcVcVcV
cUcUcUcUcUcUcUcUcUcUcUcUcUcUcUcUcUcUcUcUcUcUcUcVcVcVcVcVcVcVcVcVcVcVcVcVcVcVcVcVcVcVcVcVcVcVcVcVcVcV
cUcUcUcUcUcUcUcUcUcUcUcUcUcUcUcUcUcUcUcUcUcUcUcVcVcVcVcVcVcVcVcVcVcVcVcVcVcVcVcVcVcVcVcVcVcVcVcVcVcV
cUcUcUcUcUcUcUcUcUcUcUcUcUcUcXcUcUcUcUcUcUcUcUcVcVcVcVcVcVcVcVcVcVcVcVcVcVcYcVcVcVcVcVcVcVcVcVcVcVcV
cUcUcUcUcUcXcUcUcUcUcUcUcUcUcUcUcUcUcUcUcUcUcUcVcVcVcVcVcVcVcVcVcVcVcVcVcVcVcVcVcVcVcVcVcVcVcVcVcVcV
cUcUcUcUcUcUcUcUcUcUcUcUcUcUcUcUcUcUcUcUcUcUcUcVcVcVcVcVcVcVcVcVcVcVcVcVcVcVcVcVcVcVcVcVcVcVcVcVcVcV
cUcUcUcUcUcUcUcUcUcUcUcUcUcUcUcUcUcUcUcUcUcUcUcVcVcVcVcVcVcVcVcVcVcVcVcVcVcVcVcVcVcVcVcYcVcVcVcVcVcV
cUcUcUcUcZcUcUcUcUcUcUcUcUcUcUcUcUcUcUcUcUcUcUcVcVcVcYcVcVcVcVcVcVcVcVcVcVcVcVcVcVcVcVcVcVcVcVcVcVcV
cUdacUcUcUcUcUcUcUcUcUcUcUcUcUcUcUcUcUcUcUcUcUcVcVcVcVcVcVcVcVcVcVcVcVcVcVcVcVcVcVcVcVcVcVcVcVcVcVcV
cUcUcUcUcUcUcUcUcUcUcUcUcUcUcUcUcUcUcUcUcUcUcUcVcVcVcVcVcVcVcVcVcVcVcVcVcVcVcVcVcVcVcVcVcVcVcVcVcVcV
"}
