"aa" = (/turf/unsimulated/wall,/area/tranquility/walls1)
"ab" = (/turf/unsimulated/wall{tag = "icon-rock-dark"; icon_state = "rock-dark"},/area/tranquility/walls1)
"ac" = (/turf/space,/area/space)
"ad" = (/obj/effect/landmark/test/space_turf,/turf/space,/area/space)
"ae" = (/turf/unsimulated/wall,/area/tranquility/shaft)
"af" = (/obj/structure/sign/deck/fourth,/turf/unsimulated/wall,/area/tranquility/shaft)
"ag" = (/obj/effect/decal/cleanable/cobweb,/turf/simulated/open,/area/tranquility/shaft)
"ah" = (/turf/simulated/open,/area/tranquility/shaft)
"ai" = (/obj/machinery/light/spot{dir = 1},/turf/simulated/open,/area/tranquility/shaft)
"aj" = (/obj/structure/lattice,/turf/simulated/open,/area/tranquility/shaft)
"ak" = (/turf/unsimulated/wall,/area/tranquility/shaftmaint)
"al" = (/obj/structure/sign/deck/fourth,/turf/unsimulated/wall,/area/tranquility/shaftmaint)
"am" = (/turf/unsimulated/mask,/area/turbolift/tranquility_level4)
"an" = (/obj/structure/lattice,/turf/unsimulated/mask,/area/turbolift/tranquility_level4)
"ao" = (/turf/unsimulated/wall,/area/tranquility/infirmary)
"ap" = (/turf/unsimulated/wall{tag = "icon-0"; icon_state = "0"},/area/tranquility/maint4)
"aq" = (/obj/effect/decal/cleanable/dirt,/turf/unsimulated/floor{tag = "icon-plating"; icon_state = "plating"},/area/tranquility/shaftmaint)
"ar" = (/obj/machinery/light/small{dir = 1},/turf/unsimulated/floor{tag = "icon-plating"; icon_state = "plating"},/area/tranquility/shaftmaint)
"as" = (/turf/unsimulated/floor{tag = "icon-plating"; icon_state = "plating"},/area/tranquility/shaftmaint)
"at" = (/obj/structure/table/standard,/obj/item/weapon/storage/firstaid/toxin,/turf/unsimulated/floor{tag = "icon-white"; icon_state = "white"},/area/tranquility/infirmary)
"au" = (/obj/structure/table/standard,/obj/effect/decal/cleanable/dirt,/obj/item/weapon/storage/firstaid/erk,/turf/unsimulated/floor{tag = "icon-white"; icon_state = "white"},/area/tranquility/infirmary)
"av" = (/obj/structure/table/standard,/obj/item/weapon/storage/firstaid/regular,/obj/machinery/light{dir = 1},/turf/unsimulated/floor{tag = "icon-white"; icon_state = "white"},/area/tranquility/infirmary)
"aw" = (/obj/structure/table/standard,/obj/item/roller,/obj/item/roller,/turf/unsimulated/floor{tag = "icon-white"; icon_state = "white"},/area/tranquility/infirmary)
"ax" = (/obj/effect/decal/cleanable/dirt,/turf/unsimulated/floor{tag = "icon-plating"; icon_state = "plating"},/area/tranquility/maint4)
"ay" = (/turf/unsimulated/floor{tag = "icon-plating"; icon_state = "plating"},/area/tranquility/maint4)
"az" = (/obj/effect/decal/cleanable/cobweb2,/turf/unsimulated/floor{tag = "icon-plating"; icon_state = "plating"},/area/tranquility/maint4)
"aA" = (/obj/structure/ladder,/turf/unsimulated/floor{tag = "icon-plating"; icon_state = "plating"},/area/tranquility/shaftmaint)
"aB" = (/obj/structure/closet/secure_closet/paramedic,/turf/unsimulated/floor{tag = "icon-white"; icon_state = "white"},/area/tranquility/infirmary)
"aC" = (/obj/effect/decal/cleanable/dirt,/turf/unsimulated/floor{tag = "icon-white"; icon_state = "white"},/area/tranquility/infirmary)
"aD" = (/turf/unsimulated/floor{tag = "icon-white"; icon_state = "white"},/area/tranquility/infirmary)
"aE" = (/obj/structure/closet/medical_wall/filled,/turf/unsimulated/wall,/area/tranquility/infirmary)
"aF" = (/obj/structure/sign/halo_floorsign/maint{tag = "icon-maint (EAST)"; icon_state = "maint"; dir = 4},/turf/unsimulated/floor{tag = "icon-plating"; icon_state = "plating"},/area/tranquility/maint4)
"aG" = (/obj/structure/ladder,/turf/unsimulated/floor{tag = "icon-plating"; icon_state = "plating"},/area/tranquility/maint4)
"aH" = (/obj/effect/decal/cleanable/dirt,/obj/machinery/light/small{dir = 4},/turf/unsimulated/floor{tag = "icon-plating"; icon_state = "plating"},/area/tranquility/maint4)
"aI" = (/obj/structure/sign/halo_floorsign/maint{tag = "icon-maint (NORTH)"; icon_state = "maint"; dir = 1},/turf/unsimulated/floor{tag = "icon-plating"; icon_state = "plating"},/area/tranquility/shaftmaint)
"aJ" = (/obj/machinery/light/spot{dir = 8},/turf/simulated/open,/area/tranquility/shaft)
"aK" = (/obj/machinery/light/spot{dir = 4},/turf/simulated/open,/area/tranquility/shaft)
"aL" = (/obj/effect/decal/cleanable/dirt,/obj/machinery/vending/medical,/turf/unsimulated/floor{tag = "icon-white"; icon_state = "white"},/area/tranquility/infirmary)
"aM" = (/obj/machinery/vending/wallmed1,/turf/unsimulated/wall,/area/tranquility/infirmary)
"aN" = (/obj/effect/decal/cleanable/dirt,/obj/structure/closet/secure_closet/medical3,/obj/machinery/light{dir = 8},/turf/unsimulated/floor{tag = "icon-white"; icon_state = "white"},/area/tranquility/infirmary)
"aO" = (/obj/machinery/space_heater,/turf/unsimulated/floor{tag = "icon-white"; icon_state = "white"},/area/tranquility/infirmary)
"aP" = (/turf/unsimulated/wall,/area/tranquility/halls1)
"aQ" = (/obj/machinery/vending/wallmed1,/turf/unsimulated/wall,/area/tranquility/halls1)
"aR" = (/obj/machinery/door/airlock/halo_maint,/turf/unsimulated/floor{tag = "icon-plating"; icon_state = "plating"},/area/tranquility/shaftmaint)
"aS" = (/obj/structure/sign/warning/moving_parts,/turf/simulated/wall/r_wall,/area/tranquility/shaft)
"aT" = (/obj/effect/floor_decal/corner/yellow{tag = "icon-corner_white (NORTHWEST)"; icon_state = "corner_white"; dir = 9},/obj/effect/floor_decal/industrial/warning/dust{tag = "icon-warning_dust (NORTH)"; icon_state = "warning_dust"; dir = 1},/obj/effect/decal/cleanable/dirt,/turf/unsimulated/floor{tag = "icon-dark"; icon_state = "dark"},/area/tranquility/halls1)
"aU" = (/obj/effect/floor_decal/industrial/warning/dust{tag = "icon-warning_dust (NORTH)"; icon_state = "warning_dust"; dir = 1},/obj/effect/decal/cleanable/dirt,/turf/unsimulated/floor{tag = "icon-dark"; icon_state = "dark"},/area/tranquility/halls1)
"aV" = (/obj/effect/floor_decal/corner/yellow{tag = "icon-corner_white (SOUTHEAST)"; icon_state = "corner_white"; dir = 6},/obj/effect/floor_decal/industrial/warning/dust{tag = "icon-warning_dust (NORTH)"; icon_state = "warning_dust"; dir = 1},/turf/unsimulated/floor{tag = "icon-dark"; icon_state = "dark"},/area/tranquility/halls1)
"aW" = (/obj/structure/sign/warning/fall,/turf/unsimulated/wall,/area/tranquility/shaft)
"aX" = (/obj/structure/grille,/obj/structure/window/reinforced/full,/turf/simulated/floor/plating,/area/tranquility/infirmary)
"aY" = (/obj/machinery/door/airlock/halo_lifepod{name = "Airlock"},/turf/unsimulated/floor{tag = "icon-plating"; icon_state = "plating"},/area/tranquility/infirmary)
"aZ" = (/obj/structure/sign/bluecross_2,/turf/simulated/wall/r_wall,/area/tranquility/infirmary)
"ba" = (/turf/unsimulated/wall,/area/tranquility/maint4)
"bb" = (/turf/unsimulated/floor{tag = "icon-dark"; icon_state = "dark"},/area/tranquility/halls1)
"bc" = (/obj/effect/decal/cleanable/dirt,/turf/unsimulated/floor{tag = "icon-dark"; icon_state = "dark"},/area/tranquility/halls1)
"bd" = (/obj/effect/floor_decal/industrial/warning/dust{tag = "icon-warning_dust (EAST)"; icon_state = "warning_dust"; dir = 4},/turf/unsimulated/floor{tag = "icon-dark"; icon_state = "dark"},/area/tranquility/halls1)
"be" = (/obj/effect/floor_decal/corner/yellow{tag = "icon-corner_white (NORTHWEST)"; icon_state = "corner_white"; dir = 9},/obj/effect/decal/cleanable/dirt,/turf/unsimulated/floor{tag = "icon-dark"; icon_state = "dark"},/area/tranquility/halls1)
"bf" = (/obj/effect/floor_decal/corner/yellow{tag = "icon-corner_white (SOUTHEAST)"; icon_state = "corner_white"; dir = 6},/obj/effect/decal/cleanable/dirt,/turf/unsimulated/floor{tag = "icon-dark"; icon_state = "dark"},/area/tranquility/halls1)
"bg" = (/obj/effect/floor_decal/industrial/warning/dust{tag = "icon-warning_dust (WEST)"; icon_state = "warning_dust"; dir = 8},/turf/unsimulated/floor{tag = "icon-dark"; icon_state = "dark"},/area/tranquility/halls1)
"bh" = (/obj/effect/floor_decal/sign/m,/turf/unsimulated/floor{tag = "icon-dark"; icon_state = "dark"},/area/tranquility/halls1)
"bi" = (/obj/machinery/door/airlock/halo_maint,/turf/unsimulated/floor{tag = "icon-plating"; icon_state = "plating"},/area/tranquility/maint4)
"bj" = (/turf/unsimulated/wall{tag = "icon-0"; icon_state = "0"},/area/tranquility/maint3)
"bk" = (/obj/machinery/light,/turf/unsimulated/floor{tag = "icon-dark"; icon_state = "dark"},/area/tranquility/halls1)
"bl" = (/obj/effect/decal/cleanable/dirt,/obj/machinery/light,/turf/unsimulated/floor{tag = "icon-dark"; icon_state = "dark"},/area/tranquility/halls1)
"bm" = (/obj/effect/floor_decal/corner/yellow{tag = "icon-corner_white (NORTHWEST)"; icon_state = "corner_white"; dir = 9},/turf/unsimulated/floor{tag = "icon-dark"; icon_state = "dark"},/area/tranquility/halls1)
"bn" = (/obj/effect/floor_decal/corner/yellow{tag = "icon-corner_white (SOUTHEAST)"; icon_state = "corner_white"; dir = 6},/turf/unsimulated/floor{tag = "icon-dark"; icon_state = "dark"},/area/tranquility/halls1)
"bo" = (/turf/unsimulated/floor{tag = "icon-plating"; icon_state = "plating"},/area/tranquility/maint3)
"bp" = (/obj/machinery/light/small/red{tag = "icon-bulb1 (NORTH)"; icon_state = "bulb1"; dir = 1},/turf/unsimulated/floor{tag = "icon-plating"; icon_state = "plating"},/area/tranquility/maint3)
"bq" = (/obj/effect/decal/cleanable/cobweb2,/turf/unsimulated/floor{tag = "icon-plating"; icon_state = "plating"},/area/tranquility/maint3)
"br" = (/turf/unsimulated/wall{tag = "icon-0"; icon_state = "0"},/area/tranquility/maint1)
"bs" = (/turf/unsimulated/wall,/area/tranquility/maint1)
"bt" = (/obj/machinery/door/airlock/halo_maint,/turf/unsimulated/floor{tag = "icon-plating"; icon_state = "plating"},/area/tranquility/maint1)
"bu" = (/obj/structure/extinguisher_cabinet,/turf/unsimulated/wall,/area/tranquility/halls1)
"bv" = (/turf/unsimulated/wall,/area/tranquility/janitor)
"bw" = (/obj/structure/sign/halo_floorsign/cargobay{tag = "icon-cargobay (NORTH)"; icon_state = "cargobay"; dir = 1},/obj/effect/floor_decal/corner/yellow{tag = "icon-corner_white (NORTH)"; icon_state = "corner_white"; dir = 1},/turf/unsimulated/floor{tag = "icon-dark"; icon_state = "dark"},/area/tranquility/halls1)
"bx" = (/obj/structure/sign/halo_floorsign/cargobay{tag = "icon-cargobay (NORTH)"; icon_state = "cargobay"; dir = 1},/obj/effect/floor_decal/corner/yellow{tag = "icon-corner_white (EAST)"; icon_state = "corner_white"; dir = 4},/turf/unsimulated/floor{tag = "icon-dark"; icon_state = "dark"},/area/tranquility/halls1)
"by" = (/obj/effect/decal/cleanable/dirt,/turf/unsimulated/floor{tag = "icon-plating"; icon_state = "plating"},/area/tranquility/maint3)
"bz" = (/obj/structure/ladder,/turf/unsimulated/floor{tag = "icon-plating"; icon_state = "plating"},/area/tranquility/maint3)
"bA" = (/obj/effect/decal/cleanable/dirt,/turf/unsimulated/floor{tag = "icon-plating"; icon_state = "plating"},/area/tranquility/maint1)
"bB" = (/turf/unsimulated/floor{tag = "icon-plating"; icon_state = "plating"},/area/tranquility/maint1)
"bC" = (/obj/structure/mopbucket,/obj/effect/decal/cleanable/cobweb,/obj/item/weapon/mop,/turf/unsimulated/floor{tag = "icon-dark"; icon_state = "dark"},/area/tranquility/janitor)
"bD" = (/obj/structure/toilet,/turf/unsimulated/floor{tag = "icon-dark"; icon_state = "dark"},/area/tranquility/janitor)
"bE" = (/obj/machinery/light{dir = 8},/turf/unsimulated/floor{tag = "icon-dark"; icon_state = "dark"},/area/tranquility/halls1)
"bF" = (/obj/structure/sign/halo_floorsign/maint{tag = "icon-maint (NORTH)"; icon_state = "maint"; dir = 1},/turf/unsimulated/floor{tag = "icon-plating"; icon_state = "plating"},/area/tranquility/maint3)
"bG" = (/turf/unsimulated/wall,/area/tranquility/armory2)
"bH" = (/obj/effect/decal/cleanable/generic,/obj/machinery/light/small{dir = 8},/turf/unsimulated/floor{tag = "icon-dark"; icon_state = "dark"},/area/tranquility/janitor)
"bI" = (/obj/structure/sink{dir = 4; icon_state = "sink"; pixel_x = 10; tag = "icon-sink (EAST)"},/turf/unsimulated/floor{tag = "icon-dark"; icon_state = "dark"},/area/tranquility/janitor)
"bJ" = (/obj/structure/mirror,/turf/unsimulated/wall,/area/tranquility/janitor)
"bK" = (/obj/structure/sign/directions/supply{tag = "icon-direction_supply (NORTH)"; icon_state = "direction_supply"; dir = 1},/turf/unsimulated/wall,/area/tranquility/janitor)
"bL" = (/obj/effect/decal/cleanable/blood/oil,/turf/unsimulated/floor{tag = "icon-dark"; icon_state = "dark"},/area/tranquility/halls1)
"bM" = (/obj/structure/sign/directions/infirmary{tag = "icon-direction_infirm (EAST)"; icon_state = "direction_infirm"; dir = 4},/turf/unsimulated/wall,/area/tranquility/halls1)
"bN" = (/obj/structure/sign/warning/vent_port,/turf/unsimulated/wall{tag = "icon-0"; icon_state = "0"},/area/tranquility/maint3)
"bO" = (/obj/effect/decal/cleanable/cobweb,/turf/unsimulated/floor{tag = "icon-plating"; icon_state = "plating"},/area/tranquility/maint1)
"bP" = (/obj/structure/table/rack,/obj/item/weapon/gun/projectile/m6d_magnum,/obj/effect/decal/cleanable/cobweb,/turf/unsimulated/floor{tag = "icon-dark"; icon_state = "dark"},/area/tranquility/armory2)
"bQ" = (/obj/structure/table/rack,/obj/item/weapon/gun/projectile/m6d_magnum,/turf/unsimulated/floor{tag = "icon-dark"; icon_state = "dark"},/area/tranquility/armory2)
"bR" = (/obj/structure/table/rack,/obj/item/weapon/gun/projectile/ma5b_ar/MA37,/obj/effect/decal/cleanable/dirt,/turf/unsimulated/floor{tag = "icon-dark"; icon_state = "dark"},/area/tranquility/armory2)
"bS" = (/turf/unsimulated/wall,/area/tranquility/checkpoint)
"bT" = (/obj/machinery/door/airlock/halo,/turf/unsimulated/floor{tag = "icon-plating"; icon_state = "plating"},/area/tranquility/checkpoint)
"bU" = (/obj/structure/extinguisher_cabinet,/turf/unsimulated/wall,/area/tranquility/checkpoint)
"bV" = (/turf/unsimulated/wall{tag = "icon-rock-dark"; icon_state = "rock-dark"},/area/tranquility/maint3)
"bW" = (/obj/structure/sign/halo_floorsign/maint{tag = "icon-maint (EAST)"; icon_state = "maint"; dir = 4},/turf/unsimulated/floor{tag = "icon-plating"; icon_state = "plating"},/area/tranquility/maint1)
"bX" = (/obj/structure/ladder,/turf/unsimulated/floor{tag = "icon-plating"; icon_state = "plating"},/area/tranquility/maint1)
"bY" = (/obj/machinery/light/small{dir = 4},/turf/unsimulated/floor{tag = "icon-plating"; icon_state = "plating"},/area/tranquility/maint1)
"bZ" = (/obj/machinery/light{dir = 8},/turf/unsimulated/floor{tag = "icon-dark"; icon_state = "dark"},/area/tranquility/armory2)
"ca" = (/obj/effect/decal/cleanable/dirt,/turf/unsimulated/floor{tag = "icon-dark"; icon_state = "dark"},/area/tranquility/armory2)
"cb" = (/obj/machinery/door/airlock/halo_lifepod{name = "Airlock"},/turf/unsimulated/floor{tag = "icon-plating"; icon_state = "plating"},/area/tranquility/checkpoint)
"cc" = (/turf/unsimulated/floor{tag = "icon-steel"; icon_state = "steel"},/area/tranquility/checkpoint)
"cd" = (/obj/machinery/light{dir = 4; icon_state = "tube1"},/turf/unsimulated/floor{tag = "icon-dark"; icon_state = "dark"},/area/tranquility/halls1)
"ce" = (/obj/effect/decal/cleanable/cobweb,/turf/unsimulated/floor{tag = "icon-plating"; icon_state = "plating"},/area/tranquility/maint3)
"cf" = (/obj/structure/table/rack,/obj/item/ammo_magazine/m127_saphe,/obj/item/ammo_magazine/m127_saphe,/turf/unsimulated/floor{tag = "icon-dark"; icon_state = "dark"},/area/tranquility/armory2)
"cg" = (/obj/structure/table/rack,/obj/item/ammo_magazine/m762_ap/MA37,/obj/item/ammo_magazine/m762_ap/MA37,/turf/unsimulated/floor{tag = "icon-dark"; icon_state = "dark"},/area/tranquility/armory2)
"ch" = (/obj/structure/filingcabinet/chestdrawer,/turf/unsimulated/floor{tag = "icon-steel"; icon_state = "steel"},/area/tranquility/checkpoint)
"ci" = (/obj/effect/decal/cleanable/dirt,/turf/unsimulated/floor{tag = "icon-steel"; icon_state = "steel"},/area/tranquility/checkpoint)
"cj" = (/obj/structure/grille,/obj/structure/window/reinforced/full,/turf/simulated/floor/plating,/area/tranquility/checkpoint)
"ck" = (/obj/machinery/vending/security,/turf/unsimulated/floor{tag = "icon-steel"; icon_state = "steel"},/area/tranquility/checkpoint)
"cl" = (/obj/structure/filingcabinet/security,/obj/machinery/light{dir = 4; icon_state = "tube1"},/turf/unsimulated/floor{tag = "icon-steel"; icon_state = "steel"},/area/tranquility/checkpoint)
"cm" = (/obj/machinery/door/blast/regular/triple{id = 2},/turf/unsimulated/floor{tag = "icon-dark"; icon_state = "dark"},/area/tranquility/entrance)
"cn" = (/obj/effect/decal/cleanable/dirt,/turf/unsimulated/floor{tag = "icon-dark"; icon_state = "dark"},/area/tranquility/entrance)
"co" = (/turf/unsimulated/wall,/area/tranquility/entrance)
"cp" = (/turf/unsimulated/wall{tag = "icon-0"; icon_state = "0"},/area/tranquility/maint2)
"cq" = (/obj/machinery/space_heater,/obj/machinery/light{dir = 8},/turf/unsimulated/floor{tag = "icon-steel"; icon_state = "steel"},/area/tranquility/checkpoint)
"cr" = (/obj/structure/bed/chair{tag = "icon-chair_preview (EAST)"; icon_state = "chair_preview"; dir = 4},/turf/unsimulated/floor{tag = "icon-steel"; icon_state = "steel"},/area/tranquility/checkpoint)
"cs" = (/obj/machinery/door/window/eastleft,/obj/structure/table/steel,/obj/item/weapon/paper_bin,/obj/item/weapon/pen/red,/turf/simulated/floor/plating,/area/tranquility/checkpoint)
"ct" = (/turf/unsimulated/floor{tag = "icon-dark"; icon_state = "dark"},/area/tranquility/entrance)
"cu" = (/obj/machinery/light{dir = 4; icon_state = "tube1"},/turf/unsimulated/floor{tag = "icon-dark"; icon_state = "dark"},/area/tranquility/entrance)
"cv" = (/turf/unsimulated/wall{tag = "icon-rock-dark"; icon_state = "rock-dark"},/area/tranquility/maint2)
"cw" = (/obj/structure/sign/warning/vent_port,/turf/unsimulated/wall{tag = "icon-0"; icon_state = "0"},/area/tranquility/maint2)
"cx" = (/obj/effect/decal/cleanable/dirt,/turf/unsimulated/floor{tag = "icon-plating"; icon_state = "plating"},/area/tranquility/maint2)
"cy" = (/obj/machinery/vending/cigarette,/turf/unsimulated/floor{tag = "icon-steel"; icon_state = "steel"},/area/tranquility/checkpoint)
"cz" = (/obj/machinery/door/window/eastright,/obj/structure/table/steel,/obj/effect/decal/cleanable/generic,/obj/item/weapon/reagent_containers/spray/pepper,/turf/simulated/floor/plating,/area/tranquility/checkpoint)
"cA" = (/obj/machinery/vending/wallmed1,/turf/unsimulated/wall,/area/tranquility/entrance)
"cB" = (/turf/unsimulated/floor{tag = "icon-plating"; icon_state = "plating"},/area/tranquility/maint2)
"cC" = (/obj/structure/sign/halo_floorsign/maint{tag = "icon-maint (EAST)"; icon_state = "maint"; dir = 4},/turf/unsimulated/floor{tag = "icon-plating"; icon_state = "plating"},/area/tranquility/maint2)
"cD" = (/obj/structure/ladder,/turf/unsimulated/floor{tag = "icon-plating"; icon_state = "plating"},/area/tranquility/maint2)
"cE" = (/obj/machinery/light/small/red{tag = "icon-bulb1 (EAST)"; icon_state = "bulb1"; dir = 4},/turf/unsimulated/floor{tag = "icon-plating"; icon_state = "plating"},/area/tranquility/maint2)
"cF" = (/obj/structure/reagent_dispensers/peppertank,/turf/unsimulated/wall,/area/tranquility/checkpoint)
"cG" = (/obj/machinery/recharger/wallcharger,/turf/unsimulated/wall,/area/tranquility/checkpoint)
"cH" = (/obj/machinery/button/remote/blast_door{id = 2},/turf/unsimulated/wall,/area/tranquility/checkpoint)
"cI" = (/obj/machinery/light{dir = 8},/turf/unsimulated/floor{tag = "icon-dark"; icon_state = "dark"},/area/tranquility/entrance)
"cJ" = (/obj/machinery/door/blast/regular/triple,/obj/effect/decal/cleanable/dirt,/turf/unsimulated/floor{tag = "icon-plating"; icon_state = "plating"},/area/tranquility/entrance)
"cK" = (/turf/unsimulated/floor{tag = "icon-plating"; icon_state = "plating"},/area/tranquility/entrance)
"cL" = (/obj/effect/decal/cleanable/dirt,/turf/unsimulated/floor{tag = "icon-plating"; icon_state = "plating"},/area/tranquility/entrance)
"cM" = (/obj/structure/sign/warning/detailed{name = "\improper AUTHORIZED PERSONNEL ONLY"},/turf/unsimulated/wall,/area/tranquility/entrance)
"cN" = (/obj/machinery/light/small/red{tag = "icon-bulb1 (WEST)"; icon_state = "bulb1"; dir = 8},/turf/unsimulated/floor{tag = "icon-plating"; icon_state = "plating"},/area/tranquility/entrance)
"cO" = (/obj/machinery/button/remote/blast_door{id = 1},/turf/unsimulated/wall,/area/tranquility/entrance)
"cP" = (/turf/unsimulated/wall{tag = "icon-rock-dark"; icon_state = "rock-dark"},/area/tranquility/entrance)
"cQ" = (/obj/effect/decal/cleanable/cobweb2,/obj/effect/decal/cleanable/dirt,/turf/unsimulated/floor{tag = "icon-plating"; icon_state = "plating"},/area/tranquility/maint2)
"cR" = (/obj/structure/sign/warning/hot_exhaust,/turf/unsimulated/wall{tag = "icon-rock-dark"; icon_state = "rock-dark"},/area/tranquility/maint3)
"cS" = (/obj/structure/sign/warning/hot_exhaust,/turf/unsimulated/wall{tag = "icon-rock-dark"; icon_state = "rock-dark"},/area/tranquility/maint2)
"cT" = (/obj/effect/floor_decal/snow,/turf/unsimulated/floor{tag = "icon-plating"; icon_state = "plating"},/area/tranquility/entrance)
"cU" = (/obj/structure/grille,/turf/unsimulated/floor{tag = "icon-plating"; icon_state = "plating"},/area/tranquility/maint2)
"cV" = (/turf/unsimulated/floor{tag = "icon-snow"; icon_state = "snow"},/area/tranquility/outside)
"cW" = (/turf/unsimulated/floor{tag = "icon-snow"; icon_state = "snow"},/area/tranquility/random2)
"cX" = (/obj/structure/grille,/obj/effect/decal/cleanable/dirt,/turf/unsimulated/floor{tag = "icon-plating"; icon_state = "plating"},/area/tranquility/maint3)
"cY" = (/obj/effect/landmark/drop_pod_landing,/turf/unsimulated/floor{tag = "icon-snow"; icon_state = "snow"},/area/tranquility/outside)
"cZ" = (/turf/simulated/open,/area/tranquility/random2)
"da" = (/obj/effect/landmark/test/safe_turf,/turf/unsimulated/floor{tag = "icon-snow"; icon_state = "snow"},/area/tranquility/outside)
"db" = (/obj/effect/landmark/map_data{height = 4},/turf/unsimulated/floor{tag = "icon-snow"; icon_state = "snow"},/area/tranquility/outside)
"dc" = (/obj/effect/landmark/drop_pod_landing,/turf/unsimulated/floor{tag = "icon-snow"; icon_state = "snow"},/area/tranquility/random2)

(1,1,1) = {"
aaaaaaaaaaababababababababababababababababababababababababababababababababababababababababababababab
aaacacacaaababababababababababababababababababababababababababababababababababababababababababababab
aaacadacaaabababababababababababaeaeaeaeaeafaeaeaeaeaeababababababababababababababababababababababab
aaacacacaaabababababababababababaeagahahaiajaiahahahaeababababababababababababababababababababababab
aaaaaaaaaaabababababababakakalakaeahahamamanamamahahaeaoaoaoaoaoabababababapapapapapabababababababab
ababababababababababababakaqarasaeahahamamamamamahahaeatauavawaoapapapapapapaxayazapabababababababab
ababababababababababababakaqaAaqaeajajanamamamanajajaeaBaCaDaDaEapayayaxaxayaFaGaHapabababababababab
ababababababababababababakasaIaqaeaJahamamamamamahaKaeaLaCaCaCaMapaxapapapapayayaxapabababababababab
ababababababababababababakakasakaeahahamamamamamahahaeaNaDaDaOaoapaxapababapapapapapabababababababab
abababababaPaPaQaPaPaPaPakakaRakaeaeaSaeaTaUaVaeaWaeaeaXaXaYaZaobaaxapababababababababababababababab
abababababaPbbbcbcbbbbbcbbbbbbbcbbbcbcbdbebcbfbgbbbbbbbcbcbcbbbhbiayapababababababababbjbjbjbjbjabab
abababababaPbbbhbkbbbcbcbbblbcbcbcbcbkbdbmbcbnbgbbbkbbbcbbbbbkbbbaapapababababababababbjbobpbqbjabab
ababababbrbsbsbtbsaPaPbuaPaPaPbvbvbvbvbvbwbbbxaPaPaPaPaPaPaQaPbuaPababababababababababbjbybzbybjabab
ababababbrbAbBbBbrababababababbvbCbDbvbvbEbbbbaPabababababababababababababababababababbjbobFbybjabab
ababababbrbAbrbrbrbrbGbGbGbGbGbvbHbIbJbKbbbcbLbMabababababababababababababababababababbjbjbobNbjabab
ababababbrbAbrbObAbAbGbPbQbRbSbSbTbSbUbSbbbcbcaPababababababababababababababbVbVbVbVbVbVbVbybVababab
ababababbrbBbBbWbXbYbGbZcacacbccccccccbTbbbccdaPababababababababababababababbVcebybybobobybybVababab
ababababbrbrbrbAbAbBbGcfcfcgbSchcccicccjbcbcbbaPababababababababababababababbVbobVbVbVbVbVbVbVababab
ababababababbrbrbrbrbGbGbGbGbSckccciclbScmcncncoababababababababababababababbVbybVababababababababab
abababababcpcpcpcpcpababababbScqcicccrcsctcncucoababababababababababababababbVbybVababababababababab
abcvcvcvcvcwcxcxcxcpababababbScycccccrczcncncncAababababababababababababababbVbobVbVbVababababababab
abcvcxcBcBcBcCcDcEcpababababbSbScFcGcHbScIcncncoababababababababababababababbVbybybqbVababababababab
abcvcxcvcvcpcBcxcBcpabababababababababcocJcKcLcoababababababababababababababbVbVbVbobVababababababab
abcvcxcvabcpcpcpcpcpabababababababababcMcNcLcKcOababababababababababababababababbVbybVbVbVbVbVababab
abcvcBcvabababababababababababababababcPcKcLcLcPababababababababababababababababbVbybobybybybVababab
abcvcBcvcvcvabababababababababababababcPcLcLcLcPababababababababababababababababbVbVbVbVbVbobVababab
abcvcxcxcQcvabababababababababababababcPcLcKcLcPababababababababababababababababababababbVbocRbVabab
abcvcvcvcBcvcScvabababababababababababcPcKcKcKcPababababababababababababababababababababbVbybqbVabab
ababcvcvcxcxcQcvabababababababababababcPcTcTcTcPababababababababababababababababababababbVbVbobVabab
abababcvcvcvcxcvabababababababababababcPcTcTcTcPabababababababababababababababababababababbVbybVabab
ababababcvcvcUcvabababababababababcVcVcVcVcVcVabcWabcWcWabababababababababababababababababbVbybVabab
ababababababcVcVcVababababababcVcVcVcVcVcVcVcVcWcWcWcWcWcWababababababababcWcWababababababbVcXbVabab
ababcVcVcVcVcVcVcVcVcVcVcVcVcVcVcVcVcVcVcVcVcVcWcWcWcWcWcWcWababababababcWcWcWcWababababcWcWcWcWabab
cVcVcVcVcVcVcVcVcVcVcVcVcVcVcVcVcVcVcVcVcVcVcVcWcWcWcWcWcWcWcWcWcWcWcWcWcWcWcWcWcWcWcWcWcWcWcWcWcWcW
cVcVcVcVcVcVcVcVcVcVcVcVcVcVcVcVcVcVcVcVcVcVcVcWcWcWcWcWcWcWcWcWcWcWcWcWcWcWcWcWcWcWcWcWcWcWcWcWcWcW
cVcVcVcVcVcVcVcVcVcVcVcVcVcVcVcVcVcVcVcVcVcVcVcWcWcWcWcWcWcWcWcWcWcWcWcWcWcWcWcWcWcWcWcWcWcWcWcWcWcW
cVcVcVcVcVcVcVcVcVcVcVcVcVcVcYcVcVcVcVcVcVcVcVcWcWcWcWcWcWcWcWcWcWcWcWcWcWcWcWcWcWcWcWcWcWcWcWcWcWcW
cVcVcVcVcVcYcVcVcVcVcVcVcVcVcVcVcVcVcVcVcYcVcVcWcWcWcZcZcZcZcZcZcZcWcWcWcWcWcZcZcZcZcZcZcZcWcWcWcWcW
cVcVcVcVcVcVcVcVcVcVcVcVcVcVcVcVcVcVcVcVcVcVcVcWcWcWcZcZcZcZcZcZcZcWcWcWcWcWcZcZcZcZcZcZcZcWcWcWcWcW
cVcVcVcVcVcVcVcVcVcVcVcVcVcVcVcVcVcVcVcVcVcVcVcWcWcWcZcZcZcZcZcZcZcWcWcWcWcWcZcZcZcZcZcZcZcWcWcWcWcW
cVcVcVcVcVcVcVcVcVcVcVcVcVcVcVcVcVcVcVcVcVcVcVcWcWcWcZcZcZcZcZcZcZcWcWcWcWcWcZcZcZcZcZcZcZcWcWcWcWcW
cVcVcVcVcVcVcVcVcVcVcVcVcVcVcVcVcVcVcVcVcVcVcVcWcWcWcZcZcZcZcZcZcZcWcWcWcWcWcZcZcZcZcZcZcZcWcWcWcWcW
cVcVcVcVcVcVcVcVcVcVcVcVcVcVcVcVcVcVcVcVcVcVcVcWcWcWcZcZcZcZcZcZcZcWcWcWcWcWcZcZcZcZcZcZcZcWcWcWcWcW
cVcVcVcVcVcVcVcVcVcVcVcVcVcVcYcVcVcVcVcVcYcVcVcWcWcWcZcZcZcZcZcZcZcWcWcWcWcWcZcZcZcZcZcZcZcWcWcWcWcW
cVcVcVcVcVcYcVcVcVcVcVcVcVcVcVcVcVcVcVcVcVcVcVcWcWcWcWcWcWcWcWcWcWcWcWcWcWcWcWcWcWcWcWcWcWcWcWcWcWcW
cVcVcVcVcVcVcVcVcVcVcVcVcVcVcVcVcVcVcVcVcVcVcVcWcWcWcWcWcWcWcWcWcWcWcWcWcWcWcWcWcWcWcWcWcWcWcWcWcWcW
cVcVcVcVcVcVcVcVcVcVcVcVcVcVcVcVcVcVcVcVcVcVcVcWcWcWcWcWcWcWcWcWcWcWcWcWcWcWcWcWcWcWcWcWcWcWcWcWcWcW
cVcVcVcVdacVcVcVcVcVcVcVcVcVcVcVcVcVcVcVcVcVcVcWcWcWcWcWcWcWcWcWcWcWcWcWcWcWcWcWcWcWcWcWcWcWcWcWcWcW
cVdbcVcVcVcVcVcVcVcVcVcVcVcVcVcVcVcVcVcVcVcVcVcWcWcWcWcWcWcWcWcWcWcWcWcWcWcWcWcWcWcWcWcWcWcWcWcWcWcW
cVcVcVcVcVcVcVcVcVcVcVcVcVcVcYcVcVcVcVcVcVcVcVcWcWcWdccWcWcWcWcWdccWcWcWcWcWdccWcWcWcWcWcWcWcWcWcWdc
"}
