"a" = (/turf/space,/area/ship_battle/asteroid/asteroid_m1_1)
"b" = (/turf/space,/area/ship_battle/asteroid/asteroid_m1_2)
"c" = (/turf/unsimulated/mask,/area/ship_battle/asteroid/asteroid_m1_2)
"d" = (/turf/space,/area/shuttle/mining_shuttle/destination)
"e" = (/turf/simulated/floor/asteroid,/area/shuttle/mining_shuttle/destination)
"f" = (/turf/simulated/floor/asteroid,/area/ship_battle/asteroid/asteroid_m1_2)
"g" = (/turf/simulated/floor/asteroid,/area/ship_battle/asteroid/asteroid_m1_1)
"h" = (/turf/unsimulated/mask,/area/ship_battle/asteroid/asteroid_m1_1)
"i" = (/turf/space,/area/ship_battle/asteroid/asteroid_m1_3)
"j" = (/turf/unsimulated/mask,/area/ship_battle/asteroid/asteroid_m1_3)
"k" = (/turf/unsimulated/mask,/area/ship_battle/asteroid/asteroid_m1_4)
"l" = (/turf/simulated/floor/asteroid,/area/ship_battle/asteroid/asteroid_m1_4)
"m" = (/turf/space,/area/ship_battle/asteroid/asteroid_m1_4)
"n" = (/turf/simulated/floor/asteroid,/area/ship_battle/asteroid/asteroid_m1_3)
"o" = (/obj/effect/mapinfo/asteroid{dimensions_x = 75; dimensions_y = 75; landing_area = /area/shuttle/mining_shuttle/destination; name = "Medium Asteroid"; overmap_state = "asteroid_medium"},/turf/space,/area/ship_battle/asteroid/asteroid_m1_3)

(1,1,1) = {"
aaaaaaaaaaaaaaaaaaaaaaaaaaaaaaaaaaaaaabbbbbbbbbbbbbbbbbbbbbbbbbbbbbbbbbbbbb
aaaaaaaaaaaaaaaaaaaaaaaaaaaaaaaaaaaaaabbbbbbbbbbbbbbbbbbbbbbbbbbbbbbbbbbbbb
aaaaaaaaaaaaaaaaaaaaaaaaaaaaaaaaaaaaaabbbbbbbbbbbbbbbbbbbbbbbbbbbbbbbbbbbbb
aaaaaaaaaaaaaaaaaaaaaaaaaaaaaaaaaaaaaabbbbbbbbbbbbbbbbbbbbbbbbbbbbbbbbbbbbb
aaaaaaaaaaaaaaaaaaaaaaaaaaaaaaaaaaaaaabbbbbbbbbbbbbbbbbbbbbbbbbbbbbbbbbbbbb
aaaaaaaaaaaaaaaaaaaaaaaaaaaaaaaaaaaaaabbbbbbbbbbbbbbbbbbbbbbbbbbbbbbbbbbbbb
aaaaaaaaaaaaaaaaaaaaaaaaaaaaaaaaaaaaaabbbbbbbbbbbbbbbbbbbbbbbbbbbbbbbbbbbbb
aaaaaaaaaaaaaaaaaaaaaaaaaaaaaaaaaaaaaabbbbbbbbbbbbbbbbbbbbbbbbbbbbbbbbbbbbb
aaaaaaaaaaaaaaaaaaaaaaaaaaaaaaaaaaaaaabbbbbbbbbbbbbbbbbbbbbbbbbbbbbbbbbbbbb
aaaaaaaaaaaaaaaaaaaaaaaaaaaaaaaaaaaaaabbbbbbbbbbbccbbbbbbbbbbbbbbbbbbbbbbbb
aaaaaaaaaaaaaaaaaaaaaaaaaaaaaaaaaaaaaabbbbbbbbbbcccbbbbbbbbbbbbbbbbbbbbbbbb
aaaaaaaaaaaaaaaaaaaaaaaaaaaaaaaaaaaaaabbbbbbbbbbbcbbbbbbbbbbbbbbbbbbbbbbbbb
aaaaaaaaaaaaaaaaaaaaaaaaaaaaaaaaaaaaaabbbbbbbbbbbbbbbbbbbbbbbbbbbbbbbbbbbbb
aaaaaaaaaaaaaaaaaaaaaaaaaaaaaaaaaaaaaabbbbbbbbbbbbbbbbbbbbbbbbbbbbbbbbbbbbb
aaaaaaaaaaaaaaaaaaaaaaaaaaaaaaaaaaaaaabbbbbbbbbbbbbbbbbbbbbbbbbbbbbbbbbbbbb
aaaaaaaaaaaaaaaaaaaaaaaaaaaaaaaaddeeddedddddffbbbbbbbbbbbbbbbbbbbbbbbbbbbbb
aaaaaaaaaaaaaaaaaaaaaaaaaaaaaaaaeeeeeeeeeeeefffbbbbbbbbbbbbbbbbbbbbbbbbbbbb
aaaaaaaaaaaaaaaaaaaaaaaaaaaaaaaaeeeeeeeeeeeeffffbbbbbbbbbbcbbbbbbbbbbbbbbbb
aaaaaaaaaaaaaaaaaaaaaaaaaaaaaaageeeeeeeeeeeefffbbbbbbbbbcccbbbbbbbbbbbbbbbb
aaaaaaaaaaaaaaaaaaaaaaaaaaaaaaaaeeeeeeeeeeeeffffbbbbbbbbccccbbbbbbbbbbbbbbb
aaaaaaaaaaaaaaaaaaaaaaaaaaaaaagaeeeeeeeeeeeefffffbbbbbbccccccbbbbbbbbbbbbbb
aaaaaaaaaaaaaaaaaaaaaaaaaaaaaaggeeeeeeeeeeeeffffffffbbbbccccbbbbbbbbbbbbbbb
aaaaaaaaaaaaaahhhhaaaaaaaaaaagggeeeeeeeeeeeeffffffffbbbbccccbbbbbbbbbbbbbbb
aaaaaaaaaaaaahhhhhaaaaaagggaggggeeeeeeeeeeeefffffffffbbbbcccbbbbbbbbbbbbbbb
aaaaaaaaaaaahhhhhhhaaaaaagggggggeeeeeeeeeeeefffffcfcffbbbcbbbbbbbbbbbbbbbbb
aaaaaaaaaaaahhhhhhaaaaaaaggghgggeeeeeeeeeeeecfcffcfcccfbbbbbbbbbbbbbbbbbbbb
aaaaaaaaaaaahhhhhaaaaaaahhhhhgggeeeeeeeeeeeeffcffcfcccfbbbbbbbbbbbbbbbbbbbb
aaaaaaaaaaaahhhaaaaaaaahhhhhhhhhhgghhhfcfcfcffccffccccffbbbbbbbbbbbbbbbbbbb
aaaaaaaaaaaaaaaaaaaaaahhhhhhhhhhhhhhggfcccfccccccccccccfbbbbbbbbbbbbbbbbbbb
aaaaaaaaaaaaaaaaaaaaaaghhhhgghhhhhhgghccccfffffccccccccfbbbbbbbbbbbbbbbbbbb
aaaaaaaaaaaaaaaaaaaaahhhhhhgghhhgghhhhccffffcccccccccccffcbbbbbcccbbbbbbbbb
aaaaaaaaaaaaaaaaaaaaaghhhhhhghhhgghhhhfcfcccccccffccccffccbbbcccccbbbbbbbbb
aaaaaaaaaaaaaaahhaaagghhhhhghhhhghhhggccfccccccccfffffffccfbbbccccbbbbbbbbb
aaaaaaaaaaaaaaaahaaaghhhhhhhhhhhhhhhhgcccccccccccffffffffcfbbbcccccbbbbbbbb
aaaaaaaaaaaaaaaaaaagghhhhhhhhhhhhhhhhhcccccccccccfffffffcffbbbbccbbbbbbbbbb
iiiiiiiiiiiiiiiiiiiiijjjjjjjjjjjjjjjjkkkkkkkkkkkkkkkkkklllmmmmmmmmmmmmmmmmm
iiiiiiiiiiiiiiiiiiijnjjjjjjjjjjjjjjjjkkkkkkkkkkkkkklklklllmmmmmmmmmmmmmmmmm
iiiiiiiiiiiiiiiiijnjjjnjjjjjjjjjjjjjjkkkkkkkkkkkkkkkklkllllkmmmmmmmmmmmmmmm
iiiiiiiiiijjjiiiijnjjjjjjjjjjjjjjjjjjkkkkkkkkkkkkkkkklllllkkmmmmmmmmmmmmmmm
iiiiiiiiiijjjjjiijjjjjjjjjjjjjjjjjjnnkkkkkkkkkkkkkkklllllkkkmmmmmmmmmmmmmmm
iiiiiiiiiiijjjjijjjjjjjjjjjjjjjjjjjjjkkkkkkkkkkkkkkkkkkklmkkmmmmmmmmmmmmmmm
iiiiiiiiiiiiiiiiinjjjjjjjjjjjjjjjjjjjkkkkkkkkkkkkkkkkkkllkkmmmmmmmmmmmmmmmm
iiiiiiiiiiiiiiiiinnnnjjjjjjjjjjjjjjjjkkkkkkkkkkkkkkkkkllmmmmmmmmmmmmmmmmmmm
iiiiiiiiiiiiiiiiiiiinnnjjjjjjjjjjjjjjkkkkkllkkkkkkkkkkkkmmmmmmmmmmmmmmmmmmm
iiiiiiiiiiiiiiiiiiinnnjjjjjjjjjjjjjjjkkkkkkllkkkkkkkkkkkmmmmmmmmmmmmmmmmmmm
iiiiiiiiiiiiijjjiiiinjjjjjjjjjjjjjjjjkkkkkkkkkkkkkkkkkkkmmmmmmmmmmmmmmmmmmm
iiiiiiiiiiiiijjjiinnnnnjjjjjjjnjjjjjjkkkkkkkkkkkkkkkkkkklmmmmmmmmmmmmmmmmmm
iiiiiiiiiiiiiijiiinnnjjjjjjjjjnjjjjjjkkkkkkkkkkkkkkkkkkklmmmmmmmmmmmmmmmmmm
iiiiiiiiiiiiiiiiiijjjjjjjjjjjjjjjjjjjkkkkkkkkkkkkkkkkkkmmmmmmmmmmmmmmmmmmmm
iiiiiiiiiiiiiiiiiiiijjjjjjjjjjjjjjjjjkkkkkkkkkkkkkkkkkkmmmmmmmmmmmmmmmmmmmm
iiiiiiiiiiiiiiiiiiiijjjjjjjjjjjjjjjjjkkkkkkkkkkkkkkkkmmmmmmmmmmmmmmmmmmmmmm
iiiiiiiiiiiiiiiiiiiijjjjjjjjjjjjjjjjjkkkkkkkkkkkkkkkkkkmmmmmmmmmmmmmmmmmmmm
iiiiiiiiiiiiiiiiiiiinjnjjjjjjjjjjjjjjkkkkkkkkkkkkkkkkkkkmmmmmmmmmmmmmmmmmmm
iiiiiiiiiiiiiiiiiiiinnnjnjjjjjjjjjjjjkkkkkkkkkkkkkkklkkkmmmmmmmmmmmmmmmmmmm
iiiiiiiiiiiiiiiiiiiiiinnnnjjjjjjjjjjjkkkkllkkkkkkklkllmkmmmmmmmmmmmmmmmmmmm
iiiiiiiiiiiiiiiiiijiiiiiinjjjjjjjjjjjkkkkllllkkklklklmmmmmmmmmmmmmmmmmmmmmm
iiiiiiiiiiiiiiiiiiiiiiiiinnjjjjjjjjjjlkkllmmllllllllmmmmmmmmmmmmmmmmmmmmmmm
iiiiiiiiiiiiiiiiiiiiiiiiiinjjjjjjjjnjkkklmmmmmmmmmmmmmmmmmmmmmmmmmmmmmmmmmm
iiiiiiiiiiiiiiiiiiiiiiiiiinnjjnnnjnnnkllllmmmmmmmmmmmmmmmmmmmmmmmmmmmmmmmmm
iiiiiiiiiiiiiiiiiiiiiiiiiiinnnnnnnnnnllllmmmmmmmmmmmmmmmmmmmmmmmmmmmmmmmmmm
iiiiiiiiiiiiiiiiiiiiijnjjiiinnnnnnnnnllmmmmmmmmmmmmmmmmmmmmmmmmmmmmmmmmmmmm
iiiiiiiiiiiiiiiiiiiiiinjjjiiiiiiiiiiimmmmmmmmmmmmmmmmmmmmmmmmmmmmmmmmmmmmmm
iiiiiiiiiiiiiiiiiiiiiiiijjjjijiiiiiiimmmmmmmmmmmmmmmmmmmmmmmmmmmmmmmmmmmmmm
iiiiiiiiiiiiiiiiiiiiiiijjjjjjjniiiiiimmmmmmmmmmmmmmmmmmmmmmmmmmmmmmmmmmmmmm
iiiiiiiiiiiiiiiiiiiiiiiinjjjjjjnniiiimmmmmmmmmmmmmmmmmmmmmmmmmmmmmmmmmmmmmm
iiiiiiiiiiiiiiiiiiiiiiiinjjjjjjjjiiiimmmmmmmmmmmmmmmmmmmmmmmmmmmmmmmmmmmmmm
iiiiiiiiiiiiiiiiiiiiiiiinjjjjjjjjiiiimmmmmmmmmmmmmmmmmmmmmmmmmmmmmmmmmmmmmm
iiiiiiiiiiiiiiiiiiiiiiiinnnniiinniiiimmmmmmmmmmmmmmmmmmmmmmmmmmmmmmmmmmmmmm
iiiiiiiiiiiiiiiiiiiiiiiiiiniiiiniiiiimmmmmmmmmmmmmmmmmmmmmmmmmmmmmmmmmmmmmm
iiiiiiiiiiiiiiiiiiiiiiiiiiiiiiiniiiiimmmmmmmmmmmmmmmmmmmmmmmmmmmmmmmmmmmmmm
iiiiiiiiiiiiiiiiiiiiiiiiiiiiiiiiiiiiimmmmmmmmmmmmmmmmmmmmmmmmmmmmmmmmmmmmmm
iiiiiiiiiiiiiiiiiiiiiiiiiiiiiiiiiiiiimmmmmmmmmmmmmmmmmmmmmmmmmmmmmmmmmmmmmm
iiiiiiiiiiiiiiiiiiiiiiiiiiiiiiiiiiiiimmmmmmmmmmmmmmmmmmmmmmmmmmmmmmmmmmmmmm
iiiiiiiiiiiiiiiiiiiiiiiiiiiiiiiiiiiiimmmmmmmmmmmmmmmmmmmmmmmmmmmmmmmmmmmmmm
oiiiiiiiiiiiiiiiiiiiiiiiiiiiiiiiiiiiimmmmmmmmmmmmmmmmmmmmmmmmmmmmmmmmmmmmmm
"}
