"a" = (/obj/structure/barricade,/turf/simulated/floor/tiled,/area/space)
"b" = (/turf/simulated/floor/tiled,/area/space)
"c" = (/turf/simulated/mineral,/area/space)
"d" = (/obj/effect/landmark/test/safe_turf,/turf/simulated/floor/tiled,/area/space)
"e" = (/obj/effect/landmark/test/space_turf,/turf/space,/area/space)
"f" = (/turf/simulated/mineral,/area/planet/daynight)
"g" = (/obj/effect/landmark/spawn_medium,/turf/unsimulated/floor/grass,/area/planet/daynight)
"h" = (/turf/unsimulated/floor/grass,/area/planet/daynight/miner_base)
"i" = (/obj/effect/landmark/spawn_easy,/turf/unsimulated/floor/grass,/area/planet/daynight)
"j" = (/obj/effect/landmark/spawn_hard,/turf/unsimulated/floor/grass,/area/planet/daynight)
"k" = (/turf/unsimulated/floor/grass,/area/planet/daynight/covenant_landing)
"l" = (/obj/structure/closet/covenant,/turf/unsimulated/floor/grass,/area/planet/daynight/covenant_landing)
"m" = (/obj/effect/landmark/resupply_skip,/turf/unsimulated/floor/grass,/area/planet/daynight/covenant_landing)
"n" = (/obj/structure/destructible/covenant_barricade{dir = 1},/obj/structure/destructible/covenant_barricade{dir = 8},/turf/unsimulated/floor/grass,/area/planet/daynight/covenant_landing)
"o" = (/obj/structure/destructible/covenant_barricade{dir = 1},/turf/unsimulated/floor/grass,/area/planet/daynight/covenant_landing)
"p" = (/obj/structure/destructible/covenant_barricade{dir = 1},/obj/structure/destructible/covenant_barricade{dir = 4},/turf/unsimulated/floor/grass,/area/planet/daynight/covenant_landing)
"q" = (/obj/structure/energybarricade{dir = 1},/turf/unsimulated/floor/grass,/area/planet/daynight/covenant_landing)
"r" = (/obj/structure/destructible/covenant_barricade{dir = 8},/turf/unsimulated/floor/grass,/area/planet/daynight/covenant_landing)
"s" = (/obj/structure/destructible/covenant_barricade{dir = 4},/turf/unsimulated/floor/grass,/area/planet/daynight/covenant_landing)
"t" = (/obj/structure/destructible/covenant_barricade{dir = 8},/obj/structure/destructible/covenant_barricade,/turf/unsimulated/floor/grass,/area/planet/daynight/covenant_landing)
"u" = (/obj/structure/destructible/covenant_barricade,/turf/unsimulated/floor/grass,/area/planet/daynight/covenant_landing)
"v" = (/obj/machinery/floodlight/covenant/active,/turf/unsimulated/floor/grass,/area/planet/daynight/covenant_landing)
"w" = (/obj/effect/landmark/biome/forest,/turf/unsimulated/floor/grass,/area/planet/daynight)
"x" = (/obj/effect/landmark/assault_target_firefight,/turf/unsimulated/floor/grass,/area/planet/daynight/covenant_landing)
"y" = (/obj/structure/destructible/covenant_barricade{dir = 4},/obj/structure/destructible/covenant_barricade{dir = 4},/obj/structure/destructible/covenant_barricade{dir = 1},/turf/unsimulated/floor/grass,/area/planet/daynight/covenant_landing)
"z" = (/obj/effect/landmark/start/joinlate,/turf/unsimulated/floor/grass,/area/planet/daynight/covenant_landing)
"A" = (/obj/effect/landmark/resupply_openworld,/turf/unsimulated/floor/grass,/area/planet/daynight/covenant_landing)
"B" = (/obj/structure/destructible/covenant_barricade{dir = 4},/obj/structure/destructible/covenant_barricade{dir = 4},/obj/structure/destructible/covenant_barricade,/turf/unsimulated/floor/grass,/area/planet/daynight/covenant_landing)
"C" = (/obj/structure/energybarricade{dir = 8},/turf/unsimulated/floor/grass,/area/planet/daynight/covenant_landing)
"D" = (/obj/structure/grav_elevator_external,/obj/effect/landmark/start/joinlate,/turf/unsimulated/floor/grass,/area/planet/daynight/covenant_landing)
"E" = (/obj/structure/energybarricade{dir = 4},/turf/unsimulated/floor/grass,/area/planet/daynight/covenant_landing)
"F" = (/obj/structure/energybarricade,/turf/unsimulated/floor/grass,/area/planet/daynight/covenant_landing)
"G" = (/obj/item/stack/cable_coil,/turf/unsimulated/floor/grass,/area/planet/daynight/miner_base)
"H" = (/obj/structure/barricade,/turf/unsimulated/floor/grass,/area/planet/daynight/miner_base)
"I" = (/obj/item/stack/material/wood,/turf/unsimulated/floor/grass,/area/planet/daynight/miner_base)
"J" = (/obj/effect/gibspawner,/turf/unsimulated/floor/grass,/area/planet/daynight/miner_base)
"K" = (/obj/item/stack/barbedwire,/turf/unsimulated/floor/grass,/area/planet/daynight/miner_base)
"L" = (/obj/item/stack/material/steel,/turf/unsimulated/floor/grass,/area/planet/daynight/miner_base)
"M" = (/turf/unsimulated/floor/grass,/area/planet/daynight)
"N" = (/obj/item/stack/rods,/turf/unsimulated/floor/grass,/area/planet/daynight/miner_base)
"O" = (/obj/item/stack/material/stone,/turf/unsimulated/floor/grass,/area/planet/daynight/miner_base)
"P" = (/obj/effect/decal/cleanable/vomit,/turf/unsimulated/floor/grass,/area/planet/daynight/miner_base)
"Q" = (/obj/item/stack/material/wood/ten,/turf/unsimulated/floor/grass,/area/planet/daynight/miner_base)
"R" = (/obj/effect/landmark/corpse/syndicatesoldier,/turf/unsimulated/floor/grass,/area/planet/daynight/miner_base)
"S" = (/obj/effect/decal/cleanable/blood/oil,/turf/unsimulated/floor/grass,/area/planet/daynight/miner_base)
"T" = (/obj/structure/destructible/covenant_barricade{dir = 4},/obj/structure/destructible/covenant_barricade,/turf/unsimulated/floor/grass,/area/planet/daynight/covenant_landing)
"U" = (/obj/effect/evac_ship/spirit,/turf/unsimulated/floor/grass,/area/planet/daynight/covenant_landing)
"V" = (/obj/item/weapon/armor_patch/cov,/turf/unsimulated/floor/grass,/area/planet/daynight/covenant_landing)
"W" = (/obj/item/weapon/gun/energy/plasmapistol,/turf/unsimulated/floor/grass,/area/planet/daynight/covenant_landing)
"X" = (/obj/structure/closet/crate/random/covenant/medical,/turf/unsimulated/floor/grass,/area/planet/daynight/covenant_landing)
"Y" = (/obj/structure/closet/crate/random/covenant/construction,/turf/unsimulated/floor/grass,/area/planet/daynight/covenant_landing)
"Z" = (/obj/structure/bed/roller/covenant,/turf/unsimulated/floor/grass,/area/planet/daynight/covenant_landing)

(1,1,1) = {"
gjjjjjjjjjjjjjjjjjjjjjjjjjjjjjjjjjjjjjjjjjjjjjjjjjjjjjjjjjjjjjjjjjjjjjjjjjjjjjjjjjjjjjjjjjjjjjjjjjjj
gMMMMMMMMMMMMMMMMMMMMMMMMMMMMMMMMMMMMMMMMMMMMMMMMMMMMMMMMMMMMMMMMMMMMMMMMMMMMMMMMMMMMMMMMMMMMMMMMMMj
gMMMMMMMMMMMMMMMMMMMMMMMMMMMMMMMMMMMMMMMMMMMMMMMMMMMMMMMMMMMMMMMMMMMMMMMMMMMMMMMMMMMMMMMMMMMMMMMMMMj
gMMMMMMMMMMMMMMMMMMMMMMMMMMMMMMMMMMMMMMMMMMMMMMMMMMMMMMMMMMMMMMMMMMMMMMMMMMMMMMMMMMMMMMMMMMMMMMMMMMj
gMMMMMMMMMMMMMMMMMMMMMMMMMMMMMMMMMMMMMMMMMMMMMMMMMMMMMMMMMMMMMMMMMMMMMMMMMMMMMMMMhhhhhhhhhhhhhhhhMMj
gMMMMMMMMMMMMMMMMMMMMMMMMMMMMMMMMMMMMMMMMMMMMMMMMMMMMMMMMMMMMMMMMMMMMMMMMMMMMMMMMhhhhhGhhhhhhhhhhMMj
gMMMMMMMMMMMMMMMMMMMMMMMMMMMMMMMMMMMMMMMMMMMMMMMMMMMMMMMMMMMMMMMMMMMMMMMMMMMMMMMMhhhhhhhhhhhhhhhhMMj
gMMMMMMMMMMMMMMMMMMMMMMMMMMMMMMMMMMMMMMMMMMMMMMMMMMMMMMMMMMMMMMMMMMMMMMMMMMMMMMMMhhhHIHhHHhhhhhhhMMj
gMMMMMMMMMMMMMMMMMMMMMMMMMMMMMMMMMMMMMMMMMMMMMMMMMMMMMMMMMMMMMMMMMMMMMMMMMMMMMMMMhhhHhhhhHhhhJhhhMMj
gMMMMMMMMMMMMMMMMMMMMMMMMMMMMMMMMMMMMMMMMMMMMMMMMMMMMMMMMMMMMMMMMMMMMMMMMMMMMMMMMhKhHhJhhIhhhhhhhMMj
gMMMMMMMMMMMMMMMMMMMMMMMMMMMMMMMMMMMMMMMMMMMMMMMMMMMMMMMMMMMMMMMMMMMMMMMMMMMMMMMMhhhIhhLhIhhhhhhhMMj
gMMMMMMMMMMMMMMMMMMMMMMMMMMMMMMMMMMMMMMMMMMMMMMMMMMMMMMMMMMMMMMMMMMMMMMMMMMMMMMMMhhhHhhhhHhhhKhhhMMj
gMMMMMMMMMMMMMMMMMMMMMMMMMMMMMMMMMMMMMMMMMMMMMMMMMMMMMMMMMMMMMMMMMMMMMMMMMMMMMMMMhhhHIIIHHhhNhhhhMMj
gMMMMMMMMMMMMMMMMMMMMMMMMMMMMMMMMMMMMMMMMMMMMMMMMMMMMMMMMMMMMMMMMMMMMMMMMMMMMMMMMhhhhhhhhhhhhhhhhMMj
gMMMMMMMMMMMMMMMMMMMMMMMMMMMMMMMMMMMMMMMMMMMMMMMMMMMMMMMMMMMMMMMMMMMMMMMMMMMMMMMMhhhhhhhhhOhhhhPhMMj
gMMMMMMMMMMMMMMMMMMMMMMMMMMMMMMMMMMMMMMMMMMMMMMMMMMMMMMMMMMMMMMMMMMMMMMMMMMMMMMMMhhhQhhhhhhhhJhhhMMj
gMMMMMMMMMMMMMMMMMMMMMMMMMMMMMMMMMMMMMMMMMMMMMMMMMMMMMMMMMMMMMMMMMMMMMMMMMMMMMMMMhhhhQhhhhhhhhhhhMMj
gMMMMMMMMMMMMMMMMMMMMMMMMMMMMMMMMMMMMMMMMMMMMMMMMMMMMMMMMMMMMMMMMMMMMMMMMMMMMMMMMhhhhhJhhhRRRRRRhMMj
gMMMMMMMMMMMMMMMMMMMMMMMMMMMMMMMMMMMMMMMMMMMMMMMMMMMMMMMMMMMMMMMMMMMMMMMMMMMMMMMMhhhhhhhhhhhhhhhhMMj
gMMMMMMMMMMMMMMMMMMMMMMMMMMMMMMMMMMMMMMMMMMMMMMMMMMMMMMMMMMMMMMMMMMMMMMMMMMMMMMMMhhhhhhhhhhhhhhhhMMj
gMMMMMMMMMMMMMMMMMMMMMMMMMMMMMMMMMMMMMMMMMMMMMMMMMMMMMMMMMMMMMMMMMMMMMMMMMMMMMMMMhhhhhhhhShhhhhhhMMj
gMMMMMMMMMMMMMMMMMMMMMMMMMMMMMMMMMMMMMMMMMMMMMMMMMMMMMMMMMMMMMMMMMMMMMMMMMMMMMMMMhhhhhhhhhhhhhhhhMMj
gMMMMMMMMMMMMMMMMMMMMMMMMMMMMMMMMMMMMMMMMMMMMMMMMMMMMMMMMMMMMMMMMMMMMMMMMMMMMMMMMMMMMMMMMMMMMMMMMMMj
gMMMMMMMMMMMMMMMMMMMMMMMMMMMMMMMMMMMMMMMMMMMMMMMMMMMMMMMMMMMMMMMMMMMMMMMMMMMMMMMMMMMMMMMMMMMMMMMMMMj
gMMMMMMMMMMMMMMMMMMMMMMMMMMMMMMMMMMMMMMMMMMMMMMMMMMMMMMMMMMMMMMMMMMMMMMMMMMMMMMMMMMMMMMMMMMMMMMMMMMj
gMMMMMMMMMMMMMMMMMMMMMMMMMMMMMMMMMMMMMMMMMMMMMMMMMMMMMMMMMMMMMMMMMMMMMMMMMMMMMMMMMMMMMMMMMMMMMMMMMMj
gMMMMMMMMMMMMMMMMMMMMMMMMMMMMMMMMMMMMMMMMMMMMMMMMMMMMMMMMMMMMMMMMMMMMMMMMMMMMMMMMMMMMMMMMMMMMMMMMMMj
gMMMMMMMMMMMMMMMMMMMMMMMMMMMMMMMMMMMMMMMMMMMMMMMMMMMMMMMMMMMMMMMMMMMMMMMMMMMMMMMMMMMMMMMMMMMMMMMMMMj
gMMMMMMMMMMMMMMMMMMMMMMMMMMMMMMMMMMMMMMMMMMMMMMMMMMMMMMMMMMMMMMMMMMMMMMMMMMMMMMMMMMMMMMMMMMMMMMMMMMj
gMMMMMMMMMMMMMMMMMMMMMMMMMMMMMMMMMMMMMMMMMMMMMMMMMMMMMMMMMMMMMMMMMMMMMMMMMMMMMMMMMMMMMMMMMMMMMMMMMMj
gMMMMMMMMMMMMMMMMMMMMMMMMMMMMMMMMMMMMMMMMMMMMMMMMMMMMMMMMMMMMMMMMMMMMMMMMMMMMMMMMMMMMMMMMMMMMMMMMMMj
gMMMMMMMMMMMMMMMMMMMMMMMMMMMMMMMMMMMMMMMMMMMMMMMMMMMMMMMMMMMMMMMMMMMMMMMMMMMMMMMMMMMMMMMMMMMMMMMMMMj
gMMMMMMMMMMMMMMMMMMMMMMMMMMMMMMMMMMMMMMMMMMMMMMMMMMMMMMMMMMMMMMMMMMMMMMMMMMMMMMMMMMMMMMMMMMMMMMMMMMj
gMMMMMMMMMMMMMMMMMMMMMMMMMMMMMMMMMMMMMMMMMMMMMMMMMMMMMMMMMMMMMMMMMMMMMMMMMMMMMMMMMMMMMMMMMMMMMMMMMMj
gMMMMMMMMMMMMMMMMMMMMMMMMMMMMMMMMMMMMMMMMMMMMMMMMMMMMMMMMMMMMMMMMMMMMMMMMMMMMMMMMMMMMMMMMMMMMMMMMMMj
gMMMMMMMMMMMMMMMMMMMMMMMMMMMMMMMMMMMMMMMMMMMMMMMMMMMMMMMMMMMMMMMMMMMMMMMMMMMMMMMMMMMMMMMMMMMMMMMMMMj
gMMMMMMMMMMMMMMMMMMMMMMMMMMMMMMMMMMMMMMMMMMkkkkkkkkkkkkkkkkkkMMMMMMMMMMMMMMMMMMMMMMMMMMMMMMMMMMMMMMj
gMMMMMMMMMMMMMMMMMMMMMMMMMMMMMMMMMMMMMMMMMMklkkkkkkkklkkkkkkkMMMMMMMMMMMMMMMMMMMMMMMMMMMMMMMMMMMMMMj
gMMMMMMMMMMMMMMMMMMMMMMMMMMMMMMMMMMMMMMMMMMkkkkkkkkkkkkkkkkkkMMMMMMMMMMMMMMMMMMMMMMMMMMMMMMMMMMMMMMj
gMMMMMMMMMMMMMMMMMMMMMMMMMMMMMMMMMMMMMMMMMMkkkkkkkkkkkkkkkkkkkkkkMMMMMMMMMMMMMMMMMMMMMMMMMMMMMMMMMMj
gMMMMMMMMMMMMMMMMMMMMMMMMMMMMMMMMMMMMMMMMMMkkkkkqkkkkkkkkkkkkkkkkMMMMMMMMMMMMMMMMMMMMMMMMMMMMMMMMMMj
gMMMMMMMMMMMMMMMMMMMMMMMMMMMMMMMMMMMMMMMkkkkkkkkkkkkkkkkkkmkkkklkMMMMMMMMMMMMMMMMMMMMMMMMMMMMMMMMMMj
gMMMMMMMMMMMMMMMMMMMMMMMMMMMMMMMMMMMMMwMkkmkkkkkkkkkkknopkkkkkkkkMMMMMMMMMMMMMMMMMMMMMMMMMMMMMMMMMMj
gMMMMMMMMMMMMMMMMMMMMMMMMMMMMMMMMMMMMMMMkkknokkkWkkkkkrkskkkkkkkkMMMMMMMMMMMMMMMMMMMMMMMMMMMMMMMMMMj
gMMMMMMMMMMMMMMMMMMMMMMMMMMMMMMMMMMkkkkkkkkrkkkkkkkVkkkkkkkkkkkkkMMMMMMMMMMMMMMMMMMMMMMMMMMMMMMMMMMj
gMMMMMMMMMMMMMMMMMMMMMMMMMMMMMMMMMMkkkkkkkktukkkkkkkkkvkkkkkkkkkkMMMMMMMMMMMMMMMMMMMMMMMMMMMMMMMMMMj
gMMMMMMMMMMMMMMMMMMMMMMMMMMMMMMMMMMklkkkkkkkkkkkUkkkZkkkkkkkkkkkkkkkMMMMMMMMMMMMMMMMMMMMMMMMMMMMMMMj
gMMMMMMMMMMMMMMMMMMMMMMMMMMMMMMMMMMkkkkkkkkkkVkkkxkkkkkkkoykkkkkklkkMMMMMMMMMMMMMMMMMMMMMMMMMMMMMMMj
gMMMMMMMMMMMMMMMMMMMMMMMMMMMMMMMMMMMkkkkkkkkkkkkzzzzkmkWkkskkkkkkkkkMMMMMMMMMMMMMMMMMMMMMMMMMMMMMMMj
gMMMMMMMMMMMMMMMMMMMMMMMMMMMMMMMMMMMkkkkkkkvkkAkzzzzkkkkkuBkkkkkkkkkMMMMMMMMMMMMMMMMMMMMMMMMMMMMMMMj
gMMMMMMMMMMMMMMMMMMMMMMMMMMMMMMMMMMMkkkkCkkkYkkkzzzzkkXkkkkkkkkkkkkkMMMMMMMMMMMMMMMMMMMMMMMMMMMMMMMj
gMMMMMMMMMMMMMMMMMMMMMMMMMMMMMMMMMMMkkkkkkkkkkkkDzzzkkkkkkkkkkkkkkkkMMMMMMMMMMMMMMMMMMMMMMMMMMMMMMMj
gMMMMMMMMMMMMMMMMMMMMMMMMMMMMMMMMMMMkkkkkkkkWkkkkkkkkkvkkkEkkkkkkMMMMMMMMMMMMMMMMMMMMMMMMMMMMMMMMMMj
gMMMMMMMMMMMMMMMMMMMMMMMMMMMMMMMMMMMkkkkkkmkkkkkkkkkkkkkkkkkkkkkkMMMMMMMMMMMMMMMMMMMMMMMMMMMMMMMMMMj
gMMMMMMMMMMMMMMMMMMMMMMMMMMMMMMMMMMMkkkkkFkkkkkkkVkkkkkkkkkkkkkkkMMMMMMMMMMMMMMMMMMMMMMMMMMMMMMMMMMj
gMMMMMMMMMMMMMMMMMMMMMMMMMMMMMMMMMMMkkkkkkkkrkkkkkkkskkkmkkkkkklkMMMMMMMMMMMMMMMMMMMMMMMMMMMMMMMMMMj
gMMMMMMMMMMMMMMMMMMMMMMMMMMMMMMMMMMMMkkkkkkktuuuuuuuTkkkkkkkkkkkkMMMMMMMMMMMMMMMMMMMMMMMMMMMMMMMMMMj
gMMMMMMMMMMMMMMMMMMMMMMMMMMMMMMMMMMMMklkkkkkkkkkkkkkkkkkkkkkMMMMMMMMMMMMMMMMMMMMMMMMMMMMMMMMMMMMMMMj
gMMMMMMMMMMMMMMMMMMMMMMMMMMMMMMMMMMMMkkkkkkkkkkkkkkkkkkkkkkkMMMMMMMMMMMMMMMMMMMMMMMMMMMMMMMMMMMMMMMj
gMMMMMMMMMMMMMMMMMMMMMMMMMMMMMMMMMMMMkkkkkkkkkkkkkkkkkkkkkkkMMMMMMMMMMMMMMMMMMMMMMMMMMMMMMMMMMMMMMMj
gMMMMMMMMMMMMMMMMMMMMMMMMMMMMMMMMMMMMMMMMMMMMkkkkkkkkkkkkkkkMMMMMMMMMMMMMMMMMMMMMMMMMMMMMMMMMMMMMMMj
gMMMMMMMMMMMMMMMMMMMMMMMMMMMMMMMMMMMMMMMMMMMMkkkkkkkkkkklkkkMMMMMMMMMMMMMMMMMMMMMMMMMMMMMMMMMMMMMMMj
gMMMMMMMMMMMMMMMMMMMMMMMMMMMMMMMMMMMMMMMMMMMMkkklkkkkkkkkkkkMMMMMMMMMMMMMMMMMMMMMMMMMMMMMMMMMMMMMMMj
gMMMMMMMMMMMMMMMMMMMMMMMMMMMMMMMMMMMMMMMMMMMMkkkkkkkkMMMMMMMMMMMMMMMMMMMMMMMMMMMMMMMMMMMMMMMMMMMMMMj
gMMMMMMMMMMMMMMMMMMMMMMMMMMMMMMMMMMMMMMMMMMMMkkkkkkkkMMMMMMMMMMMMMMMMMMMMMMMMMMMMMMMMMMMMMMMMMMMMMMj
gMMMMMMMMMMMMMMMMMMMMMMMMMMMMMMMMMMMMMMMMMMMMMMMMMMMMMMMMMMMMMMMMMMMMMMMMMMMMMMMMMMMMMMMMMMMMMMMMMMj
gMMMMMMMMMMMMMMMMMMMMMMMMMMMMMMMMMMMMMMMMMMMMMMMMMMMMMMMMMMMMMMMMMMMMMMMMMMMMMMMMMMMMMMMMMMMMMMMMMMj
gMMMMMMMMMMMMMMMMMMMMMMMMMMMMMMMMMMMMMMMMMMMMMMMMMMMMMMMMMMMMMMMMMMMMMMMMMMMMMMMMMMMMMMMMMMMMMMMMMMj
gMMMMMMMMMMMMMMMMMMMMMMMMMMMMMMMMMMMMMMMMMMMMMMMMMMMMMMMMMMMMMMMMMMMMMMMMMMMMMMMMMMMMMMMMMMMMMMMMMMj
gMMMMMMMMMMMMMMMMMMMMMMMMMMMMMMMMMMMMMMMMMMMMMMMMMMMMMMMMMMMMMMMMMMMMMMMMMMMMMMMMMMMMMMMMMMMMMMMMMMj
gMMMMMMMMMMMMMMMMMMMMMMMMMMMMMMMMMMMMMMMMMMMMMMMMMMMMMMMMMMMMMMMMMMMMMMMMMMMMMMMMMMMMMMMMMMMMMMMMMMj
gMMMMMMMMMMMMMMMMMMMMMMMMMMMMMMMMMMMMMMMMMMMMMMMMMMMMMMMMMMMMMMMMMMMMMMMMMMMMMMMMMMMMMMMMMMMMMMMMMMj
gMMMMMMMMMMMMMMMMMMMMMMMMMMMMMMMMMMMMMMMMMMMMMMMMMMMMMMMMMMMMMMMMMMMMMMMMMMMMMMMMMMMMMMMMMMMMMMMMMMj
gMMMMMMMMMMMMMMMMMMMMMMMMMMMMMMMMMMMMMMMMMMMMMMMMMMMMMMMMMMMMMMMMMMMMMMMMMMMMMMMMMMMMMMMMMMMMMMMMMMj
gMMMMMMMMMMMMMMMMMMMMMMMMMMMMMMMMMMMMMMMMMMMMMMMMMMMMMMMMMMMMMMMMMMMMMMMMMMMMMMMMMMMMMMMMMMMMMMMMMMj
gMMMMMMMMMMMMMMMMMMMMMMMMMMMMMMMMMMMMMMMMMMMMMMMMMMMMMMMMMMMMMMMMMMMMMMMMMMMMMMMMMMMMMMMMMMMMMMMMMMj
gMMMMMMMMMMMMMMMMMMMMMMMMMMMMMMMMMMMMMMMMMMMMMMMMMMMMMMMMMMMMMMMMMMMMMMMMMMMMMMMMMMMMMMMMMMMMMMMMMMj
gMMMMMMMMMMMMMMMMMMMMMMMMMMMMMMMMMMMMMMMMMMMMMMMMMMMMMMMMMMMMMMMMMMMMMMMMMMMMMMMMMMMMMMMMMMMMMMMMMMj
gMMMMMMMMMMMMMMMMMMMMMMMMMMMMMMMMMMMMMMMMMMMMMMMMMMMMMMMMMMMMMMMMMMMMMMMMMMMMMMMMMMMMMMMMMMMMMMMMMMj
gMMMMMMMMMMMMMMMMMMMMMMMMMMMMMMMMMMMMMMMMMMMMMMMMMMMMMMMMMMMMMMMMMMMMMMMMMMMMMMMMMMMMMMMMMMMMMMMMMMj
gMMMMMMMMMMMMMMMMMMMMMMMMMMMMMMMMMMMMMMMMMMMMMMMMMMMMMMMMMMMMMMMMMMMMMMMMMMMMMMMMMMMMMMMMMMMMMMMMMMj
gMMMMMMMMMMMMMMMMMMMMMMMMMMMMMMMMMMMMMMMMMMMMMMMMMMMMMMMMMMMMMMMMMMMMMMMMMMMMMMMMMMMMMMMMMMMMMMMMMMj
gMMMMMMMMMMMMMMMMMMMMMMMMMMMMMMMMMMMMMMMMMMMMMMMMMMMMMMMMMMMMMMMMMMMMMMMMMMMMMMMMMMMMMMMMMMMMMMMMMMj
gMMMMMMMMMMMMMMMMMMMMMMMMMMMMMMMMMMMMMMMMMMMMMMMMMMMMMMMMMMMMMMMMMMMMMMMMMMMMMMMMMMMMMMMMMMMMMMMMMMj
gMMMMMMMMMMMMMMMMMMMMMMMMMMMMMMMMMMMMMMMMMMMMMMMMMMMMMMMMMMMMMMMMMMMMMMMMMMMMMMMMMMMMMMMMMMMMMMMMMMj
gMMMMMMMMMMMMMMMMMMMMMMMMMMMMMMMMMMMMMMMMMMMMMMMMMMMMMMMMMMMMMMMMMMMMMMMMMMMMMMMMMMMMMMMMMMMMMMMMMMj
gMMMMMMMMMMMMMMMMMMMMMMMMMMMMMMMMMMMMMMMMMMMMMMMMMMMMMMMMMMMMMMMMMMMMMMMMMMMMMMMMMMMMMMMMMMMMMMMMMMj
gMMMMMMMMMMMMMMMMMMMMMMMMMMMMMMMMMMMMMMMMMMMMMMMMMMMMMMMMMMMMMMMMMMMMMMMMMMMMMMMMMMMMMMMMMMMMMMMMMMj
gMMMMMMMMMMMMMMMMMMMMMMMMMMMMMMMMMMMMMMMMMMMMMMMMMMMMMMMMMMMMMMMMMMMMMMMMMMMMMMMMMMMMMMMMMMMMMMMMMMj
gMMMMMMMMMMMMMMMMMMMMMMMMMMMMMMMMMMMMMMMMMMMMMMMMMMMMMMMMMMMMMMMMMMMMMMMMMMMMMMMMMMMMMMMMMMMMMMMMMMj
gMMMMMMMMMMMMMMMMMMMMMMMMMMMMMMMMMMMMMMMMMMMMMMMMMMMMMMMMMMMMMMMMMMMMMMMMMMMMMMMMMMMMMMMMMMMMMMMMMMj
fMMMMMMMMMMMMMMMMMMMMMMMMMMMMMMMMMMMMMMMMMMMMMMMMMMMMMMMMMMMMMMMMMMMMMMMMMMMMMMMMMMMMMMMMMMMMMMMMMMj
ffMMMMMMMMMMMMMMMMMMMMMMMMMMMMMMMMMMMMMMMMMMMMMMMMMMMMMMMMMMMMMMMMMMMMMMMMMMMMMMMMMMMMMMMMMMMMMMMMMj
fffMMMMMMMMMMMMMMMMMMMMMMMMMMMMMMMMMMMMMMMMMMMMMMMMMMMMMMMMMMMMMMMMMMMMMMMMMMMMMMMMMMMMMMMMMMMMMMMMj
ffffMMMMMMMMMMMMMMMMMMMMMMMMMMMMMMMMMMMMMMMMMMMMMMMMMMMMMMMMMMMMMMMMMMMMMMMMMMMMMMMMMMMMMMMMMMMMMMMj
aaaffMMMMMMMMMMMMMMMMMMMMMMMMMMMMMMMMMMMMMMMMMMMMMMMMMMMMMMMMMMMMMMMMMMMMMMMMMMMMMMMMMMMMMMMMMMMMMMj
abbfffMMMMMMMMMMMMMMMMMMMMMMMMMMMMMMMMMMMMMMMMMMMMMMMMMMMMMMMMMMMMMMMMMMMMMMMMMMMMMMMMMMMMMMMMMMMMMj
cbdbaffMMMMMMMMMMMMMMMMMMMMMMMMMMMMMMMMMMMMMMMMMMMMMMMMMMMMMMMMMMMMMMMMMMMMMMMMMMMMMMMMMMMMMMMMMMMMj
ccbbafffMMMMMMMMMMMMMMMMMMMMMMMMMMMMMMMMMMMMMMMMMMMMMMMMMMMMMMMMMMMMMMMMMMMMMMMMMMMMMMMMMMMMMMMMMMMj
eccaaffffiiiiiiiiiiiiiiiiiiiiiiiiiiiiiiiiiiiiiiiiiiiiiiiiiiiiiiiiiiiiiiiiiiiiiiiiiiiiiiiiiiiiiiiiiii
"}
