//MAP CONVERTED BY dmm2tgm.py THIS HEADER COMMENT PREVENTS RECONVERSION, DO NOT REMOVE
"a" = (
/turf/template_noop,
/area/template_noop)
"b" = (
/obj/effect/decal/cleanable/blood/drip,
/turf/template_noop,
/area/template_noop)
"c" = (
/obj/item/stack/rods,
/turf/template_noop,
/area/template_noop)
"d" = (
/obj/item/stack/rods,
/obj/item/stack/material/ocp,
/turf/template_noop,
/area/template_noop)
"e" = (
/obj/item/stack/material/ocp,
/turf/template_noop,
/area/template_noop)
"f" = (
/obj/structure/lattice,
/obj/item/stack/material/ocp,
/obj/effect/scorcher,
/turf/template_noop,
/area/template_noop)
"g" = (
/obj/effect/paint/black,
/turf/simulated/wall/ocp_wall,
/area/map_template/marooned)
"h" = (
/obj/item/stack/material/ocp,
/obj/effect/scorcher,
/turf/template_noop,
/area/template_noop)
"i" = (
/obj/machinery/computer,
/obj/effect/floor_decal/corner/red/full,
/turf/simulated/floor/tiled/dark,
/area/map_template/marooned)
"j" = (
/obj/effect/floor_decal/corner/red{
	icon_state = "corner_white";
	dir = 9
	},
/obj/machinery/atmospherics/binary/oxyregenerator,
/turf/simulated/floor/tiled/dark,
/area/map_template/marooned)
"k" = (
/obj/effect/landmark/corpse/marooned_officer,
/obj/structure/bed/chair{
	dir = 1
	},
/obj/effect/decal/cleanable/blood,
/obj/item/weapon/gun/projectile/revolver/webley/marooned,
/turf/simulated/floor/tiled/dark,
/area/map_template/marooned)
"l" = (
/obj/item/clothing/accessory/medal/silver/marooned_medal{
	desc = "A heart-shaped bronze medal. Has Magnitka flag at top part and engraved name - H. Warda.";
	name = "\improper Magnitka medal"
	},
/obj/structure/table/steel_reinforced,
/obj/effect/floor_decal/corner/red{
	icon_state = "corner_white";
	dir = 6
	},
/obj/item/weapon/paper/marooned/note09,
/turf/simulated/floor/tiled/dark/usedup,
/area/map_template/marooned)
"m" = (
/obj/structure/lattice,
/obj/effect/scorcher,
/turf/template_noop,
/area/template_noop)
"n" = (
/obj/item/weapon/paper/marooned/note02{
	pixel_x = -3;
	pixel_y = -5
	},
/obj/item/weapon/paper/marooned/note01{
	pixel_x = 2;
	pixel_y = -1
	},
/obj/structure/table/steel_reinforced,
/obj/effect/floor_decal/corner/red{
	icon_state = "corner_white";
	dir = 9
	},
/turf/simulated/floor/tiled/dark/usedup,
/area/map_template/marooned)
"o" = (
/obj/machinery/space_heater,
/obj/effect/decal/cleanable/blood/drip,
/turf/simulated/floor/tiled/dark/usedup,
/area/map_template/marooned)
"p" = (
/obj/item/weapon/paper/marooned/note03{
	pixel_x = 2;
	pixel_y = 2
	},
/obj/structure/table/steel_reinforced,
/obj/effect/floor_decal/corner/red{
	icon_state = "corner_white";
	dir = 6
	},
/turf/simulated/floor/tiled/dark/usedup,
/area/map_template/marooned)
"r" = (
/obj/machinery/door/airlock/centcom,
/turf/simulated/floor/tiled/dark,
/area/map_template/marooned)
"s" = (
/obj/structure/closet/crate/freezer,
/obj/structure/handrai{
	icon_state = "handrail";
	dir = 4
	},
/obj/effect/floor_decal/industrial/outline,
/obj/effect/floor_decal/corner/red{
	icon_state = "corner_white";
	dir = 9
	},
/turf/simulated/floor/tiled/dark,
/area/map_template/marooned)
"t" = (
/obj/structure/closet/crate/freezer,
/obj/structure/handrai,
/turf/simulated/floor/tiled/dark,
/area/map_template/marooned)
"u" = (
/obj/item/weapon/paper/marooned/note06,
/obj/random/trash,
/obj/item/weapon/paper/marooned/note08,
/turf/simulated/floor/tiled/dark,
/area/map_template/marooned)
"v" = (
/obj/machinery/space_heater,
/obj/structure/handrai,
/turf/simulated/floor/tiled/dark,
/area/map_template/marooned)
"w" = (
/obj/machinery/suit_storage_unit/standard_unit,
/obj/effect/floor_decal/industrial/outline,
/obj/effect/floor_decal/corner/red{
	icon_state = "corner_white";
	dir = 6
	},
/turf/simulated/floor/tiled/dark,
/area/map_template/marooned)
"x" = (
/obj/structure/closet/crate/freezer,
/obj/item/weapon/paper/marooned/note04,
/obj/item/weapon/paper/marooned/note05{
	pixel_x = -3;
	pixel_y = 1
	},
/obj/structure/handrai{
	icon_state = "handrail";
	dir = 4
	},
/obj/effect/floor_decal/industrial/outline,
/obj/effect/floor_decal/corner/red{
	icon_state = "corner_white";
	dir = 9
	},
/turf/simulated/floor/tiled/dark,
/area/map_template/marooned)
"y" = (
/obj/item/trash/liquidfood,
/obj/item/trash/liquidfood,
/obj/effect/decal/cleanable/blood/drip,
/turf/simulated/floor/tiled/dark/usedup,
/area/map_template/marooned)
"z" = (
/obj/random/trash,
/turf/simulated/floor/tiled/dark/usedup,
/area/map_template/marooned)
"A" = (
/obj/item/weapon/paper/marooned/note07{
	pixel_x = 6
	},
/obj/random/trash,
/obj/effect/decal/cleanable/blood/drip,
/obj/structure/bed,
/turf/simulated/floor/tiled/dark,
/area/map_template/marooned)
"B" = (
/obj/structure/shuttle/engine/propulsion,
/obj/effect/scorcher,
/turf/template_noop,
/area/template_noop)
"C" = (
/obj/structure/handrai{
	icon_state = "handrail";
	dir = 4
	},
/obj/structure/bed/chair{
	icon_state = "chair_preview";
	dir = 4
	},
/obj/item/trash/liquidfood,
/obj/item/trash/liquidfood,
/obj/effect/floor_decal/industrial/outline,
/obj/effect/floor_decal/corner/red{
	icon_state = "corner_white";
	dir = 9
	},
/turf/simulated/floor/tiled/dark,
/area/map_template/marooned)
"D" = (
/obj/item/trash/liquidfood,
/obj/item/trash/liquidfood,
/turf/simulated/floor/tiled/dark/usedup,
/area/map_template/marooned)
"E" = (
/turf/simulated/floor/tiled/dark/usedup,
/area/map_template/marooned)
"F" = (
/obj/structure/handrai{
	icon_state = "handrail";
	dir = 4
	},
/obj/structure/bed/chair{
	icon_state = "chair_preview";
	dir = 4
	},
/obj/effect/floor_decal/industrial/outline,
/obj/effect/floor_decal/corner/red{
	icon_state = "corner_white";
	dir = 9
	},
/turf/simulated/floor/tiled/dark,
/area/map_template/marooned)
"G" = (
/obj/item/weapon/wirecutters,
/obj/item/stack/cable_coil,
/obj/machinery/power/port_gen/pacman/super,
/obj/structure/cable{
	icon_state = "0-5";
	dir = 8
	},
/obj/effect/floor_decal/floordetail/traction,
/turf/simulated/floor/tiled/dark/usedup,
/area/map_template/marooned)
"H" = (
/obj/effect/floor_decal/floordetail/traction,
/obj/effect/decal/cleanable/blood/drip,
/turf/simulated/floor/tiled/dark/usedup,
/area/map_template/marooned)
"I" = (
/obj/effect/floor_decal/floordetail/traction,
/turf/simulated/floor/tiled/dark,
/area/map_template/marooned)
"J" = (
/obj/structure/inflatable/wall,
/obj/structure/handrai{
	icon_state = "handrail";
	dir = 4
	},
/obj/effect/floor_decal/industrial/warning,
/turf/simulated/floor/tiled/dark,
/area/map_template/marooned)
"K" = (
/obj/structure/inflatable/door,
/obj/structure/cable{
	icon_state = "1-6";
	dir = 1
	},
/obj/effect/floor_decal/industrial/warning,
/turf/simulated/floor/tiled/dark,
/area/map_template/marooned)
"L" = (
/obj/structure/inflatable/wall,
/obj/structure/handrai{
	icon_state = "handrail";
	dir = 8
	},
/obj/effect/floor_decal/industrial/warning,
/turf/simulated/floor/tiled/dark,
/area/map_template/marooned)
"M" = (
/obj/structure/inflatable/door,
/obj/structure/cable{
	icon_state = "2-5";
	dir = 1
	},
/obj/effect/floor_decal/industrial/warning,
/obj/machinery/door/airlock/centcom,
/turf/simulated/floor/tiled/dark,
/area/map_template/marooned)
"N" = (
/obj/structure/fuel_port,
/obj/effect/paint/black,
/turf/simulated/wall/ocp_wall,
/area/map_template/marooned)
"O" = (
/obj/structure/inflatable/wall,
/obj/structure/cable{
	icon_state = "2-5";
	dir = 2
	},
/obj/effect/scorcher,
/turf/template_noop,
/area/template_noop)
"P" = (
/obj/structure/inflatable/door,
/obj/effect/scorcher,
/turf/template_noop,
/area/template_noop)
"Q" = (
/obj/structure/inflatable/wall,
/obj/effect/scorcher,
/turf/template_noop,
/area/template_noop)
"R" = (
/obj/structure/cable{
	icon_state = "2-5";
	dir = 1
	},
/obj/effect/scorcher,
/turf/template_noop,
/area/template_noop)
"S" = (
/obj/effect/paint/black,
/turf/simulated/wall/ocp_wall,
/area/template_noop)
"T" = (
/obj/item/weapon/computer_hardware/battery_module{
	pixel_x = -7;
	pixel_y = 0
	},
/obj/item/weapon/material/wirerod{
	desc = "Metal rod with wire attached to it.";
	name = "Jurry-rigged antenna";
	pixel_x = 5;
	pixel_y = 3
	},
/obj/item/device/radio,
/obj/item/stack/cable_coil,
/obj/structure/cable{
	icon_state = "0-6";
	dir = 4
	},
/obj/structure/cable{
	icon_state = "0-4";
	d2 = 4
	},
/obj/effect/scorcher,
/turf/template_noop,
/area/template_noop)
"U" = (
/obj/structure/cable{
	d1 = 4;
	d2 = 8;
	icon_state = "4-8";
	pixel_x = 0
	},
/obj/effect/scorcher,
/turf/template_noop,
/area/template_noop)
"V" = (
/obj/item/weapon/material/wirerod{
	desc = "Metal rod with wire attached to it.";
	name = "Jurry-rigged antenna";
	pixel_x = 5;
	pixel_y = 3
	},
/obj/structure/cable{
	d2 = 8;
	icon_state = "0-8"
	},
/obj/effect/scorcher,
/turf/template_noop,
/area/template_noop)
"W" = (
/obj/effect/decal/cleanable/blood/drip,
/obj/effect/scorcher,
/turf/template_noop,
/area/template_noop)
"Z" = (
/obj/effect/scorcher,
/turf/template_noop,
/area/template_noop)

(1,1,1) = {"
a
a
a
a
a
a
a
a
a
a
a
a
a
a
a
a
a
a
a
a
a
a
a
a
a
a
a
a
a
a
"}
(2,1,1) = {"
a
a
c
a
a
a
a
a
a
a
a
a
a
a
a
a
a
a
a
a
a
a
a
a
a
a
a
a
a
a
"}
(3,1,1) = {"
a
a
a
a
a
a
a
a
Z
g
g
B
Z
Z
Z
Z
Z
Z
Z
Z
a
a
a
a
a
a
a
a
a
a
"}
(4,1,1) = {"
a
a
a
a
a
a
a
Z
Z
g
g
B
Z
Z
Z
Z
Z
Z
Z
Z
Z
a
a
a
a
a
a
a
a
a
"}
(5,1,1) = {"
a
a
a
a
e
h
g
g
g
g
g
g
g
g
Z
Z
Z
Z
Z
Z
Z
Z
a
a
a
a
a
a
a
a
"}
(6,1,1) = {"
a
a
a
a
f
g
g
g
g
s
x
C
F
g
g
Z
Z
T
Z
Z
Z
a
a
a
a
a
a
a
a
a
"}
(7,1,1) = {"
a
a
a
a
g
g
j
n
g
t
y
D
G
J
g
O
R
U
Z
Z
Z
a
a
a
a
a
a
a
a
a
"}
(8,1,1) = {"
a
a
a
a
g
i
k
o
r
u
z
E
H
K
M
P
Z
U
Z
Z
Z
a
a
a
a
a
a
a
a
a
"}
(9,1,1) = {"
a
a
a
a
g
g
l
p
g
v
A
E
I
L
g
Q
Z
U
Z
Z
Z
Z
a
a
a
a
a
a
a
a
"}
(10,1,1) = {"
a
a
a
a
g
g
g
g
g
w
w
w
w
g
N
Z
Z
U
Z
Z
Z
Z
a
a
a
a
a
a
a
a
"}
(11,1,1) = {"
a
a
a
a
Z
Z
m
g
g
g
g
g
g
g
Z
Z
Z
U
W
Z
a
a
a
a
a
a
a
a
a
a
"}
(12,1,1) = {"
a
a
a
a
Z
Z
Z
Z
Z
m
m
Z
Z
h
Z
Z
Z
V
Z
Z
a
a
a
a
a
a
a
a
a
a
"}
(13,1,1) = {"
a
a
a
a
Z
Z
Z
Z
h
Z
Z
Z
Z
Z
b
a
a
a
a
a
a
a
a
a
a
a
a
a
a
a
"}
(14,1,1) = {"
a
a
a
a
a
a
Z
Z
Z
Z
Z
Z
a
a
a
a
a
a
a
a
a
a
a
a
a
a
a
c
a
a
"}
(15,1,1) = {"
a
a
a
d
a
a
a
a
a
a
a
a
a
a
a
a
a
a
a
a
a
a
a
a
a
a
a
a
a
a
"}
(16,1,1) = {"
a
a
a
a
a
a
a
a
a
a
a
a
a
a
a
a
a
e
a
a
a
a
a
a
a
a
a
a
a
a
"}
(17,1,1) = {"
a
a
a
a
a
a
a
a
a
a
a
a
a
a
a
a
c
c
a
a
a
a
a
a
a
a
a
a
a
a
"}
(18,1,1) = {"
a
a
a
a
a
a
a
a
c
a
a
a
a
a
a
a
a
a
a
a
a
a
a
a
a
a
a
a
a
a
"}
(19,1,1) = {"
a
a
a
a
a
a
a
a
b
a
a
a
a
a
a
a
a
a
a
a
e
a
a
a
a
a
a
a
a
a
"}
(20,1,1) = {"
a
a
a
a
a
a
a
a
a
a
a
a
a
a
a
a
a
a
a
a
a
a
a
a
a
a
a
a
a
a
"}
(21,1,1) = {"
a
a
a
a
a
a
a
a
a
a
a
a
a
a
e
a
a
a
a
a
a
a
a
a
a
a
a
a
a
a
"}
(22,1,1) = {"
a
a
a
a
a
a
e
a
a
a
a
a
a
a
a
a
a
a
a
a
a
a
a
a
a
a
a
c
a
a
"}
(23,1,1) = {"
a
a
a
a
a
a
a
a
a
a
a
a
a
a
a
a
a
a
a
a
a
a
a
a
a
a
a
a
a
a
"}
(24,1,1) = {"
a
b
a
a
a
a
a
c
a
a
a
a
a
a
a
a
a
a
a
a
a
a
a
a
a
a
a
a
a
a
"}
(25,1,1) = {"
a
a
a
a
a
a
a
a
a
a
a
a
a
a
a
a
Z
Z
a
a
a
a
a
a
a
a
a
a
a
a
"}
(26,1,1) = {"
a
a
a
a
a
a
a
a
a
a
a
a
a
a
a
Z
Z
Z
Z
a
a
a
a
a
a
a
a
a
a
a
"}
(27,1,1) = {"
a
a
a
c
a
a
a
a
a
a
a
a
a
a
Z
Z
S
S
B
a
a
a
a
a
a
a
a
a
a
a
"}
(28,1,1) = {"
a
a
a
a
a
a
a
a
a
a
a
a
a
a
Z
Z
S
S
B
a
a
a
a
a
a
a
a
a
a
a
"}
(29,1,1) = {"
a
a
a
a
a
a
a
a
a
a
a
a
a
a
a
Z
Z
Z
a
a
a
a
a
a
a
a
c
a
a
a
"}
(30,1,1) = {"
a
a
a
a
a
a
a
a
a
a
a
a
a
a
a
a
a
a
a
a
a
a
a
a
a
a
a
a
a
a
"}
