"aa" = (/turf/space,/area/space)
"ab" = (/turf/simulated/wall/r_wall,/area/commando_ship/urfs_avarice)
"ac" = (/turf/simulated/wall/r_wall,/area/commando_ship/urfs_avarice/medicalbay)
"ad" = (/obj/machinery/chemical_dispenser/full,/obj/item/weapon/reagent_containers/glass/beaker/large,/turf/simulated/floor/tiled/white,/area/commando_ship/urfs_avarice/medicalbay)
"ae" = (/obj/machinery/chem_master,/turf/simulated/floor/tiled/white,/area/commando_ship/urfs_avarice/medicalbay)
"af" = (/obj/machinery/light/spot{tag = "icon-tube1 (NORTH)"; icon_state = "tube1"; dir = 1},/turf/simulated/floor/tiled/white,/area/commando_ship/urfs_avarice/medicalbay)
"ag" = (/obj/item/weapon/storage/firstaid/fire,/obj/item/weapon/storage/firstaid/fire,/obj/structure/table/rack,/turf/simulated/floor/tiled/white,/area/commando_ship/urfs_avarice/medicalbay)
"ah" = (/obj/item/weapon/storage/firstaid/combat,/obj/item/weapon/storage/firstaid/combat,/obj/structure/table/rack,/turf/simulated/floor/tiled/white,/area/commando_ship/urfs_avarice/medicalbay)
"ai" = (/obj/machinery/chemical_dispenser/ert,/obj/item/weapon/reagent_containers/glass/beaker/large,/turf/simulated/floor/tiled/white,/area/commando_ship/urfs_avarice/medicalbay)
"aj" = (/turf/simulated/floor/tiled/white,/area/commando_ship/urfs_avarice/medicalbay)
"ak" = (/obj/item/weapon/storage/firstaid/regular,/obj/item/weapon/storage/firstaid/regular,/obj/structure/table/rack,/turf/simulated/floor/tiled/white,/area/commando_ship/urfs_avarice/medicalbay)
"al" = (/obj/structure/table/standard,/obj/item/weapon/storage/box/gloves,/turf/simulated/floor/tiled/white,/area/commando_ship/urfs_avarice/medicalbay)
"am" = (/obj/structure/table/standard,/obj/item/weapon/storage/box/beakers,/turf/simulated/floor/tiled/white,/area/commando_ship/urfs_avarice/medicalbay)
"an" = (/obj/machinery/iv_drip,/turf/simulated/floor/tiled/white,/area/commando_ship/urfs_avarice/medicalbay)
"ao" = (/obj/item/weapon/storage/firstaid/adv,/obj/item/weapon/storage/firstaid/adv,/obj/structure/table/rack,/turf/simulated/floor/tiled/white,/area/commando_ship/urfs_avarice/medicalbay)
"ap" = (/obj/docking_umbilical/north{name = "URFS Avarice Umbilical 1"},/turf/simulated/wall/r_wall,/area/commando_ship/urfs_avarice)
"aq" = (/turf/simulated/wall/r_wall,/area/commando_ship/urfs_avarice/Armory)
"ar" = (/obj/structure/table/standard,/obj/item/weapon/storage/box/masks,/turf/simulated/floor/tiled/white,/area/commando_ship/urfs_avarice/medicalbay)
"as" = (/obj/item/weapon/storage/firstaid/toxin,/obj/item/weapon/storage/firstaid/toxin,/obj/structure/table/rack,/turf/simulated/floor/tiled/white,/area/commando_ship/urfs_avarice/medicalbay)
"at" = (/obj/machinery/light/spot{tag = "icon-tube1 (NORTH)"; icon_state = "tube1"; dir = 1},/turf/simulated/floor/tiled/dark,/area/commando_ship/urfs_avarice)
"au" = (/turf/simulated/floor/tiled/dark,/area/commando_ship/urfs_avarice)
"av" = (/obj/structure/table/rack,/turf/simulated/floor/tiled/dark,/area/commando_ship/urfs_avarice/Armory)
"aw" = (/obj/structure/table/rack,/obj/machinery/light/spot{tag = "icon-tube1 (NORTH)"; icon_state = "tube1"; dir = 1},/turf/simulated/floor/tiled/dark,/area/commando_ship/urfs_avarice/Armory)
"ax" = (/obj/structure/table/standard,/obj/item/weapon/storage/box/masks,/obj/item/weapon/storage/box/gloves,/turf/simulated/floor/tiled/white,/area/commando_ship/urfs_avarice/medicalbay)
"ay" = (/obj/machinery/optable,/obj/machinery/oxygen_pump/anesthetic{name = "anesthetic pump  "; pixel_y = 30},/turf/simulated/floor/tiled/white,/area/commando_ship/urfs_avarice/medicalbay)
"az" = (/obj/structure/table/standard,/obj/item/weapon/storage/firstaid/surgery,/turf/simulated/floor/tiled/white,/area/commando_ship/urfs_avarice/medicalbay)
"aA" = (/obj/structure/grille,/obj/structure/window/reinforced/full,/obj/machinery/door/firedoor,/turf/simulated/floor/tiled/white,/area/commando_ship/urfs_avarice/medicalbay)
"aB" = (/obj/machinery/sleeper{tag = "icon-sleeper_0 (EAST)"; icon_state = "sleeper_0"; dir = 4},/turf/simulated/floor/tiled/white,/area/commando_ship/urfs_avarice/medicalbay)
"aC" = (/obj/item/weapon/storage/firstaid/o2,/obj/item/weapon/storage/firstaid/o2,/obj/structure/table/rack,/turf/simulated/floor/tiled/white,/area/commando_ship/urfs_avarice/medicalbay)
"aD" = (/turf/simulated/wall/r_wall,/area/commando_ship/urfs_avarice/observation)
"aE" = (/obj/structure/grille,/obj/structure/window/reinforced/full,/obj/machinery/door/firedoor,/turf/simulated/floor,/area/commando_ship/urfs_avarice/observation)
"aF" = (/turf/simulated/floor/tiled/dark,/area/commando_ship/urfs_avarice/Armory)
"aG" = (/obj/structure/table/standard,/obj/item/weapon/defibrillator/loaded,/obj/machinery/light/spot{tag = "icon-tube1 (WEST)"; icon_state = "tube1"; dir = 8},/turf/simulated/floor/tiled/white,/area/commando_ship/urfs_avarice/medicalbay)
"aH" = (/obj/structure/bed,/obj/item/weapon/bedsheet/medical,/turf/simulated/floor/tiled/white,/area/commando_ship/urfs_avarice/medicalbay)
"aI" = (/obj/machinery/body_scanconsole{tag = "icon-body_scannerconsole (EAST)"; icon_state = "body_scannerconsole"; dir = 4},/turf/simulated/floor/tiled/white,/area/commando_ship/urfs_avarice/medicalbay)
"aJ" = (/obj/machinery/bodyscanner{tag = "icon-body_scanner_0 (EAST)"; icon_state = "body_scanner_0"; dir = 4},/turf/simulated/floor/tiled/white,/area/commando_ship/urfs_avarice/medicalbay)
"aK" = (/obj/structure/fitness/weightlifter,/turf/simulated/floor/carpet,/area/commando_ship/urfs_avarice/observation)
"aL" = (/turf/simulated/floor/carpet,/area/commando_ship/urfs_avarice/observation)
"aM" = (/obj/machinery/organ_printer/flesh/mapped{max_stored_matter = 1e+007},/turf/simulated/floor/tiled/white,/area/commando_ship/urfs_avarice/medicalbay)
"aN" = (/obj/machinery/door/airlock/halo,/obj/machinery/door/firedoor,/turf/simulated/floor/tiled/white,/area/commando_ship/urfs_avarice/medicalbay)
"aO" = (/obj/machinery/light/spot,/turf/simulated/floor/tiled/white,/area/commando_ship/urfs_avarice/medicalbay)
"aP" = (/obj/structure/cable/blue{icon_state = "2-4"},/turf/simulated/floor/tiled/white,/area/commando_ship/urfs_avarice/medicalbay)
"aQ" = (/obj/structure/cable/blue{icon_state = "4-8"},/turf/simulated/floor/tiled/white,/area/commando_ship/urfs_avarice/medicalbay)
"aR" = (/obj/machinery/power/apc{dir = 4; name = "APC"; pixel_x = 24; pixel_y = 0},/obj/structure/cable/blue{icon_state = "0-8"},/turf/simulated/floor/tiled/white,/area/commando_ship/urfs_avarice/medicalbay)
"aS" = (/obj/structure/fitness/punchingbag,/turf/simulated/floor/carpet,/area/commando_ship/urfs_avarice/observation)
"aT" = (/obj/machinery/door/firedoor,/obj/machinery/door/airlock/halo,/turf/simulated/floor/tiled/white,/area/commando_ship/urfs_avarice/medicalbay)
"aU" = (/obj/machinery/door/firedoor,/obj/machinery/door/airlock/halo,/obj/structure/cable/blue{dir = 2; icon_state = "1-2"},/turf/simulated/floor/tiled/white,/area/commando_ship/urfs_avarice/medicalbay)
"aV" = (/obj/machinery/door/blast/regular{id = "avarice_u1"},/turf/simulated/floor/tiled/dark,/area/commando_ship/urfs_avarice)
"aW" = (/obj/structure/cable/blue{icon_state = "2-4"},/turf/simulated/floor/carpet,/area/commando_ship/urfs_avarice/observation)
"aX" = (/obj/machinery/door/firedoor,/obj/structure/cable/blue{icon_state = "4-8"},/turf/simulated/floor/tiled/dark,/area/commando_ship/urfs_avarice/observation)
"aY" = (/obj/structure/cable/blue{icon_state = "4-8"},/turf/simulated/floor/tiled/dark,/area/commando_ship/urfs_avarice/Armory)
"aZ" = (/obj/machinery/door/firedoor,/obj/structure/cable/blue{icon_state = "4-8"},/turf/simulated/floor/tiled/dark,/area/commando_ship/urfs_avarice/Armory)
"ba" = (/obj/structure/cable/blue{icon_state = "4-8"},/turf/simulated/floor/tiled/dark,/area/space)
"bb" = (/obj/structure/cable/blue{icon_state = "1-8"},/turf/simulated/floor/tiled/dark,/area/space)
"bc" = (/turf/simulated/floor/tiled/dark,/area/space)
"bd" = (/obj/machinery/button/remote/blast_door{id = "avarice_u1"; name = "Umbilical Access"},/turf/simulated/wall/r_wall,/area/commando_ship/urfs_avarice)
"be" = (/obj/effect/floor_decal/spline/fancy/wood{tag = "icon-spline_fancy (NORTHWEST)"; icon_state = "spline_fancy"; dir = 9},/turf/simulated/floor/carpet,/area/commando_ship/urfs_avarice/observation)
"bf" = (/obj/effect/floor_decal/spline/fancy/wood{tag = "icon-spline_fancy (NORTH)"; icon_state = "spline_fancy"; dir = 1},/turf/simulated/floor/carpet,/area/commando_ship/urfs_avarice/observation)
"bg" = (/obj/effect/floor_decal/spline/fancy/wood{tag = "icon-spline_fancy (NORTHEAST)"; icon_state = "spline_fancy"; dir = 5},/turf/simulated/floor/carpet,/area/commando_ship/urfs_avarice/observation)
"bh" = (/obj/structure/cable/blue{dir = 2; icon_state = "1-2"},/turf/simulated/floor/carpet,/area/commando_ship/urfs_avarice/observation)
"bi" = (/obj/machinery/door/firedoor,/obj/machinery/door/airlock/multi_tile/halo/blast{name = "Fitness Room"; req_access = list(252)},/turf/simulated/floor/tiled/dark,/area/commando_ship/urfs_avarice/observation)
"bj" = (/obj/machinery/door/airlock/multi_tile/halo/blast{name = "Armory"; req_access = list(252)},/obj/machinery/door/firedoor,/turf/simulated/floor/tiled/dark,/area/commando_ship/urfs_avarice/Armory)
"bk" = (/obj/machinery/light/spot,/turf/simulated/floor/tiled/dark,/area/space)
"bl" = (/obj/machinery/door/airlock/multi_tile/halo/blast{name = "Umbilical Access"; req_access = list(252)},/turf/simulated/floor/tiled/dark,/area/commando_ship/urfs_avarice)
"bm" = (/obj/machinery/light/spot,/turf/simulated/floor/tiled/dark,/area/commando_ship/urfs_avarice)
"bn" = (/obj/machinery/light/spot{tag = "icon-tube1 (WEST)"; icon_state = "tube1"; dir = 8},/turf/simulated/floor/carpet,/area/commando_ship/urfs_avarice/observation)
"bo" = (/obj/effect/floor_decal/spline/fancy/wood{tag = "icon-spline_fancy (WEST)"; icon_state = "spline_fancy"; dir = 8},/turf/simulated/floor/carpet,/area/commando_ship/urfs_avarice/observation)
"bp" = (/obj/effect/floor_decal/spline/fancy/wood{tag = "icon-spline_fancy (EAST)"; icon_state = "spline_fancy"; dir = 4},/turf/simulated/floor/carpet,/area/commando_ship/urfs_avarice/observation)
"bq" = (/obj/machinery/vending/fitness,/obj/structure/cable/blue{dir = 2; icon_state = "1-2"},/obj/machinery/light/spot{tag = "icon-tube1 (EAST)"; icon_state = "tube1"; dir = 4},/turf/simulated/floor/carpet,/area/commando_ship/urfs_avarice/observation)
"br" = (/obj/machinery/door/airlock/multi_tile/halo/blast{dir = 1; name = "Armory"; req_access = list(252)},/turf/simulated/floor/tiled/dark,/area/commando_ship/urfs_avarice/Armory)
"bs" = (/turf/simulated/wall/r_wall,/area/space)
"bt" = (/obj/effect/floor_decal/spline/fancy/wood{tag = "icon-spline_fancy (SOUTHWEST)"; icon_state = "spline_fancy"; dir = 10},/turf/simulated/floor/carpet,/area/commando_ship/urfs_avarice/observation)
"bu" = (/obj/effect/floor_decal/spline/fancy/wood,/turf/simulated/floor/carpet,/area/commando_ship/urfs_avarice/observation)
"bv" = (/obj/effect/floor_decal/spline/fancy/wood{tag = "icon-spline_fancy (SOUTHEAST)"; icon_state = "spline_fancy"; dir = 6},/turf/simulated/floor/carpet,/area/commando_ship/urfs_avarice/observation)
"bw" = (/obj/machinery/door/firedoor,/turf/simulated/floor/tiled/dark,/area/commando_ship/urfs_avarice/observation)
"bx" = (/obj/machinery/door/firedoor,/turf/simulated/floor/tiled/dark,/area/commando_ship/urfs_avarice/Armory)
"by" = (/obj/machinery/light/spot{tag = "icon-tube1 (NORTH)"; icon_state = "tube1"; dir = 1},/turf/simulated/floor/tiled/dark,/area/space)
"bz" = (/obj/structure/cable/blue{icon_state = "2-4"},/turf/simulated/floor/tiled/dark,/area/space)
"bA" = (/obj/structure/cable/blue{icon_state = "4-8"},/turf/simulated/floor/tiled/dark,/area/commando_ship/urfs_avarice)
"bB" = (/obj/structure/cable/blue{icon_state = "4-8"},/obj/machinery/light/spot{tag = "icon-tube1 (NORTH)"; icon_state = "tube1"; dir = 1},/turf/simulated/floor/tiled/dark,/area/commando_ship/urfs_avarice)
"bC" = (/obj/machinery/power/apc{dir = 4; name = "APC"; pixel_x = 24; pixel_y = 0},/obj/structure/cable/blue{icon_state = "0-8"},/turf/simulated/floor/tiled/dark,/area/commando_ship/urfs_avarice)
"bD" = (/obj/structure/cable/blue{icon_state = "2-4"},/obj/structure/cable/blue{icon_state = "1-4"},/turf/simulated/floor/carpet,/area/commando_ship/urfs_avarice/observation)
"bE" = (/obj/machinery/door/firedoor,/obj/machinery/door/airlock/multi_tile/halo/blast{name = "Fitness Room"; req_access = list(252)},/obj/structure/cable/blue{icon_state = "4-8"},/turf/simulated/floor/tiled/dark,/area/commando_ship/urfs_avarice/observation)
"bF" = (/obj/structure/cable/blue{icon_state = "4-8"},/obj/structure/cable/blue{icon_state = "2-4"},/turf/simulated/floor/tiled/dark,/area/commando_ship/urfs_avarice/Armory)
"bG" = (/obj/machinery/door/airlock/multi_tile/halo/blast{name = "Armory"; req_access = list(252)},/obj/machinery/door/firedoor,/obj/structure/cable/blue{icon_state = "4-8"},/turf/simulated/floor/tiled/dark,/area/commando_ship/urfs_avarice/Armory)
"bH" = (/obj/structure/cable/blue{icon_state = "2-8"},/obj/structure/cable/blue{dir = 2; icon_state = "1-2"},/turf/simulated/floor/tiled/dark,/area/space)
"bI" = (/obj/machinery/button/remote/blast_door{id = "avarice_u2"; name = "Umbilical Access"},/turf/simulated/wall/r_wall,/area/commando_ship/urfs_avarice)
"bJ" = (/obj/machinery/power/apc{dir = 4; name = "APC"; pixel_x = 24; pixel_y = 0},/obj/structure/cable/blue,/turf/simulated/floor/carpet,/area/commando_ship/urfs_avarice/observation)
"bK" = (/obj/machinery/power/apc{dir = 4; name = "APC"; pixel_x = 24; pixel_y = 0},/obj/structure/cable/blue,/turf/simulated/floor/tiled/dark,/area/commando_ship/urfs_avarice/Armory)
"bL" = (/turf/simulated/wall/r_wall,/area/commando_ship/urfs_avarice/janitorial)
"bM" = (/obj/machinery/door/airlock/halo,/turf/simulated/floor/tiled/dark,/area/commando_ship/urfs_avarice/janitorial)
"bN" = (/turf/simulated/wall/r_wall,/area/commando_ship/urfs_avarice/powercoreaux)
"bO" = (/obj/machinery/door/airlock/halo,/turf/simulated/floor/tiled/dark,/area/commando_ship/urfs_avarice/powercoreaux)
"bP" = (/obj/structure/cable/blue{dir = 2; icon_state = "1-2"},/obj/machinery/door/airlock/halo,/turf/simulated/floor/tiled/dark,/area/commando_ship/urfs_avarice/powercoreaux)
"bQ" = (/obj/machinery/door/blast/regular{id = "avarice_u2"},/turf/simulated/floor/tiled/dark,/area/commando_ship/urfs_avarice)
"bR" = (/obj/structure/janitorialcart,/turf/simulated/floor/tiled/dark,/area/commando_ship/urfs_avarice/janitorial)
"bS" = (/turf/simulated/floor/tiled/dark,/area/commando_ship/urfs_avarice/janitorial)
"bT" = (/obj/machinery/power/apc{dir = 4; name = "APC"; pixel_x = 24; pixel_y = 0},/turf/simulated/floor/tiled/dark,/area/commando_ship/urfs_avarice/janitorial)
"bU" = (/turf/simulated/floor/plating,/area/commando_ship/urfs_avarice/powercoreaux)
"bV" = (/obj/machinery/atmospherics/pipe/tank/oxygen,/turf/simulated/floor/plating,/area/commando_ship/urfs_avarice/powercoreaux)
"bW" = (/obj/machinery/atmospherics/pipe/tank/oxygen,/obj/machinery/light/spot{tag = "icon-tube1 (NORTH)"; icon_state = "tube1"; dir = 1},/turf/simulated/floor/plating,/area/commando_ship/urfs_avarice/powercoreaux)
"bX" = (/obj/structure/cable/blue{icon_state = "0-8"},/obj/machinery/power/smes/buildable/max_cap_in_out{capacity = 5e+010; charge = 5e+010; input_attempt = 1; input_level = 200000; output_attempt = 1; output_level = 200000},/obj/structure/cable/blue{icon_state = "0-4"},/turf/simulated/floor/plating,/area/commando_ship/urfs_avarice/powercoreaux)
"bY" = (/obj/structure/cable/blue{icon_state = "2-8"},/obj/structure/cable/blue{dir = 2; icon_state = "1-2"},/turf/simulated/floor/plating,/area/commando_ship/urfs_avarice/powercoreaux)
"bZ" = (/obj/structure/stairs,/turf/simulated/floor/tiled/dark,/area/space)
"ca" = (/obj/structure/closet/jcloset,/turf/simulated/floor/tiled/dark,/area/commando_ship/urfs_avarice/janitorial)
"cb" = (/obj/machinery/light/spot{tag = "icon-tube1 (EAST)"; icon_state = "tube1"; dir = 4},/turf/simulated/floor/tiled/dark,/area/commando_ship/urfs_avarice/janitorial)
"cc" = (/obj/machinery/atmospherics/pipe/manifold/visible/blue{dir = 8},/obj/structure/cable/blue{icon_state = "0-4"},/turf/simulated/floor/plating,/area/commando_ship/urfs_avarice/powercoreaux)
"cd" = (/obj/machinery/atmospherics/pipe/manifold/visible/blue{dir = 4},/turf/simulated/floor/plating,/area/commando_ship/urfs_avarice/powercoreaux)
"ce" = (/obj/machinery/power/terminal{tag = "icon-term (NORTH)"; icon_state = "term"; dir = 1},/obj/structure/cable/blue{dir = 8; icon_state = "0-4"},/turf/simulated/floor/plating,/area/commando_ship/urfs_avarice/powercoreaux)
"cf" = (/obj/structure/cable/blue{dir = 2; icon_state = "1-2"},/turf/simulated/floor/plating,/area/commando_ship/urfs_avarice/powercoreaux)
"cg" = (/obj/structure/table/rack,/obj/machinery/light/spot,/turf/simulated/floor/tiled/dark,/area/commando_ship/urfs_avarice/Armory)
"ch" = (/obj/structure/closet/l3closet/janitor,/turf/simulated/floor/tiled/dark,/area/commando_ship/urfs_avarice/janitorial)
"ci" = (/obj/structure/reagent_dispensers/watertank,/obj/item/weapon/reagent_containers/glass/bucket,/turf/simulated/floor/tiled/dark,/area/commando_ship/urfs_avarice/janitorial)
"cj" = (/obj/machinery/atmospherics/binary/pump/high_power/on,/turf/simulated/floor/plating,/area/commando_ship/urfs_avarice/powercoreaux)
"ck" = (/obj/machinery/atmospherics/binary/pump/high_power/on{dir = 1},/turf/simulated/floor/plating,/area/commando_ship/urfs_avarice/powercoreaux)
"cl" = (/obj/structure/cable/blue{icon_state = "1-4"},/turf/simulated/floor/plating,/area/commando_ship/urfs_avarice/powercoreaux)
"cm" = (/obj/machinery/atmospherics/pipe/simple/visible/blue{tag = "icon-intact (SOUTHEAST)"; icon_state = "intact"; dir = 6},/obj/structure/cable/blue{dir = 2; icon_state = "1-2"},/obj/structure/cable/blue{icon_state = "2-8"},/obj/structure/cable/blue{icon_state = "1-8"},/turf/simulated/floor/plating,/area/commando_ship/urfs_avarice/powercoreaux)
"cn" = (/obj/machinery/atmospherics/portables_connector{tag = "icon-map_connector (WEST)"; icon_state = "map_connector"; dir = 8},/obj/machinery/portable_atmospherics/canister/oxygen,/turf/simulated/floor/plating,/area/commando_ship/urfs_avarice/powercoreaux)
"co" = (/obj/machinery/atmospherics/pipe/simple/visible/blue{tag = "icon-intact (SOUTHEAST)"; icon_state = "intact"; dir = 6},/turf/simulated/floor/plating,/area/commando_ship/urfs_avarice/powercoreaux)
"cp" = (/obj/machinery/atmospherics/pipe/simple/visible/blue{dir = 9},/turf/simulated/floor/plating,/area/commando_ship/urfs_avarice/powercoreaux)
"cq" = (/obj/machinery/atmospherics/pipe/simple/visible/blue{dir = 5},/turf/simulated/floor/plating,/area/commando_ship/urfs_avarice/powercoreaux)
"cr" = (/obj/machinery/atmospherics/pipe/simple/visible/blue{tag = "icon-intact (EAST)"; icon_state = "intact"; dir = 4},/turf/simulated/floor/plating,/area/commando_ship/urfs_avarice/powercoreaux)
"cs" = (/obj/machinery/atmospherics/pipe/manifold/visible/blue,/obj/structure/cable/blue{dir = 2; icon_state = "1-2"},/turf/simulated/floor/plating,/area/commando_ship/urfs_avarice/powercoreaux)
"ct" = (/obj/machinery/atmospherics/pipe/manifold/visible/blue{dir = 8},/turf/simulated/floor/plating,/area/commando_ship/urfs_avarice/powercoreaux)
"cu" = (/obj/machinery/atmospherics/pipe/manifold/visible/blue{dir = 1},/turf/simulated/floor/plating,/area/commando_ship/urfs_avarice/powercoreaux)
"cv" = (/obj/machinery/atmospherics/pipe/manifold/visible/blue{dir = 1},/obj/structure/cable/blue{dir = 2; icon_state = "1-2"},/turf/simulated/floor/plating,/area/commando_ship/urfs_avarice/powercoreaux)
"cw" = (/obj/machinery/atmospherics/unary/freezer{tag = "icon-freezer_1 (WEST)"; icon_state = "freezer_1"; dir = 8},/turf/simulated/floor/plating,/area/commando_ship/urfs_avarice/powercoreaux)
"cx" = (/obj/docking_umbilical/south{name = "URFS Avarice Umbilical 2"},/turf/simulated/wall/r_wall,/area/commando_ship/urfs_avarice)
"cy" = (/obj/machinery/atmospherics/pipe/simple/visible/blue,/turf/simulated/floor/plating,/area/commando_ship/urfs_avarice/powercoreaux)
"cz" = (/obj/machinery/atmospherics/pipe/manifold/visible/blue{dir = 8},/obj/structure/cable/blue{dir = 2; icon_state = "1-2"},/turf/simulated/floor/plating,/area/commando_ship/urfs_avarice/powercoreaux)
"cA" = (/obj/machinery/atmospherics/pipe/simple/visible/blue{dir = 5},/obj/structure/cable/blue{icon_state = "2-4"},/turf/simulated/floor/plating,/area/commando_ship/urfs_avarice/powercoreaux)
"cB" = (/obj/machinery/atmospherics/pipe/simple/visible/blue{dir = 10},/obj/structure/cable/blue{icon_state = "4-8"},/turf/simulated/floor/plating,/area/commando_ship/urfs_avarice/powercoreaux)
"cC" = (/obj/structure/cable/blue{icon_state = "4-8"},/turf/simulated/floor/plating,/area/commando_ship/urfs_avarice/powercoreaux)
"cD" = (/obj/machinery/atmospherics/pipe/simple/visible/blue{dir = 5},/obj/structure/cable/blue{icon_state = "2-8"},/obj/structure/cable/blue{dir = 2; icon_state = "1-2"},/turf/simulated/floor/plating,/area/commando_ship/urfs_avarice/powercoreaux)
"cE" = (/obj/machinery/atmospherics/unary/freezer{tag = "icon-freezer_1 (WEST)"; icon_state = "freezer_1"; dir = 8},/obj/machinery/light/colored/orange{tag = "icon-orange1 (EAST)"; icon_state = "orange1"; dir = 4},/turf/simulated/floor/plating,/area/commando_ship/urfs_avarice/powercoreaux)
"cF" = (/obj/machinery/atmospherics/binary/fusion_cooling{tag = "icon-cooling_manifold (NORTH)"; icon_state = "cooling_manifold"; dir = 1},/turf/simulated/floor/plating,/area/commando_ship/urfs_avarice/powercoreaux)
"cG" = (/obj/machinery/power/fusion_drive,/obj/structure/cable/blue,/turf/simulated/floor/plating,/area/commando_ship/urfs_avarice/powercoreaux)
"cH" = (/obj/machinery/atmospherics/binary/fusion_cooling,/turf/simulated/floor/plating,/area/commando_ship/urfs_avarice/powercoreaux)
"cI" = (/obj/machinery/power/apc{dir = 4; name = "APC"; pixel_x = 24; pixel_y = 0},/obj/structure/cable/blue,/turf/simulated/floor/plating,/area/commando_ship/urfs_avarice/powercoreaux)
"cJ" = (/obj/machinery/atmospherics/pipe/simple/visible/blue{dir = 5},/obj/structure/closet/walllocker/emerglocker/south,/turf/simulated/floor/plating,/area/commando_ship/urfs_avarice/powercoreaux)
"cK" = (/obj/machinery/atmospherics/binary/fusion_cooling{tag = "icon-cooling_manifold (WEST)"; icon_state = "cooling_manifold"; dir = 8},/obj/machinery/light/spot,/turf/simulated/floor/plating,/area/commando_ship/urfs_avarice/powercoreaux)
"cL" = (/obj/machinery/atmospherics/pipe/simple/visible/blue{dir = 9},/obj/structure/closet/wall_medical{pixel_y = -32},/turf/simulated/floor/plating,/area/commando_ship/urfs_avarice/powercoreaux)

(1,1,1) = {"
aaaaaaaaaaaaaaaaaaaaaaaaaaaaaaaaaaaaaaaaaaaaaaaaaaaaaaaaaaaaaaaaaaaaaaaaaaaaaaaaaaaaaaaaaaaaaaaaaaaaaaaaaaaaaaaaaaaaaaaa
aaaaaaaaaaaaaaaaaaaaaaaaaaaaaaaaaaaaaaaaaaaaaaaaaaaaaaaaaaaaaaaaaaaaaaaaaaaaaaaaaaaaaaaaaaaaaaaaaaaaaaaaaaaaaaaaaaaaaaaa
aaaaaaaaaaaaaaaaaaaaaaaaaaaaaaaaaaaaaaaaaaaaaaaaaaaaaaaaaaaaaaaaaaaaaaaaaaaaaaaaaaaaaaaaaaaaaaaaaaaaaaaaaaaaaaaaaaaaaaaa
aaaaaaaaaaaaaaaaaaaaaaaaaaaaaaaaaaaaaaaaaaaaaaaaaaaaababababababababababaaaaaaaaaaaaaaaaaaaaaaaaaaaaaaaaaaaaaaaaaaaaaaaa
aaaaaaaaaaaaaaaaaaaaaaaaaaaaaaaaaaaaaaaaaaaaaaaaabababababababababababaaaaaaaaaaaaaaaaaaaaaaaaaaaaaaaaaaaaaaaaaaaaaaaaaa
aaaaaaaaaaaaaaaaaaaaaaaaaaaaaaaaaaaaaaaaaaaaaaaaaaaaaaaaababababababababababaaaaaaaaaaaaaaaaaaaaaaaaaaaaaaaaaaaaaaaaaaaa
aaaaaaaaaaaaaaaaaaaaaaaaaaaaaaaaaaaaaaaaaaaaaaaaaaaaaaababababababababaaaaaaaaaaaaaaaaaaaaaaaaaaaaaaaaaaaaaaaaaaaaaaaaaa
aaaaaaaaaaaaaaaaaaaaaaaaaaaaaaaaaaaaaaaaaaaaaaaaaaaaaaabababababababababaaaaaaaaaaaaaaaaaaaaaaaaaaaaaaaaaaaaaaaaaaaaaaaa
aaaaaaaaaaaaaaaaaaaaaaaaaaaaaaaaaaaaaaaaaaaaaaaaaaaaaaababababababababababaaaaaaaaaaaaaaaaaaaaaaaaaaaaaaaaaaaaaaaaaaaaaa
aaaaaaaaaaaaaaaaaaaaaaaaaaaaaaaaaaaaaaaaaaaaaaaaaaaaaaababababababababababaaaaaaaaaaaaaaaaaaaaaaaaaaaaaaaaaaaaaaaaaaaaaa
aaaaaaaaaaaaaaaaaaaaaaaaaaaaaaaaaaaaaaaaaaaaaaaaaaaaabababababababababababaaaaaaaaaaaaaaaaaaaaaaaaaaaaaaaaaaaaaaaaaaaaaa
aaaaaaaaaaaaaaaaaaaaaaaaaaaaaaaaaaaaaaaaaaaaaaaaaaaaabababababababababababaaaaaaaaaaaaaaaaaaaaaaaaaaaaaaaaaaaaaaaaaaaaaa
aaaaaaaaaaaaaaaaaaaaaaaaaaaaaaaaaaaaaaaaaaaaaaaaaaaaababababababababababababaaaaaaaaaaaaaaaaaaaaaaaaaaaaaaaaaaaaaaaaaaaa
aaaaaaaaaaaaaaaaaaaaaaaaaaaaaaaaaaaaaaaaaaaaaaaaaaaaababababababababababababaaaaaaaaaaaaaaaaaaaaaaaaaaaaaaaaaaaaaaaaaaaa
aaaaaaaaaaaaaaaaaaaaaaaaaaaaaaaaaaaaaaaaaaaaaaaaaaaaababababababababababababaaaaaaaaaaaaaaaaaaaaababababababababababaaaa
aaaaaaaaaaaaaaaaaaaaaaaaaaaaaaaaaaaaaaaaaaaaaaaaaaabababababababababababababaaaaaaaaaaababababababababaaaaaaaaaaaaaaaaaa
aaaaaaaaaaaaaaaaaaaaaaaaaaaaaaaaaaaaaaaaaaaaaaaaaaabababababababababababababaaaaaaaaaaaaaaaaaaababababababaaaaaaaaaaaaaa
aaaaaaaaaaaaaaaaaaaaaaaaaaaaaaaaaaaaaaaaaaaaaaaaaaabababababacacacacacacacabaaaaaaaaaaaaababababababababaaaaaaaaaaaaaaaa
aaaaaaaaaaaaaaaaaaaaaaaaaaaaaaaaaaaaaaaaaaaaaaaaaaababababacacadaeafagahacacababaaaaaaababababababababababababaaaaaaaaaa
aaaaaaaaaaaaaaaaaaaaaaaaaaaaaaaaaaaaabaaaaaaaaaaabababababacaiajajajajajakacababababababababababababababaaaaaaaaaaaaaaaa
aaaaaaaaaaaaaaaaaaaaaaaaaaaaaaaaaaaaabababababababababababacalamajananajaoacacababababapabababababaaaaaaaaaaaaaaaaaaaaaa
aaaaaaaaaaaaaaaaaaaaaaaaaaaaaaaaaaabaqaqaqaqaqaqaqaqacacacacarajajananajasacacabatauauauauauatababaaaaaaaaaaaaaaaaaaaaaa
aaaaaaaaaaaaaaaaaaaaaaaaaaaaaaababaqaqavavawavavavaqaxayazaAaBajajajajajaCacacabauauauauauauauababaaaaaaaaaaaaaaaaaaaaaa
aaaaaaaaaaaaaaaaaaaaaaaDaEaEaEaDaDaqavaFaFavaFaFavaqaGajajaAaBajaHajaHajaIaJacabauauauauauauauababaaaaaaaaaaaaaaaaaaaaaa
aaaaaaaaaaaaaaaDaEaEaEaDaKaLaLaKaDaqavaFaFavaFaFavaqaMajajaNajajaHaOaHaPaQaRacabauauauauauauauababaaaaaaaaaaaaaaaaaaaaaa
aaaaaaaaaaaaaaaEaSaLaLaLaLaLaLaLaDaqaqaFaFaFaFaFaFaqacacacacacaTacacacaUacacacabababaVaVaVababababaaaaaaaaaaaaaaaaaaaaaa
aaaaaaaaaaaaaEaEaLaLaLaLaLaLaLaWaXaYaYaYaYaYaYaYaYaZbabababababababababbbcbcbcauauauauauauaubdababaaaaaaaaaaaaaaaaaaaaaa
aaaaaaaaaaaaaEaSaLaLbebfbfbgaLbhbiaFaFaFaFaFaFaFaFbjbcbcbcbcbcbcbcbkbcbcbcbcbcblauauaubmauauababababaaaaaaaaaaaaaaaaaaaa
aaaaaaaaaaaDaDaDbnaLboaLaLbpaLbqaDaqaqaqaqbraFaqaqaqbsbsbsbsbsbsbsbsbsbsbsbsbsabababababababababababaaaaaaaaaaaaaaaaaaaa
aaaaaaaaaaaaaEaSaLaLbtbububvaLbhbwaFaFaFaFaFaFaFaFbxbcbcbcbcbcbcbcbybcbzbabababAbAbAbAbBbAbCababababaaaaaaaaaaaaaaaaaaaa
aaaaaaaaaaaaaEaEaLaLaLaLaLaLaLbDbEaYaYaYaYaYaYaYbFbGbabababababababababHbcbcbcblauauauauauaubIababaaaaaaaaaaaaaaaaaaaaaa
aaaaaaaaaaaaaaaEaSaLaLaLaLaLaLbJaDaqaqaFaFaFaFaFbKaqbLbMbLbNbNbObNbNbNbPbsbcbcabababbQbQbQababababaaaaaaaaaaaaaaaaaaaaaa
aaaaaaaaaaaaaaaDaEaEaEaDaKaLaLaKaDaqavaFaFavaFaFavaqbRbSbTbNbUbUbVbWbXbYbsbZbZabauauauauauauauababaaaaaaaaaaaaaaaaaaaaaa
aaaaaaaaaaaaaaaaaaaaaaaDaEaEaEaDaDaqavaFaFavaFaFavaqcabScbbNbUbUcccdcecfbNbNbsabauauauauauauauababaaaaaaaaaaaaaaaaaaaaaa
aaaaaaaaaaaaaaaaaaaaaaaaaaaaaaababaqaqavavcgavavavaqchbScibNbUbUcjckclcmcnbNbsabauauauauauauauababaaaaaaaaaaaaaaaaaaaaaa
aaaaaaaaaaaaaaaaaaaaaaaaaaaaaaaaaaabaqaqaqaqaqaqaqaqabababbNbUcocpcqcrcscnbNbsabbmauauauauaubmababaaaaaaaaaaaaaaaaaaaaaa
aaaaaaaaaaaaaaaaaaaaaaaaaaaaaaaaaaaaabababababababababababbNbUctcucrcrcvcwbNbsababababcxabababababaaaaaaaaaaaaaaaaaaaaaa
aaaaaaaaaaaaaaaaaaaaaaaaaaaaaaaaaaaaabaaaaaaaaaaabababababbNbUcjcybUbUczcwbNbsabababababababababababababaaaaaaaaaaaaaaaa
aaaaaaaaaaaaaaaaaaaaaaaaaaaaaaaaaaaaaaaaaaaaaaaaaaababababbNbUcycAcBcCcDcEbNbsbsaaaaaaababababababababababababaaaaaaaaaa
aaaaaaaaaaaaaaaaaaaaaaaaaaaaaaaaaaaaaaaaaaaaaaaaaaababababbNbUcFcGcHbUcIbNbNaaaaaaaaaaaaababababababababaaaaaaaaaaaaaaaa
aaaaaaaaaaaaaaaaaaaaaaaaaaaaaaaaaaaaaaaaaaaaaaaaaaababababbNbUcJcKcLbUbNbNabaaaaaaaaaaaaaaaaaaababababababaaaaaaaaaaaaaa
aaaaaaaaaaaaaaaaaaaaaaaaaaaaaaaaaaaaaaaaaaaaaaaaaaababababbNbNbNbNbNbNbNababaaaaaaaaaaababababababababaaaaaaaaaaaaaaaaaa
aaaaaaaaaaaaaaaaaaaaaaaaaaaaaaaaaaaaaaaaaaaaaaaaaaaaababababababababababababaaaaaaaaaaaaaaaaaaaaababababababababababaaaa
aaaaaaaaaaaaaaaaaaaaaaaaaaaaaaaaaaaaaaaaaaaaaaaaaaaaababababababababababababaaaaaaaaaaaaaaaaaaaaaaaaaaaaaaaaaaaaaaaaaaaa
aaaaaaaaaaaaaaaaaaaaaaaaaaaaaaaaaaaaaaaaaaaaaaaaaaaaababababababababababababaaaaaaaaaaaaaaaaaaaaaaaaaaaaaaaaaaaaaaaaaaaa
aaaaaaaaaaaaaaaaaaaaaaaaaaaaaaaaaaaaaaaaaaaaaaaaaaaaabababababababababababaaaaaaaaaaaaaaaaaaaaaaaaaaaaaaaaaaaaaaaaaaaaaa
aaaaaaaaaaaaaaaaaaaaaaaaaaaaaaaaaaaaaaaaaaaaaaaaaaaaabababababababababababaaaaaaaaaaaaaaaaaaaaaaaaaaaaaaaaaaaaaaaaaaaaaa
aaaaaaaaaaaaaaaaaaaaaaaaaaaaaaaaaaaaaaaaaaaaaaaaaaaaaaababababababababababaaaaaaaaaaaaaaaaaaaaaaaaaaaaaaaaaaaaaaaaaaaaaa
aaaaaaaaaaaaaaaaaaaaaaaaaaaaaaaaaaaaaaaaaaaaaaaaaaaaaaababababababababababaaaaaaaaaaaaaaaaaaaaaaaaaaaaaaaaaaaaaaaaaaaaaa
aaaaaaaaaaaaaaaaaaaaaaaaaaaaaaaaaaaaaaaaaaaaaaaaaaaaaaabababababababababaaaaaaaaaaaaaaaaaaaaaaaaaaaaaaaaaaaaaaaaaaaaaaaa
aaaaaaaaaaaaaaaaaaaaaaaaaaaaaaaaaaaaaaaaaaaaaaaaaaaaaaababababababababaaaaaaaaaaaaaaaaaaaaaaaaaaaaaaaaaaaaaaaaaaaaaaaaaa
aaaaaaaaaaaaaaaaaaaaaaaaaaaaaaaaaaaaaaaaaaaaaaaaaaaaaaaaababababababababababaaaaaaaaaaaaaaaaaaaaaaaaaaaaaaaaaaaaaaaaaaaa
aaaaaaaaaaaaaaaaaaaaaaaaaaaaaaaaaaaaaaaaaaaaaaaaabababababababababababaaaaaaaaaaaaaaaaaaaaaaaaaaaaaaaaaaaaaaaaaaaaaaaaaa
aaaaaaaaaaaaaaaaaaaaaaaaaaaaaaaaaaaaaaaaaaaaaaaaaaaaababababababababababaaaaaaaaaaaaaaaaaaaaaaaaaaaaaaaaaaaaaaaaaaaaaaaa
aaaaaaaaaaaaaaaaaaaaaaaaaaaaaaaaaaaaaaaaaaaaaaaaaaaaaaaaaaaaaaaaaaaaaaaaaaaaaaaaaaaaaaaaaaaaaaaaaaaaaaaaaaaaaaaaaaaaaaaa
aaaaaaaaaaaaaaaaaaaaaaaaaaaaaaaaaaaaaaaaaaaaaaaaaaaaaaaaaaaaaaaaaaaaaaaaaaaaaaaaaaaaaaaaaaaaaaaaaaaaaaaaaaaaaaaaaaaaaaaa
aaaaaaaaaaaaaaaaaaaaaaaaaaaaaaaaaaaaaaaaaaaaaaaaaaaaaaaaaaaaaaaaaaaaaaaaaaaaaaaaaaaaaaaaaaaaaaaaaaaaaaaaaaaaaaaaaaaaaaaa
aaaaaaaaaaaaaaaaaaaaaaaaaaaaaaaaaaaaaaaaaaaaaaaaaaaaaaaaaaaaaaaaaaaaaaaaaaaaaaaaaaaaaaaaaaaaaaaaaaaaaaaaaaaaaaaaaaaaaaaa
aaaaaaaaaaaaaaaaaaaaaaaaaaaaaaaaaaaaaaaaaaaaaaaaaaaaaaaaaaaaaaaaaaaaaaaaaaaaaaaaaaaaaaaaaaaaaaaaaaaaaaaaaaaaaaaaaaaaaaaa
aaaaaaaaaaaaaaaaaaaaaaaaaaaaaaaaaaaaaaaaaaaaaaaaaaaaaaaaaaaaaaaaaaaaaaaaaaaaaaaaaaaaaaaaaaaaaaaaaaaaaaaaaaaaaaaaaaaaaaaa
"}
