"aa" = (/turf/unsimulated/mineral,/area/ccs_battlecruiser/planet_staging)
"ab" = (/turf/unsimulated/floor/grass2,/area/ccs_battlecruiser/planet_staging)
"ac" = (/obj/structure/jump_pad{id = "deck 2 port cargo"; name = "Covenant Jump Pad - deck 2 port cargo bay"},/turf/unsimulated/floor/grass2,/area/ccs_battlecruiser/planet_staging)
"ad" = (/obj/structure/jump_pad{id = "deck 1 port hangar"; name = "Covenant Jump Pad - deck 1 port hangar"},/turf/unsimulated/floor/grass2,/area/ccs_battlecruiser/planet_staging)
"ae" = (/obj/structure/jump_pad{id = "deck 2 starboard cargo"; name = "Covenant Jump Pad - deck 2 starboard cargo bay"},/turf/unsimulated/floor/grass2,/area/ccs_battlecruiser/planet_staging)
"af" = (/obj/structure/jump_pad{id = "deck 1 starboard hangar"; name = "Covenant Jump Pad - deck 1 starboard hangar"},/turf/unsimulated/floor/grass2,/area/ccs_battlecruiser/planet_staging)
"ag" = (/obj/effect/landmark{name = "Observer-Start"},/turf/unsimulated/floor/grass2,/area/ccs_battlecruiser/planet_staging)
"ah" = (/obj/structure/jump_pad{id = "deck4 starboard hangar"; name = "Covenant Jump Pad - deck 4 starboard hangar"},/turf/unsimulated/floor/grass2,/area/ccs_battlecruiser/planet_staging)
"ai" = (/obj/structure/jump_pad{id = "topdeck airlock"; name = "Covenant Jump Pad - deck 5 external airlock"},/turf/unsimulated/floor/grass2,/area/ccs_battlecruiser/planet_staging)
"aj" = (/obj/structure/jump_pad{id = "deck 1 assault elevator"; invisibility = 101; name = "Covenant Jump Pad - deck 5 external airlock"},/turf/unsimulated/floor/grass2,/area/ccs_battlecruiser/planet_staging)
"ak" = (/obj/structure/grav_elevator_external,/obj/structure/jump_pad{id = "deck 1 assault elevator"; invisibility = 101; name = "Covenant Jump Pad - deck 5 external airlock"},/turf/unsimulated/floor/grass2,/area/ccs_battlecruiser/planet_staging)
"al" = (/obj/structure/jump_pad{id = "deck4 port hangar"; name = "Covenant Jump Pad - deck 4 port hangar"},/turf/unsimulated/floor/grass2,/area/ccs_battlecruiser/planet_staging)
"am" = (/obj/structure/tanktrap,/turf/unsimulated/floor/grass2,/area/ccs_battlecruiser/planet_staging)
"an" = (/obj/structure/tanktrap_dead,/turf/unsimulated/floor/grass2,/area/ccs_battlecruiser/planet_staging)
"ao" = (/obj/structure/sandbag{dir = 1},/turf/unsimulated/floor/grass2,/area/ccs_battlecruiser/planet_staging)
"ap" = (/turf/unsimulated/floor/dirt,/area/ccs_battlecruiser/planet_staging)
"aq" = (/obj/structure/sandbag{dir = 4},/turf/unsimulated/floor/grass2,/area/ccs_battlecruiser/planet_staging)
"ar" = (/obj/structure/barricade,/turf/unsimulated/floor/dirt,/area/ccs_battlecruiser/planet_staging)
"as" = (/obj/structure/jump_pad{id = "deck 3 port airlock"; name = "Covenant Jump Pad - deck 3 starboard external airlock"},/turf/unsimulated/floor/grass2,/area/ccs_battlecruiser/planet_staging)
"at" = (/obj/structure/ore_box,/turf/unsimulated/floor/dirt,/area/ccs_battlecruiser/planet_staging)
"au" = (/obj/structure/sandbag_dead{dir = 4},/turf/unsimulated/floor/dirt,/area/ccs_battlecruiser/planet_staging)
"av" = (/obj/structure/jump_pad{id = "deck 3 starboard airlock"; name = "Covenant Jump Pad - deck 3 starboard external airlock"},/turf/unsimulated/floor/grass2,/area/ccs_battlecruiser/planet_staging)
"aw" = (/obj/structure/barrel,/turf/unsimulated/floor/dirt,/area/ccs_battlecruiser/planet_staging)
"ax" = (/obj/structure/sandbag{dir = 4},/turf/unsimulated/floor/dirt,/area/ccs_battlecruiser/planet_staging)
"ay" = (/obj/machinery/floodlight{anchored = 1},/turf/unsimulated/floor/dirt,/area/ccs_battlecruiser/planet_staging)
"az" = (/obj/structure/sandbag_dead,/turf/unsimulated/floor/dirt,/area/ccs_battlecruiser/planet_staging)
"aA" = (/obj/structure/turret/chaingun{dir = 1},/turf/unsimulated/floor/dirt,/area/ccs_battlecruiser/planet_staging)
"aB" = (/obj/effect/landmark/start{name = "Spartan II"},/turf/unsimulated/floor/dirt,/area/ccs_battlecruiser/planet_staging)
"aC" = (/obj/structure/sandbag,/turf/unsimulated/floor/dirt,/area/ccs_battlecruiser/planet_staging)
"aD" = (/obj/effect/landmark/start{name = "Spartan II Commander"},/turf/unsimulated/floor/dirt,/area/ccs_battlecruiser/planet_staging)
"aE" = (/obj/structure/bed/roller,/turf/unsimulated/floor/dirt,/area/ccs_battlecruiser/planet_staging)
"aF" = (/obj/structure/bed/chair,/turf/unsimulated/floor/dirt,/area/ccs_battlecruiser/planet_staging)
"aG" = (/obj/structure/table/standard,/turf/unsimulated/floor/dirt,/area/ccs_battlecruiser/planet_staging)
"aH" = (/obj/structure/table/rack,/obj/item/weapon/gun/projectile/m7_smg,/obj/item/weapon/gun/projectile/m7_smg,/obj/item/weapon/gun/projectile/m7_smg,/obj/item/weapon/storage/box/m5,/obj/item/weapon/storage/box/m5,/obj/item/weapon/storage/box/m5,/turf/unsimulated/floor/dirt,/area/ccs_battlecruiser/planet_staging)
"aI" = (/obj/item/weapon/gun/launcher/rocket/m41_ssr,/obj/structure/table/rack,/obj/item/ammo_casing/rocket,/obj/item/ammo_casing/rocket,/obj/item/ammo_casing/rocket,/turf/unsimulated/floor/dirt,/area/ccs_battlecruiser/planet_staging)
"aJ" = (/obj/structure/table/rack,/obj/item/weapon/gun/projectile/srs99_sniper,/obj/item/weapon/gun/projectile/srs99_sniper,/obj/item/weapon/gun/projectile/srs99_sniper,/obj/item/weapon/storage/box/m145_ap,/obj/item/weapon/storage/box/m145_ap,/obj/item/weapon/storage/box/m145_ap,/turf/unsimulated/floor/dirt,/area/ccs_battlecruiser/planet_staging)
"aK" = (/obj/structure/table/rack,/obj/item/weapon/gun/projectile/br85,/obj/item/weapon/gun/projectile/br85,/obj/item/weapon/gun/projectile/br85,/obj/item/weapon/storage/box/m95_sap,/obj/item/weapon/storage/box/m95_sap,/obj/item/weapon/storage/box/m95_sap,/turf/unsimulated/floor/dirt,/area/ccs_battlecruiser/planet_staging)
"aL" = (/obj/structure/table/rack,/obj/item/weapon/gun/projectile/shotgun/pump/m90_ts,/obj/item/weapon/gun/projectile/shotgun/pump/m90_ts,/obj/item/weapon/gun/projectile/shotgun/pump/m90_ts,/obj/item/ammo_box/shotgun,/obj/item/ammo_box/shotgun,/obj/item/ammo_box/shotgun,/obj/item/ammo_box/shotgun,/obj/item/ammo_box/shotgun,/turf/unsimulated/floor/dirt,/area/ccs_battlecruiser/planet_staging)
"aM" = (/obj/structure/bed/chair{dir = 1},/turf/unsimulated/floor/dirt,/area/ccs_battlecruiser/planet_staging)
"aN" = (/obj/structure/table/rack,/obj/item/device/flashlight/flare,/obj/item/device/flashlight/flare,/obj/item/device/flashlight/flare,/obj/item/device/flashlight/flare,/obj/item/device/flashlight/flare,/obj/item/device/flashlight/flare,/obj/item/device/flashlight/flare,/obj/item/device/flashlight/flare,/obj/item/device/flashlight/flare,/turf/unsimulated/floor/dirt,/area/ccs_battlecruiser/planet_staging)
"aO" = (/obj/structure/table/rack,/obj/item/weapon/storage/box/m9_frag,/obj/item/weapon/storage/box/m9_frag,/obj/item/weapon/storage/box/m9_frag,/obj/item/weapon/storage/box/m9_frag,/obj/item/weapon/storage/box/m9_frag,/turf/unsimulated/floor/dirt,/area/ccs_battlecruiser/planet_staging)
"aP" = (/obj/structure/curtain,/turf/unsimulated/floor/dirt,/area/ccs_battlecruiser/planet_staging)
"aQ" = (/obj/structure/curtain/open,/turf/unsimulated/floor/dirt,/area/ccs_battlecruiser/planet_staging)
"aR" = (/obj/structure/table/rack,/obj/item/weapon/gun/projectile/ma5b_ar,/obj/item/weapon/gun/projectile/ma5b_ar,/obj/item/weapon/gun/projectile/ma5b_ar,/obj/item/weapon/storage/box/m762_ap,/obj/item/weapon/storage/box/m762_ap,/obj/item/weapon/storage/box/m762_ap,/turf/unsimulated/floor/dirt,/area/ccs_battlecruiser/planet_staging)
"aS" = (/obj/structure/table/rack,/obj/item/weapon/gun/projectile/m739_lmg,/obj/item/weapon/gun/projectile/m739_lmg,/obj/item/ammo_magazine/a762_box_ap,/obj/item/ammo_magazine/a762_box_ap,/obj/item/ammo_magazine/a762_box_ap,/obj/item/ammo_magazine/a762_box_ap,/turf/unsimulated/floor/dirt,/area/ccs_battlecruiser/planet_staging)
"aT" = (/obj/structure/table/rack,/obj/item/weapon/gun/projectile/m6d_magnum,/obj/item/weapon/gun/projectile/m6d_magnum,/obj/item/weapon/gun/projectile/m6d_magnum,/obj/item/weapon/gun/projectile/m6d_magnum,/obj/item/weapon/storage/box/m127_saphe,/obj/item/weapon/storage/box/m127_saphe,/obj/item/weapon/storage/box/m127_saphe,/obj/item/weapon/storage/box/m127_saphe,/turf/unsimulated/floor/dirt,/area/ccs_battlecruiser/planet_staging)
"aU" = (/obj/structure/table/rack,/obj/item/weapon/gun/projectile/m392_dmr,/obj/item/weapon/gun/projectile/m392_dmr,/obj/item/weapon/storage/box/m762_ap,/obj/item/weapon/storage/box/m762_ap,/turf/unsimulated/floor/dirt,/area/ccs_battlecruiser/planet_staging)
"aV" = (/obj/structure/table/rack,/obj/item/device/flashlight/unsc,/obj/item/device/flashlight/unsc,/obj/item/device/flashlight/unsc,/obj/item/device/flashlight/unsc,/turf/unsimulated/floor/dirt,/area/ccs_battlecruiser/planet_staging)
"aW" = (/obj/structure/bed,/turf/unsimulated/floor/dirt,/area/ccs_battlecruiser/planet_staging)
"aX" = (/obj/structure/table/rack,/obj/item/weapon/material/hatchet/tacknife,/obj/item/weapon/material/hatchet/tacknife,/obj/item/weapon/material/hatchet/tacknife,/obj/item/weapon/material/hatchet/tacknife,/turf/unsimulated/floor/dirt,/area/ccs_battlecruiser/planet_staging)
"aY" = (/obj/structure/table/rack,/obj/item/weapon/material/hatchet,/obj/item/weapon/material/hatchet,/obj/item/weapon/material/hatchet,/obj/item/weapon/material/hatchet,/turf/unsimulated/floor/dirt,/area/ccs_battlecruiser/planet_staging)
"aZ" = (/obj/item/weapon/storage/firstaid/unsc,/obj/item/weapon/storage/firstaid/unsc,/obj/item/weapon/storage/firstaid/unsc,/obj/structure/table/standard,/obj/item/weapon/storage/firstaid/unsc,/obj/item/weapon/storage/firstaid/unsc,/obj/item/weapon/storage/firstaid/unsc,/obj/item/weapon/storage/firstaid/surgery,/obj/item/weapon/storage/firstaid/surgery,/turf/unsimulated/floor/dirt,/area/ccs_battlecruiser/planet_staging)

(1,1,1) = {"
aaaaaaaaaaaaaaaaaaaaaaaaaaaaaaaaaaaaaaaaaaaaaaaaaaaaaaaaaaaaaaaaaaaaaaaaaaaaaaaa
aaaaaaaaaaaaaaaaaaaaaaaaaaaaaaaaaaaaaaaaaaaaaaababacacacacaaaaaaaaaaaaaaaaaaaaaa
aaaaaaaaaaaaaaaaaaaaaaaaaaaaaaaaabadadadadabababababababababaeaaaaaaaaaaaaaaaaaa
aaaaaaaaaaaaaaaaaaaaaaaaafafafafabababababababababababababababaeaaaaaaaaaaaaaaaa
aaaaaaaaaaaaaaaaaaaaaaabababababababababababababababababababababaeaaaaaaaaaaaaaa
aaaaaaaaaaaaaaaaaaaaabababababababababababababababababababababababaeaaaaaaaaaaaa
aaaaaaaaaaaaaaaaaaaaabababababababababagagagagagagagagagagagabababababaaaaaaaaaa
aaaaaaaaaaaaaaaaaaaaabababababababagagagabababababababababagagagababababababaaaa
aaaaaaaaaaaaaaaaaaaaababababababagagabababababababababababababagagabababababahaa
aaaaaaaaaaaaaaaaaaaiababababababagababababajajajajababababababababagababababahaa
aaaaaaaaaaaaaaaaaaaiababababababagababababajajajajababababababababagababababahaa
aaaaaaaaaaaaaaaaaaaiababababababagababababajajajajababababababababagababababahaa
aaaaaaaaaaaaaaaaaaaiababababababagababababakajajajababababababababagabababababaa
aaaaaaaaaaaaaaaaaaabababababababagabababababababababababababababagagabababalaaaa
aaaaaaaaaaaaaaaaaaamabababanababagababababababababababababababagagababababalaaaa
aaaaaaaaaaaaaaaaaaaaabababababababagagabababababababababababagagabababababalaaaa
aaaaaaaaaaaaaaaaaaaaamababababababababagagagabababababagagagagababababababalaaaa
aaaaaaaaaaaaaaaaaaaaaaaoaoabababababababababagagagagagagabababababababababaaaaaa
aaaaaaaaaaaaaaaaaaaaaaapabababababababanababababababababababababababababaaaaaaaa
aaaaaaaaaaaaaaaaaaaaapapapababaqabababababababababababababababababababaaaaaaaaaa
aaaaaaaaaaarararararapapapapabaqamababababababababababababasasasasabaaaaaaaaaaaa
aaaaaaarararatapapauapapapapapaaaaaaaaaaaaaaamabavavavavabaaaaaaaaaaaaaaaaaaaaaa
aaaaawapapaxapapapapapapapapaaaaaaaaaaaaaaaaaaaaaaaaaaaaaaaaaaaaaaaaaaaaaaaaaaaa
aaayapapapaxapapapapapapazaaaaaaaaaaaaaaaaaaaaaaaaaaaaaaaaaaaaaaaaaaaaaaaaaaaaaa
aaapapapapaxapapapapapapaAaaaaaaaaaaaaaaaaaaaaaaaaaaaaaaaaaaaaaaaaaaaaaaaaaaaaaa
aaapapapaBaBaBaBaBaBaCaCaCaraaaaaaaaaaaaaaaaaaaaaaaaaaaaaaaaaaarayapawaaaaaaaaaa
aaapapapaBaBaBaBaBaBapapapataaaaaaaaaaaaaaaaaaaaaaaaaaaaarapapapapapapapaaaaaaaa
aaaDapapaBaBaBaBaBaBapapapaparaaaaaaatatayapapapawaraaaaaEapapaFaFaFaFaparaaaaaa
aaapapapaBaBaBaBaBaBapapapapapapapapapapapapapapapapaaaaaEapapaGaGaGaGapataaaaaa
aaapapapaBaBaBaBaBaBapapapapapapapapapapapapapapapapapaaaaapapaGaGaGaGapapaaaaaa
aaapapapapapapaHaHaHapaIaIaIapaJaJaJapaKaKaKapaLaLaLapapaaaaapaMaMaMaMapapapaaaa
aaapapapaNaNapaHaHaHapaIaIaIapaJaJaJapaKaKaKapaLaLaLapapapapapapapapapapapayaaaa
aaatapapaOaOapapapapapapapapapapapapapapapapapapapapapapapapapapapapapapaparaaaa
aaarapapaOaOapapapapapapapapapapapapapapapapapapapapapapapapaaaPaQaQaPaaaaaraaaa
aaaaawapaOaOapaRaRaRapaSaSaSapaTaTaTapaUaUaUapaVaVaVapapapaaaaapapapapaaaaaaaaaa
aaaaarapapapapaRaRaRapaSaSaSapaTaTaTapaUaUaUapaVaVaVapapaaaaaWapaWaWapaWaaaaaaaa
aaaaaaayapapapapapapapapapapapapapapapapapapapapapapapapaaaaaWapaWaWapaWaaaaaaaa
aaaaaaaaawapapapapapapapapapapapapapapapapapapapapapayaaaaaaaWapaWaWapaWaaaaaaaa
aaaaaaaaaaarararaXaXaXapaYaYaYatararapapaZaZaZawaraaaaaaaaaaaaaaaaaaaaaaaaaaaaaa
aaaaaaaaaaaaaaaaaaaaaaaaaaaaaaaaaaaaaaaaaaaaaaaaaaaaaaaaaaaaaaaaaaaaaaaaaaaaaaaa
"}
