//MAP CONVERTED BY dmm2tgm.py THIS HEADER COMMENT PREVENTS RECONVERSION, DO NOT REMOVE
"a" = (
/turf/space,
/area/space)
"b" = (
/obj/effect/landmark/map_data{
	height = 2
	},
/turf/space,
/area/space)
"c" = (
/turf/simulated/wall,
/area/medical/surgery2)
"d" = (
/obj/effect/floor_decal/corner/blue/diagonal,
/obj/structure/iv_drip,
/obj/item/weapon/reagent_containers/ivbag/blood/OMinus,
/obj/item/weapon/reagent_containers/ivbag/blood/OMinus,
/obj/item/weapon/reagent_containers/ivbag/blood/OMinus,
/turf/simulated/floor/tiled/white,
/area/medical/surgery2)
"e" = (
/obj/effect/floor_decal/corner/blue/diagonal,
/obj/machinery/optable,
/obj/machinery/oxygen_pump/anesthetic{
	pixel_y = 32
	},
/turf/simulated/floor/tiled/white,
/area/medical/surgery2)
"f" = (
/obj/effect/floor_decal/corner/blue/diagonal,
/obj/machinery/computer/operating,
/turf/simulated/floor/tiled/white,
/area/medical/surgery2)
"g" = (
/obj/machinery/light{
	dir = 1
	},
/obj/effect/floor_decal/corner/blue/diagonal,
/obj/structure/table/glass,
/obj/item/weapon/storage/box/syringes,
/obj/item/weapon/storage/box/freezer,
/turf/simulated/floor/tiled/white,
/area/medical/surgery2)
"h" = (
/obj/effect/floor_decal/corner/blue/diagonal,
/obj/structure/table/glass,
/obj/item/weapon/storage/box/gloves,
/obj/item/weapon/storage/box/masks,
/turf/simulated/floor/tiled/white,
/area/medical/surgery2)
"i" = (
/obj/effect/floor_decal/corner/blue/diagonal,
/turf/simulated/floor/tiled/white,
/area/medical/surgery2)
"j" = (
/obj/structure/lattice,
/turf/simulated/open,
/area/medical/surgery2)
"k" = (
/obj/machinery/light{
	dir = 1
	},
/obj/effect/floor_decal/corner/blue/diagonal,
/turf/simulated/floor/tiled/white,
/area/medical/surgery2)
"l" = (
/obj/effect/floor_decal/corner/blue/diagonal,
/obj/structure/table/glass,
/obj/item/weapon/storage/firstaid/surgery,
/turf/simulated/floor/tiled/white,
/area/medical/surgery2)
"m" = (
/obj/effect/floor_decal/corner/blue/diagonal,
/obj/structure/sink{
	 icon_state = "sink";
	dir = 4
	},
/turf/simulated/floor/tiled/white,
/area/medical/surgery2)
"n" = (
/turf/simulated/open,
/area/medical/surgery2)
"o" = (
/obj/effect/floor_decal/corner/blue/diagonal,
/obj/structure/table/glass,
/obj/item/weapon/reagent_containers/dropper,
/obj/item/weapon/reagent_containers/chem_disp_cartridge/peridaxon,
/obj/item/stack/nanopaste,
/obj/machinery/light{
	icon_state = "tube1";
	dir = 8
	},
/turf/simulated/floor/tiled/white,
/area/medical/surgery2)
"p" = (
/obj/effect/floor_decal/corner/blue/diagonal,
/obj/machinery/body_scanconsole{
	 icon_state = "body_scannerconsole";
	dir = 4
	},
/turf/simulated/floor/tiled/white,
/area/medical/surgery2)
"q" = (
/obj/effect/floor_decal/corner/blue/diagonal,
/obj/machinery/bodyscanner{
	 icon_state = "body_scanner_0";
	dir = 4
	},
/turf/simulated/floor/tiled/white,
/area/medical/surgery2)
"r" = (
/obj/effect/floor_decal/corner/blue/diagonal,
/obj/machinery/sleeper{
	 icon_state = "sleeper_0";
	dir = 8
	},
/turf/simulated/floor/tiled/white,
/area/medical/surgery2)
"s" = (
/obj/machinery/light_switch{
	pixel_x = 25
	},
/obj/effect/floor_decal/corner/blue/diagonal,
/turf/simulated/floor/tiled/white,
/area/medical/surgery2)
"t" = (
/obj/effect/floor_decal/corner/blue/diagonal,
/obj/structure/table/glass,
/obj/item/weapon/scalpel/laser1,
/obj/item/weapon/scalpel/laser2,
/obj/item/weapon/scalpel/laser3,
/obj/item/device/robotanalyzer,
/obj/item/device/healthanalyzer,
/obj/item/weapon/storage/firstaid/adv,
/turf/simulated/floor/tiled/white,
/area/medical/surgery2)
"u" = (
/obj/effect/floor_decal/corner/blue/diagonal,
/obj/structure/ladder/updown,
/turf/simulated/floor/tiled/white,
/area/medical/surgery2)
"v" = (
/obj/effect/floor_decal/corner/blue/diagonal,
/obj/machinery/atmospherics/unary/freezer,
/turf/simulated/floor/tiled/white,
/area/medical/surgery2)
"w" = (
/obj/effect/floor_decal/corner/blue/diagonal,
/obj/machinery/atmospherics/unary/cryo_cell,
/turf/simulated/floor/tiled/white,
/area/medical/surgery2)
"x" = (
/obj/effect/floor_decal/corner/blue/diagonal,
/obj/machinery/portable_atmospherics/canister/oxygen/prechilled,
/obj/machinery/atmospherics/portables_connector,
/turf/simulated/floor/tiled/white,
/area/medical/surgery2)
"y" = (
/obj/effect/floor_decal/corner/blue/diagonal,
/obj/structure/closet/secure_closet/freezer/meat,
/turf/simulated/floor/tiled/white,
/area/medical/surgery2)
"z" = (
/obj/effect/floor_decal/corner/blue/diagonal,
/obj/machinery/mecha_part_fabricator,
/turf/simulated/floor/tiled/white,
/area/medical/surgery2)
"A" = (
/obj/effect/floor_decal/corner/blue/diagonal,
/obj/machinery/atmospherics/pipe/simple/visible/blue{
	 icon_state = "intact";
	dir = 5
	},
/turf/simulated/floor/tiled/white,
/area/medical/surgery2)
"B" = (
/obj/effect/floor_decal/corner/blue/diagonal,
/obj/machinery/atmospherics/pipe/manifold/visible/blue,
/obj/item/weapon/reagent_containers/glass/beaker/cryoxadone,
/turf/simulated/floor/tiled/white,
/area/medical/surgery2)
"C" = (
/obj/effect/floor_decal/corner/blue/diagonal,
/obj/machinery/atmospherics/pipe/simple/visible/blue{
	 icon_state = "intact";
	dir = 9
	},
/turf/simulated/floor/tiled/white,
/area/medical/surgery2)
"D" = (
/obj/effect/floor_decal/corner/blue/diagonal,
/obj/machinery/light{
	icon_state = "tube1";
	dir = 4
	},
/turf/simulated/floor/tiled/white,
/area/medical/surgery2)
"E" = (
/obj/effect/floor_decal/corner/blue/diagonal,
/obj/machinery/organ_printer/flesh/mapped,
/turf/simulated/floor/tiled/white,
/area/medical/surgery2)
"F" = (
/obj/effect/floor_decal/corner/blue/diagonal,
/obj/machinery/organ_printer/robot/mapped,
/turf/simulated/floor/tiled/white,
/area/medical/surgery2)
"G" = (
/obj/machinery/light_switch{
	pixel_x = -25
	},
/obj/effect/floor_decal/corner/blue/diagonal,
/turf/simulated/floor/tiled/white,
/area/medical/surgery2)
"H" = (
/obj/machinery/light{
	icon_state = "tube1";
	dir = 8
	},
/obj/effect/floor_decal/corner/blue/diagonal,
/turf/simulated/floor/tiled/white,
/area/medical/surgery2)
"I" = (
/obj/machinery/light{
	icon_state = "tube1";
	dir = 4
	},
/obj/effect/floor_decal/corner/blue/diagonal,
/turf/simulated/floor/tiled/white,
/area/medical/surgery2)
"J" = (
/obj/structure/cable{
	d2 = 2;
	icon_state = "0-2";
	pixel_y = 0
	},
/obj/machinery/power/apc{
	dir = 8;
	name = "west bump";
	pixel_x = -24
	},
/obj/effect/floor_decal/corner/blue/diagonal,
/turf/simulated/floor/tiled/white,
/area/medical/surgery2)
"K" = (
/obj/structure/cable{
	d1 = 1;
	d2 = 2;
	icon_state = "1-2";
	pixel_y = 0
	},
/obj/effect/floor_decal/corner/blue/diagonal,
/turf/simulated/floor/tiled/white,
/area/medical/surgery2)
"L" = (
/obj/structure/cable,
/obj/machinery/power/debug_items/infinite_generator,
/obj/effect/floor_decal/corner/blue/diagonal,
/turf/simulated/floor/tiled/white,
/area/medical/surgery2)
"M" = (
/obj/machinery/light,
/obj/effect/floor_decal/corner/blue/diagonal,
/turf/simulated/floor/tiled/white,
/area/medical/surgery2)

(1,1,1) = {"
a
a
a
a
a
a
a
a
a
a
a
a
a
a
a
a
a
a
a
a
a
a
a
a
a
a
a
a
a
a
a
a
"}
(2,1,1) = {"
a
a
a
a
a
a
a
a
a
a
a
a
a
a
a
a
a
a
a
a
a
a
a
a
a
a
a
a
a
a
a
a
"}
(3,1,1) = {"
a
a
a
a
a
a
a
a
a
a
a
a
a
a
a
a
a
a
a
a
a
a
a
a
a
a
a
a
a
a
a
a
"}
(4,1,1) = {"
a
a
a
a
a
a
a
a
a
a
a
a
a
a
a
a
a
a
a
a
a
a
a
a
a
a
a
a
a
a
a
a
"}
(5,1,1) = {"
a
a
a
a
a
a
a
a
a
a
a
a
a
a
a
a
a
a
a
a
a
a
a
a
a
a
a
a
a
a
a
a
"}
(6,1,1) = {"
a
a
a
a
a
a
a
a
a
a
a
a
a
a
a
a
a
a
a
a
a
a
a
a
a
a
a
a
a
a
a
a
"}
(7,1,1) = {"
a
a
a
a
a
a
a
a
a
a
a
a
a
a
a
a
a
a
a
a
a
a
a
a
a
a
a
a
a
a
a
a
"}
(8,1,1) = {"
a
a
a
a
a
a
a
a
a
a
a
a
a
a
a
a
a
a
a
a
a
a
a
a
a
a
a
a
a
a
a
a
"}
(9,1,1) = {"
a
a
a
a
a
a
a
a
a
a
a
a
a
a
a
a
a
a
a
a
a
a
a
a
a
a
a
a
a
a
a
a
"}
(10,1,1) = {"
a
a
a
a
a
a
a
a
a
a
a
a
a
a
a
a
a
a
a
a
a
a
a
a
a
a
a
a
a
a
a
a
"}
(11,1,1) = {"
a
a
a
a
a
a
a
a
a
a
a
a
a
a
a
a
a
a
a
a
a
a
a
a
a
a
a
a
a
a
a
a
"}
(12,1,1) = {"
a
a
a
a
a
a
a
a
a
a
a
a
a
a
a
a
a
a
a
a
a
a
a
a
a
a
a
a
a
a
a
a
"}
(13,1,1) = {"
a
a
a
a
a
a
a
a
a
a
a
a
a
a
a
a
a
a
a
a
a
a
a
a
a
a
a
a
a
a
a
a
"}
(14,1,1) = {"
a
a
a
a
a
a
a
a
a
b
a
a
a
a
a
a
a
a
a
a
a
a
a
a
a
a
a
a
a
a
a
a
"}
(15,1,1) = {"
a
a
a
a
a
a
a
a
a
a
a
a
a
a
a
a
a
a
a
a
a
a
a
a
a
a
a
a
a
a
a
a
"}
(16,1,1) = {"
a
a
a
a
a
a
a
a
a
a
a
a
a
a
a
a
a
a
a
a
a
a
a
a
a
a
a
a
a
a
a
a
"}
(17,1,1) = {"
a
a
a
a
a
a
a
a
a
a
a
a
a
a
a
a
a
a
a
a
a
a
a
a
a
a
a
a
a
a
a
a
"}
(18,1,1) = {"
a
a
a
a
a
a
a
a
a
c
c
c
c
c
c
c
c
c
c
c
c
c
c
c
a
a
a
a
a
a
a
a
"}
(19,1,1) = {"
a
a
a
a
a
a
a
a
a
c
d
l
o
t
y
E
F
i
G
H
J
K
L
c
a
a
a
a
a
a
a
a
"}
(20,1,1) = {"
a
a
a
a
a
a
a
a
a
c
e
i
p
i
i
i
i
i
i
i
i
i
i
c
a
a
a
a
a
a
a
a
"}
(21,1,1) = {"
a
a
a
a
a
a
a
a
a
c
f
i
q
i
z
i
i
i
i
i
i
i
i
c
a
a
a
a
a
a
a
a
"}
(22,1,1) = {"
a
a
a
a
a
a
a
a
a
c
g
i
i
i
i
i
i
i
i
i
i
i
M
c
a
a
a
a
a
a
a
a
"}
(23,1,1) = {"
a
a
a
a
a
a
a
a
a
c
h
m
r
u
i
i
i
i
i
i
i
i
i
c
a
a
a
a
a
a
a
a
"}
(24,1,1) = {"
a
a
a
a
a
a
a
a
a
c
i
j
n
v
A
i
i
i
i
i
i
i
i
c
a
a
a
a
a
a
a
a
"}
(25,1,1) = {"
a
a
a
a
a
a
a
a
a
c
j
j
n
w
B
i
i
i
i
i
i
i
i
c
a
a
a
a
a
a
a
a
"}
(26,1,1) = {"
a
a
a
a
a
a
a
a
a
c
i
n
n
x
C
i
i
i
i
i
i
i
i
c
a
a
a
a
a
a
a
a
"}
(27,1,1) = {"
a
a
a
a
a
a
a
a
a
c
i
i
i
i
i
i
i
i
i
i
i
i
i
c
a
a
a
a
a
a
a
a
"}
(28,1,1) = {"
a
a
a
a
a
a
a
a
a
c
k
i
i
i
i
i
i
i
i
i
i
i
M
c
a
a
a
a
a
a
a
a
"}
(29,1,1) = {"
a
a
a
a
a
a
a
a
a
c
i
i
i
i
i
i
i
i
i
i
i
i
i
c
a
a
a
a
a
a
a
a
"}
(30,1,1) = {"
a
a
a
a
a
a
a
a
a
c
i
i
i
i
i
i
i
i
i
i
i
i
i
c
a
a
a
a
a
a
a
a
"}
(31,1,1) = {"
a
a
a
a
a
a
a
a
a
c
i
i
s
i
D
i
i
i
i
I
i
i
i
c
a
a
a
a
a
a
a
a
"}
(32,1,1) = {"
a
a
a
a
a
a
a
a
a
c
c
c
c
c
c
c
c
c
c
c
c
c
c
c
a
a
a
a
a
a
a
a
"}
(33,1,1) = {"
a
a
a
a
a
a
a
a
a
a
a
a
a
a
a
a
a
a
a
a
a
a
a
a
a
a
a
a
a
a
a
a
"}
(34,1,1) = {"
a
a
a
a
a
a
a
a
a
a
a
a
a
a
a
a
a
a
a
a
a
a
a
a
a
a
a
a
a
a
a
a
"}
(35,1,1) = {"
a
a
a
a
a
a
a
a
a
a
a
a
a
a
a
a
a
a
a
a
a
a
a
a
a
a
a
a
a
a
a
a
"}
(36,1,1) = {"
a
a
a
a
a
a
a
a
a
a
a
a
a
a
a
a
a
a
a
a
a
a
a
a
a
a
a
a
a
a
a
a
"}
(37,1,1) = {"
a
a
a
a
a
a
a
a
a
a
a
a
a
a
a
a
a
a
a
a
a
a
a
a
a
a
a
a
a
a
a
a
"}
(38,1,1) = {"
a
a
a
a
a
a
a
a
a
a
a
a
a
a
a
a
a
a
a
a
a
a
a
a
a
a
a
a
a
a
a
a
"}
(39,1,1) = {"
a
a
a
a
a
a
a
a
a
a
a
a
a
a
a
a
a
a
a
a
a
a
a
a
a
a
a
a
a
a
a
a
"}
(40,1,1) = {"
a
a
a
a
a
a
a
a
a
a
a
a
a
a
a
a
a
a
a
a
a
a
a
a
a
a
a
a
a
a
a
a
"}
(41,1,1) = {"
a
a
a
a
a
a
a
a
a
a
a
a
a
a
a
a
a
a
a
a
a
a
a
a
a
a
a
a
a
a
a
a
"}
(42,1,1) = {"
a
a
a
a
a
a
a
a
a
a
a
a
a
a
a
a
a
a
a
a
a
a
a
a
a
a
a
a
a
a
a
a
"}
(43,1,1) = {"
a
a
a
a
a
a
a
a
a
a
a
a
a
a
a
a
a
a
a
a
a
a
a
a
a
a
a
a
a
a
a
a
"}
(44,1,1) = {"
a
a
a
a
a
a
a
a
a
a
a
a
a
a
a
a
a
a
a
a
a
a
a
a
a
a
a
a
a
a
a
a
"}
(45,1,1) = {"
a
a
a
a
a
a
a
a
a
a
a
a
a
a
a
a
a
a
a
a
a
a
a
a
a
a
a
a
a
a
a
a
"}
(46,1,1) = {"
a
a
a
a
a
a
a
a
a
a
a
a
a
a
a
a
a
a
a
a
a
a
a
a
a
a
a
a
a
a
a
a
"}
(47,1,1) = {"
a
a
a
a
a
a
a
a
a
a
a
a
a
a
a
a
a
a
a
a
a
a
a
a
a
a
a
a
a
a
a
a
"}
(48,1,1) = {"
a
a
a
a
a
a
a
a
a
a
a
a
a
a
a
a
a
a
a
a
a
a
a
a
a
a
a
a
a
a
a
a
"}
