"aa" = (/obj/effect/landmark/spawn_easy,/turf/unsimulated/floor/desert,/area/planet/daynight)
"ab" = (/turf/unsimulated/floor/desert,/area/planet/daynight)
"ac" = (/obj/effect/landmark/spawn_medium,/turf/unsimulated/floor/desert,/area/planet/daynight)
"ad" = (/obj/structure/bardbedwire,/turf/unsimulated/floor/rock,/area/planet/stranded_outpost)
"ae" = (/obj/structure/destructible/tanktrap,/turf/unsimulated/floor/rock,/area/planet/stranded_outpost)
"af" = (/obj/structure/destructible/sandbag{dir = 1},/obj/structure/destructible/sandbag{dir = 8},/turf/unsimulated/floor/rock,/area/planet/stranded_outpost)
"ag" = (/obj/structure/destructible/sandbag{dir = 1},/turf/unsimulated/floor/rock,/area/planet/stranded_outpost)
"ah" = (/obj/structure/destructible/sandbag{dir = 1},/obj/structure/destructible/sandbag{dir = 4},/turf/unsimulated/floor/rock,/area/planet/stranded_outpost)
"ai" = (/obj/structure/destructible/sandbag{dir = 8},/turf/unsimulated/floor/rock,/area/planet/stranded_outpost)
"aj" = (/obj/effect/landmark/resupply_openworld,/turf/unsimulated/floor/desert,/area/planet/daynight)
"ak" = (/obj/structure/destructible/sandbag{dir = 4},/turf/unsimulated/floor/rock,/area/planet/stranded_outpost)
"al" = (/turf/unsimulated/floor/desert,/area/planet/stranded_outpost)
"am" = (/obj/structure/destructible/sandbag{dir = 8},/obj/structure/destructible/sandbag,/turf/unsimulated/floor/rock,/area/planet/stranded_outpost)
"an" = (/obj/structure/destructible/sandbag,/turf/unsimulated/floor/rock,/area/planet/stranded_outpost)
"ao" = (/obj/structure/destructible/sandbag,/obj/structure/destructible/sandbag{dir = 4},/turf/unsimulated/floor/rock,/area/planet/stranded_outpost)
"ap" = (/obj/structure/barricade,/turf/unsimulated/floor/rock,/area/planet/stranded_outpost)
"aq" = (/obj/structure/bed,/obj/item/weapon/storage/backpack,/turf/unsimulated/floor/rock,/area/planet/stranded_outpost)
"ar" = (/obj/effect/landmark/start/joinlate,/turf/unsimulated/floor/rock,/area/planet/stranded_outpost)
"as" = (/obj/machinery/floodlight/active,/turf/unsimulated/floor/rock,/area/planet/stranded_outpost)
"at" = (/obj/structure/table/rack,/obj/item/device/binoculars,/obj/item/device/binoculars,/turf/unsimulated/floor/rock,/area/planet/stranded_outpost)
"au" = (/obj/structure/closet/crate/random/unsc_medic,/turf/unsimulated/floor/rock,/area/planet/stranded_outpost)
"av" = (/obj/machinery/telecomms/allinone,/turf/unsimulated/floor/rock,/area/planet/stranded_outpost)
"aw" = (/obj/structure/table/standard,/obj/item/device/encryptionkey/shipcom,/obj/item/device/encryptionkey/shipcom,/obj/item/device/encryptionkey/shipcom,/obj/item/device/encryptionkey/shipcom,/obj/item/device/encryptionkey/shipcom,/obj/item/device/encryptionkey/shipcom,/obj/item/device/encryptionkey/shipcom,/obj/item/device/encryptionkey/shipcom,/obj/item/device/encryptionkey/shipcom,/turf/unsimulated/floor/rock,/area/planet/stranded_outpost)
"ax" = (/obj/structure/closet/crate/random/unsc_guns,/turf/unsimulated/floor/rock,/area/planet/stranded_outpost)
"ay" = (/obj/item/weapon/storage/firstaid/unsc,/obj/item/weapon/storage/firstaid/unsc,/obj/item/weapon/storage/firstaid/unsc,/obj/structure/table/standard,/obj/item/weapon/storage/firstaid/unsc,/obj/item/weapon/storage/firstaid/unsc,/obj/item/weapon/storage/firstaid/unsc,/obj/item/weapon/storage/firstaid/surgery,/obj/item/weapon/storage/firstaid/surgery,/turf/unsimulated/floor/rock,/area/planet/stranded_outpost)
"az" = (/obj/structure/destructible/tanktrap,/turf/unsimulated/floor/desert,/area/planet/stranded_outpost)
"aA" = (/obj/machinery/door/unpowered/simple/wood,/turf/unsimulated/floor/rock,/area/planet/stranded_outpost)
"aB" = (/obj/effect/landmark/assault_target_firefight,/turf/unsimulated/floor/rock,/area/planet/stranded_outpost)
"aC" = (/obj/effect/landmark/spawn_hard,/turf/unsimulated/floor/desert,/area/planet/daynight)
"aD" = (/obj/effect/evac_ship,/turf/unsimulated/floor/rock,/area/planet/stranded_outpost)
"aE" = (/obj/structure/table/rack,/obj/item/weapon/material/hatchet/tacknife,/turf/unsimulated/floor/rock,/area/planet/stranded_outpost)
"aF" = (/obj/structure/table/rack,/obj/item/weapon/shovel,/obj/item/weapon/shovel,/obj/item/weapon/shovel,/obj/item/weapon/shovel,/turf/unsimulated/floor/rock,/area/planet/stranded_outpost)
"aG" = (/obj/structure/closet/crate/random/unsc_misc,/turf/unsimulated/floor/rock,/area/planet/stranded_outpost)
"aH" = (/obj/structure/closet/crate/random/unsc_armour,/turf/unsimulated/floor/rock,/area/planet/stranded_outpost)
"aI" = (/obj/structure/closet/crate/random/unsc_mats,/turf/unsimulated/floor/rock,/area/planet/stranded_outpost)
"aJ" = (/obj/structure/table/rack,/obj/item/weapon/material/hatchet,/obj/item/weapon/material/hatchet,/obj/item/weapon/material/hatchet,/obj/item/weapon/material/hatchet,/turf/unsimulated/floor/rock,/area/planet/stranded_outpost)
"aK" = (/obj/structure/destructible/marine_barricade{icon_state = "marine barricade"; dir = 1},/turf/unsimulated/floor/desert,/area/planet/stranded_outpost)
"aL" = (/obj/structure/barricade,/obj/structure/destructible/sandbag{dir = 1},/obj/structure/destructible/sandbag{dir = 8},/turf/unsimulated/floor/rock,/area/planet/stranded_outpost)
"aM" = (/obj/structure/table/rack,/obj/item/device/flashlight/flare,/obj/item/device/flashlight/flare,/obj/item/device/flashlight/flare,/obj/item/device/flashlight/flare,/obj/item/device/flashlight/flare,/obj/item/device/flashlight/flare,/obj/item/device/flashlight/flare,/obj/item/device/flashlight/flare,/obj/item/device/flashlight/flare,/turf/unsimulated/floor/rock,/area/planet/stranded_outpost)
"aN" = (/obj/structure/table/rack,/obj/item/stack/material/cloth{amount = 50},/obj/item/stack/material/cloth{amount = 50},/obj/item/stack/material/cloth{amount = 50},/turf/unsimulated/floor/rock,/area/planet/stranded_outpost)
"aO" = (/obj/structure/barricade,/obj/structure/destructible/sandbag{dir = 1},/turf/unsimulated/floor/rock,/area/planet/stranded_outpost)
"aP" = (/obj/structure/barricade,/obj/structure/destructible/sandbag{dir = 4},/obj/structure/destructible/sandbag{dir = 1},/turf/unsimulated/floor/rock,/area/planet/stranded_outpost)
"aQ" = (/obj/structure/table/rack,/obj/item/stack/material/steel{amount = 50},/obj/item/stack/material/steel{amount = 50},/obj/item/stack/material/steel{amount = 50},/turf/unsimulated/floor/rock,/area/planet/stranded_outpost)
"aR" = (/obj/structure/barricade,/obj/structure/destructible/sandbag{dir = 8},/turf/unsimulated/floor/rock,/area/planet/stranded_outpost)
"aS" = (/obj/structure/table/rack,/obj/item/weapon/storage/box/m9_frag,/obj/item/weapon/storage/box/m9_frag,/obj/item/weapon/storage/box/m9_frag,/obj/item/weapon/storage/box/m9_frag,/obj/item/weapon/storage/box/m9_frag,/turf/unsimulated/floor/rock,/area/planet/stranded_outpost)
"aT" = (/obj/structure/table/rack,/obj/item/stack/material/wood{amount = 50},/obj/item/stack/material/wood{amount = 50},/obj/item/stack/material/wood{amount = 50},/turf/unsimulated/floor/rock,/area/planet/stranded_outpost)
"aU" = (/obj/structure/barricade,/obj/structure/destructible/sandbag{dir = 4},/turf/unsimulated/floor/rock,/area/planet/stranded_outpost)
"aV" = (/obj/structure/turret/chaingun{dir = 1},/turf/unsimulated/floor/desert,/area/planet/stranded_outpost)
"aW" = (/obj/structure/barricade,/turf/simulated/floor/tiled,/area/planet)
"aX" = (/turf/simulated/floor/tiled,/area/planet)
"aY" = (/turf/simulated/mineral,/area/planet)
"aZ" = (/obj/effect/landmark/test/safe_turf,/turf/simulated/floor/tiled,/area/planet)
"ba" = (/obj/effect/landmark/test/space_turf,/turf/space,/area/planet)
"bb" = (/obj/effect/landmark/resupply_skip,/turf/unsimulated/floor/desert,/area/planet/stranded_outpost)
"bc" = (/turf/unsimulated/floor/rock,/area/planet/stranded_outpost)
"bd" = (/obj/structure/destructible/marine_barricade{icon_state = "marine barricade"; dir = 8},/turf/unsimulated/floor/desert,/area/planet/stranded_outpost)
"be" = (/obj/structure/destructible/marine_barricade{icon_state = "marine barricade"; dir = 4},/turf/unsimulated/floor/desert,/area/planet/stranded_outpost)
"bf" = (/obj/machinery/floodlight/active,/turf/unsimulated/floor/desert,/area/planet/stranded_outpost)
"bg" = (/obj/effect/landmark/resupply_skip,/turf/unsimulated/floor/rock,/area/planet/stranded_outpost)
"bh" = (/obj/structure/barricade,/obj/structure/destructible/sandbag{dir = 8},/obj/structure/destructible/sandbag,/turf/unsimulated/floor/rock,/area/planet/stranded_outpost)
"bi" = (/turf/simulated/mineral,/area/planet/daynight)
"bj" = (/obj/structure/barricade,/obj/structure/destructible/sandbag,/turf/unsimulated/floor/rock,/area/planet/stranded_outpost)
"bk" = (/obj/structure/barricade,/obj/structure/destructible/sandbag,/obj/structure/destructible/sandbag{dir = 4},/turf/unsimulated/floor/rock,/area/planet/stranded_outpost)
"bl" = (/obj/structure/bed/roller,/turf/unsimulated/floor/rock,/area/planet/stranded_outpost)
"bm" = (/obj/effect/landmark/spawn_legendary,/turf/unsimulated/floor/desert,/area/planet/daynight)
"bn" = (/obj/structure/destructible/marine_barricade,/turf/unsimulated/floor/desert,/area/planet/stranded_outpost)
"bo" = (/obj/structure/turret/chaingun{dir = 2},/turf/unsimulated/floor/desert,/area/planet/stranded_outpost)

(1,1,1) = {"
bmbmbmbmbmbmbmbmbmbmbmbmbmbmbmbmbmbmbmbmbmbmbmbmbmbmbmbmbmbmbmbmbmbmbmbmbmbmbmbmbmbmbmbmbmbmbmbmbmbmbmbmbmbmbmbmbmbmbmbmbmbmbmbmbmbmbmbmbmbmbmbmbmbmbmbmbmbmbmbmbmbmbmbmbmbmbmbmbmbmbmbmbmbmbmbmbmbmbmbm
acababababababababababababababababababababababababababababababababababababababababababababababababababababababababababababababababababababababababababababababababababababababababababababababababababaC
acababababababababababababababababababababababababababababababababababababababababababababababababababababababababababababababababababababababababababababababababababababababababababababababababababaC
acababababababababababababababababababababababababababababababababababababababababababababababababababababababababababababababababababababababababababababababababababababababababababababababababababaC
acababababababababababababababababababababababababababababababababababababababababababababababababababababababababababababababababababababababababababababababababababababababababababababababababababaC
acababababababababababababababababababababababababababababababababababababababababababababababababababababababababababababababababababababababababababababababababababababababababababababababababababaC
acababababababababababababababababababababababababababababababababababababababababababababababababababababababababababababababababababababababababababababababababababababababababababababababababababaC
acababababababababababababababababababababababababababababababababababababababababababababababababababababababababababababababababababababababababababababababababababababababababababababababababababaC
acababababababababababababababababababababababababababababababababababababababababababababababababababababababababababababababababababababababababababababababababababababababababababababababababababaC
acababababababababababababababababababababababababababababababababababababababababababababababababababababababababababababababababababababababababababababababababababababababababababababababababababaC
acababababababababababababababababababababababababababababababababababababababababababababababababababababababababababababababababababababababababababababababababababababababababababababababababababaC
acababababababababababababababababababababababababababababababababababababababababababababababababababababababababababababababababababababababababababababababababababababababababababababababababababaC
acababababababababababababababababababababababababababababababababababababababababababababababababababababababababababababababababababababababababababababababababababababababababababababababababababaC
acababababababababababababababababababababababababababababababababababababababababababababababababababababababababababababababababababababababababababababababababababababababababababababababababababaC
acababababababababababababababababababababababababababababababababababababababababababababababababababababababababababababababababababababababababababababababababababababababababababababababababababaC
acababababababababababababababababababababababababababababababababababababababababababababababababababababababababababababababababababababababababababababababababababababababababababababababababababaC
acababababababababababababababababababababababababababababababababababababababababababababababababababababababababababababababababababababababababababababababababababababababababababababababababababaC
acababababababababababababababababababababababababababababababababababababababababababababababababababababababababababababababababababababababababababababababababababababababababababababababababababaC
acababababababababababababababababababababababababababababababababababababababababababababababababababababababababababababababababababababababababababababababababababababababababababababababababababaC
acababababababababababababababababababababababababababababababababababababababababababababababababababababababababababababababababababababababababababababababababababababababababababababababababababaC
acababababababababababababababababababababababababababababababababababababababababababababababababababababababababababababababababababababababababababababababababababababababababababababababababababaC
acababababababababababababababababababababababababababababababababababababababababababababababababababababababababababababababababababababababababababababababababababababababababababababababababababaC
acababababababababababababababababababababababababababababababababababababababababababababababababababababababababababababababababababababababababababababababababababababababababababababababababababaC
acababababababababababababababababababababababababababababababababababababababababababababababababababababababababababababababababababababababababababababababababababababababababababababababababababaC
acababababababababababababababababababababababababababababababababababababababababababababababababababababababababababababababababababababababababababababababababababababababababababababababababababaC
acababababababababababababababababababababababababababababababababababababababababababababababababababababababababababababababababababababababababababababababababababababababababababababababababababaC
acabababababababababababababababababababababababababababababalalalalalalalalalalalalalalalalalalalalalalalalalalalalalalalalalalalalalalalalalalalalalalabababababababababababababababababababababababaC
acabababababababababababababababababababababababababababababalalalalalalalalalalalalalalalalalalalalalalalalalalalalalalalalalalalalalalalalalalalalalalabababababababababababababababababababababababaC
acabababababababababababababababababababababababababababababalalalalalalalalalalalalalalalalalalalazazazazazazazazalalalalalalalalalalalalalalalalalalalabababababababababababababababababababababababaC
acabababababababababababababababababababababababababababababalalalalalbcbcbcbcbcbcbcbcalalalalalalalalalbbalalalalalalalalalalbcbcbcbcbcbcbcbcbcalalalalabababababababababababababababababababababababaC
acabababababababababababababababababababababababababababababalalalalbcadadadadadadadadadalalalalalalalalalalalalalalalalalaladadadadadadadadadbcbcalalalabababababababababababababababababababababababaC
acabababababababababababababababababababababababababababababalalalalbcadaeaeaeaeaeaeaeaebcalalalalalalalalalalalalalalalalbcaeaeaeaeaeaeaeaeadbcbcalalalabababababababababababababababababababababababaC
acabababababababababababababababababababababababababababababalalalbcbcadaebgbcbcbcbcbcaebcalalbbalalalalalalalalalbbalalalbcaebcbcbcbcbcbgaeadbcbcalalalabababababababababababababababababababababababaC
acabababababababababababababababababababababababababababababalalalbcbcadaebcafagagahbcaebcalalalalalalalalalalalalalalalalbcaebcafagagahbcaeadbcbcalalalabababababababababababababababababababababababaC
acabababababababababababababababababababababababababababababalalalbcbcadaebcaibcbcakbcaebcbcalalalalalalalalalalalalalalalbcaebcaibcbcakbcaeadbcbcalalalabababababababababababababababababababababababaC
acabababababababababababababababababababababababababababababalalalbcbcadaebcaibcbcakbcaebcbcbcalalalalaKaVaKalalalalalbcbcbcaebcaibcbcakbcaeadbcbcalalalabababababababababababababababababababababababaC
acabababababababababababababababababababababababababababababalalalbcbcadaebcamananaobcaebcbcbcbcalalalalalalalalalbcbcbcbcbcaebcamananaobcaeadbcalalalalabababababababababababababababababababababababaC
acabababababababababababababababababababababababababababababalalalbcbcadaebcbcbcbcbcbcaLaOaOaOaOaOaObcbcbcbcbcbcaOaOaOaOaOaOaPbcbcbcbcbcbcaeadbcalalalalabababababababababababababababababababababababaC
acabababababababababababababababababababababababababababababalalalalbcadaeaebcbcbcbcbcaRaqarasaraqapbcbcbcbcbcbcapaxbcasbcaxaUbcbcbcbcbcaeaeadbcalalalalabababababababababababababababababababababababaC
acabababababababababababababababababababababababababababababalalalalbcbcbcbcbcbcbcbcbcaRavarararawapbcbcbcbcbcbcapbcbcbcbcbcaUbcbcbcbcbcbcbcbcbcalalalalabababababababababababababababababababababababaC
acabababababababababababababababababababababababababababababalalalalbcbcbcbcbcbcbcbcbcaRaqarararaqapbcbcbcbcbcbcapaxbcbcbcaxaUbcbcbcbcbcbcbcbcalalalalalabababababababababababababababababababababababaC
acabababababababababababababababababababababababababababababalalalalalalbcbcbcbcbcbcbcaRayarararayapbcbcbgbcbcbcapbcbcbcbcbcaUbcbcbcbcbcbcbcalalalalalalabababababababababababababababababababababababaC
acabababababababababababababababababababababababababababababalalalalalalalbgbcbcbcbcbcaRaqarararaqapbcbcbcbcbcasapaxbcbcbcaxaUbcbcbcbcbcbbalalalalalalalabababababababababababababababababababababababaC
acabababababababababababababababababababababababababababababalalalalazalalalalbcbcbcbcaRapapaAapapapbcbcbcbcbcbcapapapaAapapaUbcbcbcalalalalalazalalalalabababababababababababababababababababababababaC
acabababababababababababababababababababababababababababababalalalalazalalalalalbcbcbcbcbcbcbcbcbcbcbcbcbcbcbcbcbcbcbcbcbcbcbcbcbcalalalalalalazalalalalabababababababababababababababababababababababaC
acabababababababababababababababababababababababababababababalalalalazalalalalbdbcasbcbcbcbcbcbcbcbcbcbcbcbcbcbcbcbcbcbcbcbcbcbcalalbealalalalazalalalalabababababababababababababababababababababababaC
acabababababababababababababababababababababababababababababalalalalazalalalalalalbcbcbcbcbcbcbcbcbcbcbcaBbcbcbcbcbcbcbcbcbcbcbcbfalalalalalalazalalalalabababababababababababababababababababababababaC
acabababababababababababababababababababababababababababababalalalalazalalalalalalbcbcbgbcbcbcbcbcbcbcbcbgbcbcbcbcbcbgbcbcbcbcbcalalalalalalalazalalalalabababababababababababababababababababababababaC
acabababababababababababababababababababababababababababababalalalalazalalalalbdalbcbcbcbcbcbcbcbcbcbcbcbcbcbcbcbcbcbcbcbcbcbcbcalalbealalalalazalalalalabababababababababababababababababababababababaC
acabababababababababababababababababababababababababababababalalalalazalalalalalbcbcbcbcbcbcbcbcbcbcbcaDbcbcbcbcbcbcbcbcbcbcbcbcalalalalalalalazalalalalabababababababababababababababababababababababaC
acabababababababababababababababababababababababababababababalalalalazalalbbalbcbcbcbcaRapapaAapapapbcbcbcbcbcbcapapapaAapapaUbcbcalalalalalalazalalalalabababababababababababababababababababababababaC
acabababababababababababababababababababababababababababababalalalalalalalalalbcbcbcbcaRaEbcbcbcaFapasbcbcbcbcbcapaGbcbcbcaHaUbcbcalalalbbalalalalalalalabababababababababababababababababababababababaC
acabababababababababababababababababababababababababababababalalalalalalalalbcbcbcbcbcaRatbcbcbcaJapbcbcbcbcbcbcapbcbcbcbcbcaUbcbcbcalalalalalalalalalalabababababababababababababababababababababababaC
acabababababababababababababababababababababababababababababalalalalalalbcbcbcbcbcbcbcaRaMbcbcbcaNapbcbcbcbcbcbcapaubcbcbcauaUbcbcbcbcalalalalalalalalalabababababababababababababababababababababababaC
acabababababababababababababababababababababababababababababalalalalbcbcbcbcbcbcbcbcbcaRaMbcbcbcaQapbcbcbgbcbcbcapbcbcblbcbcaUbcbcbcbcbcbcalalalalalalalabababababababababababababababababababababababaC
acabababababababababababababababababababababababababababababalalalalbcadaeaebcbcbcbcbcaRaSbcasbcaTapbcbcbcbcbcbcapaIbcasbcaIaUbcbcbcbcbcaeaeadbcalalalalabababababababababababababababababababababababaC
acabababababababababababababababababababababababababababababalalalalbcadaebcbcbcbcbcbcbhbjbjbjbjbjbjbcbcbcbcbcbcbjbjbjbjbjbjbkbcbcbcbcbcbcaeadbcbcalalalabababababababababababababababababababababababaC
acabababababababababababababababababababababababababababababalalalbcbcadaebcafagagahbcaebcbcbcbcbcalalalalalalalbcbcbcbcbcbcaebcafagagahbcaeadbcbcalalalabababababababababababababababababababababababaC
acabababababababababababababababababababababababababababababalalalbcbcadaebcaibcbcakbcaebcbcbcbcalalalbnbobnalalalbcbcbcbcbcaebcaibcbcakbcaeadbcbcalalalabababababababababababababababababababababababaC
acabababababababababababababababababababababababababababababalalalbcbcadaebcaibcbcakbcaebcbcbcbcalalalalalalalalalalalbcbcbcaebcaibcbcakbcaeadbcbcalalalabababababababababababababababababababababababaC
acabababababababababababababababababababababababababababababalalalbcbcadaebcamananaobcaebcbcbcalalalalalalalalalalalbbalbcbcaebcamananaobcaeadbcbcalalalabababababababababababababababababababababababaC
acabababababababababababababababababababababababababababababalalalbcbcadaebgbcbcbcbcbcaebcbcalbbalalalalalalalalalalalalalbcaebcbcbcbcbcbgaeadbcbcalalalabababababababababababababababababababababababaC
acabababababababababababababababababababababababababababababalalalalbcadaeaeaeaeaeaeaeaebcbcalalalalalalalalalalalalalalalalaeaeaeaeaeaeaeaeadbcbcalalalabababababababababababababababababababababababaC
acabababababababababababababababababababababababababababababalalalalbcadadadadadadadadadalalalalalazazazazazazazazalalalalaladadadadadadadadadbcbcalalalabababababababababababababababababababababababaC
acabababababababababababababababababababababababababababababalalalalbcbcbcbcbcbcbcbcbcbcalalalalalalalalalalalalalalalalalalalalbcbcbcbcbcbcbcbcalalalalabababababababababababababababababababababababaC
acabababababababababababababababababababababababababababababalalalalalbcbcbcbcbcbcbcalalalalalalalalalalalalalalalalalalalalalalalalalbcbcbcalalalalalalabababababababababababababababababababababababaC
acabababababababababababababababababababababababababababababalalalalalalalalalalalalalalalalalalalalalalalalalalalalalalalalalalalalalalalalalalalalalalabababababababababababababababababababababababaC
acabababababababababababababababababababababababababababababalalalalalalalalalalalalalalalalalalalalalalalalalalalalalalalalalalalalalalalalalalalalalalabababababababababababababababababababababababaC
acabababababababababababababababababababababababababababababalalalalalalalalalalalalalalalalalalalalalalalalalalalalalalalalalalalalalalalalalalalalalalabababababababababababababababababababababababaC
acababababababababababababababababababababababababababababababababababababababababababababababababababababababababababababababababababababababababababababababababababababababababababababababababababaC
acababababababababababababababababababababababababababababababababababababababababababababababababababababababababababababababababababababababababababababababababababababababababababababababababababaC
acababababababababababababababababababababababababababababababababababababababababababababababababababababababababababababababababababababababababababababababababababababababababababababababababababaC
acababababababababababababababababababababababababababababababababababababababababababababababababababababababababababababababababababababababababababababababababababababababababababababababababababaC
acababababababababababababababababababababababababababababababababababababababababababababababababababababababababababababababababababababababababababababababababababababababababababababababababababaC
acababababababababababababababababababababababababababababababababababababababababababababababababababababababababababababababababababababababababababababababababababababababababababababababababababaC
acababababababababababababababababababababababababababababababababababababababababababababababababababababababababababababababababababababababababababababababababababababababababababababababababababaC
acababababababababababababababababababababababababababababababababababababababababababababababababababababababababababababababababababababababababababababababababababababababababababababababababababaC
acababababababababababababababababababababababababababababababababababababababababababababababababababababababababababababababababababababababababababababababababababababababababababababababababababaC
acababababababababababababababababababababababababababababababababababababababababababababababababababababababababababababababababababababababababababababababababababababababababababababababababababaC
acababababababababababababababababababababababababababababababababababababababababababababababababababababababababababababababababababababababababababababababababababababababababababababababababababaC
acababababababababababababababababababababababababababababababababababababababababababababababababababababababababababababababababababababababababababababababababababababababababababababababababababaC
acababababababababababababababababababababababababababababababababababababababababababababababababababababababababababababababababababababababababababababababababababababababababababababababababababaC
acababababababababababababababababababababababababababababababababababababababababababababababababababababababababababababababababababababababababababababababababababababababababababababababababababaC
acababababababababababababababababababababababababababababababababababababababababababababababababababababababababababababababababababababababababababababababababababababababababababababababababababaC
acababababababababababababababababababababababababababababababababababababababababababababababababababababababababababababababababababababababababababababababababababababababababababababababababababaC
acababababababababababababababababababababababababababababababababababababababababababababababababababababababababababababababababababababababababababababababababababababababababababababababababababaC
acababababababababababababababababababababababababababababababababababababababababababababababababababababababababababababababababababababababababababababababababababababababababababababababababababaC
acababababababababababababababababababababababababababababababababababababababababababababababababababababababababababababababababababababababababababababababababababababababababababababababababababaC
acababababababababababababababababababababababababababababababababababababababababababababababababababababababababababababababababababababababababababababababababababababababababababababababababababaC
acababababababababababababababababababababababababababababababababababababababababababababababababababababababababababababababababababababababababababababababababababababababababababababababababababaC
acababababababababababababababababababababababababababababababababababababababababababababababababababababababababababababababababababababababababababababababababababababababababababababababababababaC
biababababababababababababababababababababababababababababababababababababababababababababababababababababababababababababababababababababababababababababababababababababababababababababababababababaC
bibiabababababababababababababababababababababababababababababababababababababababababababababababababababababababababababababababababababababababababababababababababababababababababababababababababaC
bibibiababajabababababababababababababababababababababababababababababababababababababababababababababababababababababababababababababababababababababababababababababababababababababababababababababaC
bibibibiabababababababababababababababababababababababababababababababababababababababababababababababababababababababababababababababababababababababababababababababababababababababababababababababaC
aWaWaWbibiababababababababababababababababababababababababababababababababababababababababababababababababababababababababababababababababababababababababababababababababababababababababababababababaC
aWaXaXbibibiabababababababababababababababababababababababababababababababababababababababababababababababababababababababababababababababababababababababababababababababababababababababababababababaC
aYaXaZaXaWbibiababababababababababababababababababababababababababababababababababababababababababababababababababababababababababababababababababababababababababababababababababababababababababababaC
aYaYaXaXaWbibibiabababababababababababababababababababababababababababababababababababababababababababababababababababababababababababababababababababababababababababababababababababababababababababaC
baaYaYaWaWbibibibiaaaaaaaaaaaaaaaaaaaaaaaaaaaaaaaaaaaaaaaaaaaaaaaaaaaaaaaaaaaaaaaaaaaaaaaaaaaaaaaaaaaaaaaaaaaaaaaaaaaaaaaaaaaaaaaaaaaaaaaaaaaaaaaaaaaaaaaaaaaaaaaaaaaaaaaaaaaaaaaaaaaaaaaaaaaaaaaaaaaaaa
"}
