"aa" = (/turf/unsimulated/wall,/area/submaps/covenant/cov_citadelle)
"ab" = (/turf/unsimulated/floor/snow3,/area/submaps/covenant/cov_citadelle)
"ac" = (/obj/structure/tree/snow_dead,/turf/unsimulated/floor/snow3,/area/submaps/covenant/cov_citadelle)
"ad" = (/obj/effect/rocks/small,/turf/unsimulated/floor/snow3,/area/submaps/covenant/cov_citadelle)
"ae" = (/obj/effect/flora/snow/snowygrass,/turf/unsimulated/floor/snow3,/area/submaps/covenant/cov_citadelle)
"af" = (/obj/effect/floor_decal/industrial/warning{icon_state = "warning"; dir = 9},/obj/effect/floor_decal/snow,/turf/simulated/floor/plating,/area/submaps/covenant/cov_citadelle)
"ag" = (/obj/effect/floor_decal/industrial/warning{icon_state = "warning"; dir = 1},/obj/effect/floor_decal/snow,/turf/simulated/floor/plating,/area/submaps/covenant/cov_citadelle)
"ah" = (/obj/effect/floor_decal/industrial/warning{icon_state = "warning"; dir = 5},/obj/effect/floor_decal/snow,/turf/simulated/floor/plating,/area/submaps/covenant/cov_citadelle)
"ai" = (/obj/effect/flora/snow,/turf/unsimulated/floor/snow3,/area/submaps/covenant/cov_citadelle)
"aj" = (/obj/effect/flora/snow/snowbush,/turf/unsimulated/floor/snow3,/area/submaps/covenant/cov_citadelle)
"ak" = (/obj/effect/floor_decal/industrial/warning{icon_state = "warning"; dir = 8},/obj/effect/floor_decal/snow,/turf/simulated/floor/plating,/area/submaps/covenant/cov_citadelle)
"al" = (/obj/effect/floor_decal/snow,/turf/simulated/floor/plating,/area/submaps/covenant/cov_citadelle)
"am" = (/obj/effect/floor_decal/industrial/warning{icon_state = "warning"; dir = 4},/obj/effect/floor_decal/snow,/turf/simulated/floor/plating,/area/submaps/covenant/cov_citadelle)
"an" = (/obj/structure/tree/snow_pine,/turf/unsimulated/floor/snow3,/area/submaps/covenant/cov_citadelle)
"ao" = (/obj/effect/floor_decal/industrial/warning{icon_state = "warning"; dir = 10},/obj/effect/floor_decal/snow,/turf/simulated/floor/plating,/area/submaps/covenant/cov_citadelle)
"ap" = (/obj/effect/floor_decal/industrial/warning,/obj/effect/floor_decal/snow,/turf/simulated/floor/plating,/area/submaps/covenant/cov_citadelle)
"aq" = (/obj/effect/floor_decal/industrial/warning{icon_state = "warning"; dir = 6},/obj/effect/floor_decal/snow,/turf/simulated/floor/plating,/area/submaps/covenant/cov_citadelle)
"ar" = (/turf/simulated/wall/covenant,/area/submaps/covenant/cov_citadelle)
"as" = (/obj/machinery/door/airlock/multi_tile/covenant{name = "Citadelle"},/turf/simulated/floor/covenant,/area/submaps/covenant/cov_citadelle)
"at" = (/turf/simulated/floor/covenant,/area/submaps/covenant/cov_citadelle)
"au" = (/obj/structure/closet/crate/covenant,/obj/machinery/light/covenant/west,/turf/simulated/floor/covenant,/area/submaps/covenant/cov_citadelle)
"av" = (/obj/structure/closet/crate/covenant,/turf/simulated/floor/covenant,/area/submaps/covenant/cov_citadelle)
"aw" = (/obj/structure/closet/crate/covenant,/obj/item/weapon/gun/energy/plasmapistol,/turf/simulated/floor/covenant,/area/submaps/covenant/cov_citadelle)
"ax" = (/obj/machinery/atmospherics/portables_connector,/obj/machinery/portable_atmospherics/canister/oxygen/prechilled{icon_state = "black"; name = "\improper Covenant Canister: \[O2 (Cryo)]"},/turf/simulated/floor/covenant,/area/submaps/covenant/cov_citadelle)
"ay" = (/obj/machinery/atmospherics/unary/cryo_cell/covenant,/turf/simulated/floor/covenant,/area/submaps/covenant/cov_citadelle)
"az" = (/obj/structure/bed/covenant,/turf/simulated/floor/covenant,/area/submaps/covenant/cov_citadelle)
"aA" = (/obj/structure/closet/crate/covenant,/obj/machinery/light/covenant/east,/turf/simulated/floor/covenant,/area/submaps/covenant/cov_citadelle)
"aB" = (/obj/structure/closet/crate/covenant,/obj/machinery/light/covenant/north,/turf/simulated/floor/covenant,/area/submaps/covenant/cov_citadelle)
"aC" = (/obj/machinery/light/covenant/north,/turf/simulated/floor/covenant,/area/submaps/covenant/cov_citadelle)
"aD" = (/obj/machinery/atmospherics/pipe/simple/hidden{icon_state = "intact"; dir = 5},/turf/simulated/floor/covenant,/area/submaps/covenant/cov_citadelle)
"aE" = (/obj/machinery/atmospherics/pipe/manifold/hidden,/turf/simulated/floor/covenant,/area/submaps/covenant/cov_citadelle)
"aF" = (/obj/machinery/atmospherics/pipe/simple/hidden{icon_state = "intact"; dir = 9},/turf/simulated/floor/covenant,/area/submaps/covenant/cov_citadelle)
"aG" = (/mob/living/bot/cleanbot/covenant,/turf/simulated/floor/covenant,/area/submaps/covenant/cov_citadelle)
"aH" = (/obj/structure/energybarricade{icon_state = "3"; dir = 1},/turf/simulated/floor/covenant,/area/submaps/covenant/cov_citadelle)
"aI" = (/obj/structure/closet/crate/covenant,/obj/item/weapon/reagent_containers/glass/beaker/cryoxadone,/obj/item/weapon/reagent_containers/glass/beaker/cryoxadone,/turf/simulated/floor/covenant,/area/submaps/covenant/cov_citadelle)
"aJ" = (/obj/machinery/door/airlock/covenant{name = "Temple"},/turf/simulated/floor/covenant,/area/submaps/covenant/cov_citadelle)
"aK" = (/obj/machinery/light/covenant/south,/turf/simulated/floor/covenant,/area/submaps/covenant/cov_citadelle)
"aL" = (/obj/machinery/door/airlock/covenant{name = "Warehouse"},/turf/simulated/floor/covenant,/area/submaps/covenant/cov_citadelle)
"aM" = (/obj/machinery/light/covenant/west,/turf/simulated/floor/covenant,/area/submaps/covenant/cov_citadelle)
"aN" = (/obj/structure/closet/covenant,/turf/simulated/floor/covenant,/area/submaps/covenant/cov_citadelle)
"aO" = (/obj/machinery/chemical_dispenser/full/covenant,/turf/simulated/floor/covenant,/area/submaps/covenant/cov_citadelle)
"aP" = (/obj/structure/table/marble,/turf/simulated/floor/covenant,/area/submaps/covenant/cov_citadelle)
"aQ" = (/obj/item/weapon/storage/box/beakers,/obj/structure/table/marble,/turf/simulated/floor/covenant,/area/submaps/covenant/cov_citadelle)
"aR" = (/obj/structure/covenant_comms_tower,/turf/simulated/floor/covenant,/area/submaps/covenant/cov_citadelle)
"aS" = (/obj/machinery/light/covenant/east,/turf/simulated/floor/covenant,/area/submaps/covenant/cov_citadelle)
"aT" = (/obj/structure/weapon_rack,/turf/simulated/floor/covenant,/area/submaps/covenant/cov_citadelle)
"aU" = (/obj/structure/energybarricade{icon_state = "3"; dir = 8},/turf/simulated/floor/covenant,/area/submaps/covenant/cov_citadelle)
"aV" = (/obj/structure/table/marble,/obj/item/squad_manager/covenant,/turf/simulated/floor/covenant,/area/submaps/covenant/cov_citadelle)
"aW" = (/obj/machinery/squad_camera_console/covenant,/turf/simulated/floor/covenant,/area/submaps/covenant/cov_citadelle)
"aX" = (/obj/structure/energybarricade{icon_state = "3"; dir = 4},/turf/simulated/floor/covenant,/area/submaps/covenant/cov_citadelle)
"aY" = (/obj/structure/window/reinforced/projresist/covenant{icon_state = "window"; dir = 1},/obj/structure/window/reinforced/projresist/covenant{icon_state = "window"; dir = 8},/obj/structure/grille,/turf/simulated/floor/covenant,/area/submaps/covenant/cov_citadelle)
"aZ" = (/obj/structure/window/reinforced/projresist/covenant{icon_state = "window"; dir = 1},/obj/structure/window/reinforced/projresist/covenant{icon_state = "window"; dir = 4},/obj/structure/grille,/turf/simulated/floor/covenant,/area/submaps/covenant/cov_citadelle)
"ba" = (/obj/machinery/door/airlock/multi_tile/covenant{name = "Citadelle"; icon_state = "closed"; dir = 8},/turf/simulated/floor/covenant,/area/submaps/covenant/cov_citadelle)
"bb" = (/obj/structure/window/reinforced/projresist/covenant{icon_state = "window"; dir = 8},/obj/structure/window/reinforced/projresist/covenant,/obj/structure/grille,/turf/simulated/floor/covenant,/area/submaps/covenant/cov_citadelle)
"bc" = (/obj/structure/window/reinforced/projresist/covenant,/obj/structure/window/reinforced/projresist/covenant{icon_state = "window"; dir = 4},/obj/structure/grille,/turf/simulated/floor/covenant,/area/submaps/covenant/cov_citadelle)
"bd" = (/obj/effect/rocks,/turf/unsimulated/floor/snow3,/area/submaps/covenant/cov_citadelle)
"be" = (/obj/structure/grille,/obj/structure/window/reinforced/projresist/covenant,/obj/structure/window/reinforced/projresist/covenant{icon_state = "window"; dir = 8},/obj/structure/window/reinforced/projresist/covenant{icon_state = "window"; dir = 1},/turf/simulated/floor/covenant,/area/submaps/covenant/cov_citadelle)
"bf" = (/obj/structure/grille,/obj/structure/window/reinforced/projresist/covenant,/obj/structure/window/reinforced/projresist/covenant{icon_state = "window"; dir = 4},/obj/structure/window/reinforced/projresist/covenant{icon_state = "window"; dir = 1},/turf/simulated/floor/covenant,/area/submaps/covenant/cov_citadelle)
"bg" = (/obj/machinery/door/airlock/covenant{name = "Hall"},/turf/simulated/floor/covenant,/area/submaps/covenant/cov_citadelle)
"bh" = (/obj/structure/energybarricade,/turf/simulated/floor/covenant,/area/submaps/covenant/cov_citadelle)
"bi" = (/obj/machinery/door/airlock/covenant{name = "Factory"},/turf/simulated/floor/covenant,/area/submaps/covenant/cov_citadelle)
"bj" = (/obj/structure/repair_bench/cov,/obj/item/weapon/melee/energy/elite_sword/dagger,/obj/item/plasma_core,/turf/simulated/floor/covenant,/area/submaps/covenant/cov_citadelle)
"bk" = (/obj/structure/table/marble,/obj/item/weapon/wirecutters/covenant,/obj/item/weapon/weldingtool/covenant,/obj/item/weapon/wrench/covenant,/obj/item/weapon/screwdriver/covenant,/obj/item/device/multitool/covenant,/obj/item/weapon/crowbar/covenant,/obj/machinery/light/covenant/west,/turf/simulated/floor/covenant,/area/submaps/covenant/cov_citadelle)
"bl" = (/obj/structure/repair_bench/cov,/obj/item/weapon/gun/energy/plasmarepeater{fire_delay = 300; name = "Faulty Type-51 Directed Energy Rifle"; screen_shake = 1},/turf/simulated/floor/covenant,/area/submaps/covenant/cov_citadelle)
"bm" = (/obj/structure/table/marble,/obj/item/stack/material/nanolaminate/fifty,/obj/item/stack/material/nanolaminate/fifty,/obj/item/stack/material/nanolaminate/fifty,/turf/simulated/floor/covenant,/area/submaps/covenant/cov_citadelle)
"bn" = (/obj/structure/repair_bench/cov,/obj/item/clothing/head/helmet/kigyar/skirmisher/commando,/turf/simulated/floor/covenant,/area/submaps/covenant/cov_citadelle)
"bo" = (/obj/structure/repair_bench/cov,/turf/simulated/floor/covenant,/area/submaps/covenant/cov_citadelle)
"bp" = (/obj/structure/table/marble,/obj/item/weapon/wirecutters/covenant,/obj/item/weapon/weldingtool/covenant,/obj/item/weapon/wrench/covenant,/obj/item/weapon/screwdriver/covenant,/obj/item/device/multitool/covenant,/obj/item/weapon/crowbar/covenant,/obj/machinery/light/covenant/north,/turf/simulated/floor/covenant,/area/submaps/covenant/cov_citadelle)
"bq" = (/obj/machinery/door/airlock/multi_tile/covenant/three{icon_state = "closed"; dir = 8},/turf/simulated/floor/covenant,/area/submaps/covenant/cov_citadelle)
"br" = (/obj/machinery/light/covenant/south,/obj/structure/grille,/obj/structure/window/reinforced/projresist/covenant{icon_state = "window"; dir = 1},/obj/structure/window/reinforced/projresist/covenant{icon_state = "window"; dir = 8},/obj/structure/window/reinforced/projresist/covenant,/turf/simulated/floor/covenant,/area/submaps/covenant/cov_citadelle)
"bs" = (/obj/structure/grille,/obj/structure/window/reinforced/projresist/covenant{icon_state = "window"; dir = 4},/obj/structure/window/reinforced/projresist/covenant{icon_state = "window"; dir = 1},/turf/simulated/floor/covenant,/area/submaps/covenant/cov_citadelle)
"bt" = (/obj/structure/grille,/obj/structure/window/reinforced/projresist/covenant{icon_state = "window"; dir = 8},/obj/structure/window/reinforced/projresist/covenant{icon_state = "window"; dir = 4},/obj/structure/window/reinforced/projresist/covenant{icon_state = "window"; dir = 1},/turf/simulated/floor/covenant,/area/submaps/covenant/cov_citadelle)
"bu" = (/obj/vehicles/wraith{dir = 1; icon_state = "wraith_destroyed_north"},/turf/simulated/floor/covenant,/area/submaps/covenant/cov_citadelle)
"bv" = (/obj/machinery/light/covenant/west,/obj/structure/grille,/obj/structure/window/reinforced/projresist/covenant,/obj/structure/window/reinforced/projresist/covenant{icon_state = "window"; dir = 8},/obj/structure/window/reinforced/projresist/covenant{icon_state = "window"; dir = 4},/turf/simulated/floor/covenant,/area/submaps/covenant/cov_citadelle)
"bw" = (/obj/structure/grille,/obj/structure/window/reinforced/projresist/covenant,/obj/structure/window/reinforced/projresist/covenant{icon_state = "window"; dir = 8},/obj/structure/window/reinforced/projresist/covenant{icon_state = "window"; dir = 4},/turf/simulated/floor/covenant,/area/submaps/covenant/cov_citadelle)

(1,1,1) = {"
aaaaaaaaaaaaaaaaaaaaaaaaaaaaaaaaaaaaaaaaaaaaaaaaaaaaaaaaaaaaaaaaaaaaaaaaaaaaaaaaaaaaaaaaaaaaaaaaaaaaaaaaaaaaaaaa
aaabababababababababababababababacabababababababababababadaeaeababababababababababababababababababababababababaa
aaabafagagagagagagagagagagahabababaeababababababababababababaeabababababaiabababababababababababadababaeababajaa
aaabakalalalalalalalalalalamabababababababaeababababababababadababababababababaeabababababababababababababababaa
aaabakalalalalalalalalalalamaeabababaiabababababadababababababajabaeababababacabababababajabaeababababababababaa
aaabakalalalalalalalalalalamabababababababaeabacabababaeababababababababababababababababadababababababababababaa
aaabakalalalalalalalalalalamababadababaeabababababababababababanababababababadababababababababababababababababaa
aaabaoapapapapapapapapapapaqabababababababababababababababababaiababababababaeababababaeabababababababababababaa
aaababababababaiababababababababababaeabababababababababababababababaeabababababababababababababababajababababaa
aaabababaeabababababababababacabababababababababababaeabababababababababababajabababababababacabaeabadababababaa
aaababababababababaeababababababababababababababababababababababadabababacababababababababababababababababababaa
aaabababaiabababababababababajarararararararararabababarasatarabababarararararararararabababababababababaeababaa
aaababababababaeababababaeabararauavavavavavavawarabararatatararaiararaxayaxatarazaAararabababababababaiabababaa
aaababaeabacababababababababaraBavavavavavavavavarabaraCatataCarabarataDaEaFataratataCarabaeabababababababababaa
aaabababababababababababababaravavaGatatatatatatarajarataHaHatarabaratatatatatararatatarababaiababababababababaa
aaababababababaeababadabababaravavatatatatatatatarabaratatatatarabaraIatatatataGararaJarabababababababababababaa
aaabababajabababababababaiabaravavatatatataKatararabaratatatatarabararataKatatatatatatarababababaeabababacababaa
aaababababababababababaeababaravavatatatararaLarababaraHatataHarabajaraJararatatatatatarabababababababanababaiaa
aaabababababaeabababababababaravavatatataratatararararatatatatararararatataraMatatatatarababajababababababababaa
aaabacabababababababababababaravavatatataLatatataraNaNataHaHatavaNaratatataJatatatatatarabababadabababababababaa
aaabababababababababababacabararavatatarararatataCatatatatatatatataCatatarararaOaPaQararabababababababaiabababaa
aaababababababaiabababajabababarararararaiararaMatatatataRatatatatataSararabarararararababababababababababababaa
aaabababababaeababababababababababababaiabaravatataTatatatatatataTatatavarababababababababadabacabaeabababababaa
aaabababababababababaeababababarararararararavatatatataKatataKatatatatavarararararararababababababababababababaa
aaabababababababababababababararaMatatataUatatatatataSaraVaWaraMatatatatataXatatataSararababababababababajababaa
aaabababababababababababababatatataUatatatataUatatatataWaYaZaVatatatataXatatatataXatatatabababababababababababaa
aaababaiabababababaeababababbaatataUatatatataUatatatataVbbbcaWatatatataXatatatataXatatbaabababababababababababaa
aaabababababababbdabababababararaMatatataUatatatatataSaraWaVaraMatatatatataXatatataSararabababaiabababababababaa
aaababababaeabababacabaeabababarararararararaNatatatataCatataCatatatataNarararararararababababaeababababaeababaa
aaababababaeabababababababababaiaiababababaraNatataTatatatatatataTatatavarababababababajabababababababadabababaa
aaababanabababababababababababarararararabararaMatatatataRatatatatataSararabarararararababababababababababababaa
aaabababababajabababababababararavatatarararatataKatatatatatatatataKatatarararatatatararababajabanababacabababaa
aaabababababababababadabababarbebfatatatbgatatataravaNatbhbhatavavaratatatbiatatatatatarabababababababababababaa
aaabacabababababababababababaravatatatbjaratatararararatatatatararararatatarbkatatatatatabababababaiabababababaa
aaabababababaeabaiabababababarbebfatatblararbgarababarbhatatbharababarbiararbmatatatatatababababababababaeababaa
aaabababababaeababaeababababaravatatatatbnboatararabaratatatatarabararatbpbmaGatatatatbqababadababababababababaa
aaabababababababababababababarbebfatatatatatatatarabaratatatatarabaratatatatatatatatatarababaeababababababajabaa
aaabababababababababababababaravatatatatatatatatarabaratbhbhatarabaratatatatatatatatatarabababacabababababababaa
aaababaiababababababababababarbrbsatbtatbtatbtavarabaraKatataKaradaratatatbuatatatataKarabababababababababababaa
aaabababababababababaeabababararbvavbwavbwavbwararabararatatararabararatatatatatataSararabababababababababababaa
aaabababababaeababababababababarararararararararabababarasatarabababarararararararararabababababababadababaiabaa
aaabababababadabacababajababababababababababababababadababababacabababababababababababababababababaeabababababaa
aaababababababababababababababababababababababaiabababababababababababababababababababababajabababababababababaa
aaababababababababababababababababababababababababababababababababababababababababababababababababababababababaa
aaabababababababababababababadababaeababababajabababababaeabababababababababaeababababababababababababababababaa
aaababababaeabababababaeabababababababacabababababababababababababaeabababababababababacababababaiabacababababaa
aaabababababababababababababababababababababababababaiababababababababaiabababababababababababaeabababababababaa
aaababababajababaiababababababababababababaeababababababababajabababababacababababababababababababababababababaa
aaabababababababababababababanababababababababababababababababababababababababababababadabababababababababababaa
aaababababaeababababababababababababaiabababababababababacababababababadabababaeabababababababababababababababaa
aaabababababababababababaeababababababababababababababababababaeabababababanababaiabababababababaiabadababababaa
aaabababababacabababababababababababababababababaeabababababadabaiababababababababababababababababajababaeababaa
aaabababababababababababaiabababababababajababababababababababababababababajabababababaiaeababababababababababaa
aaabababababababababababababacababababababababababababababababababababababababababababababababababababababaiabaa
aaababababababababababababababababababababababababababababababababababababababababababababababababababababababaa
aaaaaaaaaaaaaaaaaaaaaaaaaaaaaaaaaaaaaaaaaaaaaaaaaaaaaaaaaaaaaaaaaaaaaaaaaaaaaaaaaaaaaaaaaaaaaaaaaaaaaaaaaaaaaaaa
"}
