//MAP CONVERTED BY dmm2tgm.py THIS HEADER COMMENT PREVENTS RECONVERSION, DO NOT REMOVE
"aq" = (
/obj/effect/floor_decal/solarpanel,
/obj/machinery/power/solar,
/obj/structure/cable{
	dir = 4;
	icon_state = "1-2"
	},
/obj/structure/cable{
	d2 = 4;
	icon_state = "0-4"
	},
/obj/effect/landmark/clear,
/turf/template_noop,
/area/map_template/ecprobe/solarsp)
"ba" = (
/obj/effect/floor_decal/solarpanel,
/obj/machinery/power/solar,
/obj/item/stack/material/rods,
/obj/structure/cable{
	d2 = 4;
	icon_state = "0-4"
	},
/obj/effect/landmark/clear,
/turf/template_noop,
/area/map_template/ecprobe/solarss)
"bB" = (
/obj/structure/sign/ecplaque{
	pixel_x = -32
	},
/turf/simulated/floor/tiled/techfloor/grid,
/area/map_template/ecprobe/bridge)
"co" = (
/obj/structure/shuttle/engine/heater{
	dir = 8
	},
/obj/structure/window/reinforced{
	dir = 4
	},
/obj/machinery/atmospherics/pipe/simple/visible/fuel{
	dir = 9
	},
/turf/template_noop,
/area/map_template/ecprobe/engineering)
"cY" = (
/obj/machinery/constructable_frame,
/obj/item/stack/cable_coil,
/obj/item/stock_parts/circuitboard/comm_monitor,
/obj/structure/window/reinforced{
	dir = 1
	},
/obj/structure/window/reinforced{
	dir = 4
	},
/turf/simulated/floor/bluegrid,
/area/map_template/ecprobe/engineering)
"da" = (
/obj/structure/cable,
/obj/machinery/power/apc{
	name = "south bump";
	pixel_y = -28
	},
/obj/effect/floor_decal/corner/blue/border,
/turf/simulated/floor/tiled/techfloor,
/area/map_template/ecprobe/bridge)
"dF" = (
/obj/effect/floor_decal/corner/blue/bordercorner{
	dir = 4
	},
/turf/simulated/floor/tiled/techfloor/grid,
/area/map_template/ecprobe/bridge)
"ee" = (
/obj/machinery/atmospherics/binary/pump{
	dir = 4
	},
/turf/simulated/floor/reinforced,
/area/map_template/ecprobe/engineering)
"gl" = (
/obj/effect/landmark/clear,
/obj/structure/shuttle/engine/heater{
	dir = 8
	},
/obj/structure/window/reinforced{
	dir = 4
	},
/obj/machinery/atmospherics/pipe/manifold/visible/fuel{
	dir = 4
	},
/turf/template_noop,
/area/map_template/ecprobe/engineering)
"gs" = (
/obj/structure/cable{
	d1 = 1;
	d2 = 4;
	icon_state = "1-4"
	},
/turf/simulated/floor/reinforced,
/area/map_template/ecprobe/engineering)
"gB" = (
/obj/structure/cable{
	dir = 4;
	icon_state = "1-2"
	},
/turf/simulated/floor/reinforced,
/area/map_template/ecprobe/engineering)
"hQ" = (
/obj/machinery/constructable_frame,
/obj/item/stack/cable_coil,
/obj/item/stock_parts/circuitboard/comm_server,
/obj/structure/window/reinforced,
/obj/structure/window/reinforced{
	dir = 4
	},
/turf/simulated/floor/bluegrid,
/area/map_template/ecprobe/engineering)
"hV" = (
/obj/structure/cable{
	icon_state = "1-2"
	},
/obj/structure/cable{
	dir = 8;
	icon_state = "1-4"
	},
/obj/structure/cable{
	icon_state = "2-8"
	},
/obj/structure/catwalk,
/obj/effect/landmark/clear,
/turf/template_noop,
/area/map_template/ecprobe/solarsp)
"id" = (
/obj/structure/cable{
	icon_state = "1-2"
	},
/turf/simulated/floor/reinforced,
/area/map_template/ecprobe/engineering)
"in" = (
/obj/effect/landmark/clear,
/obj/effect/landmark/clear,
/turf/template_noop,
/area/template_noop)
"jV" = (
/obj/effect/floor_decal/solarpanel,
/obj/machinery/power/solar,
/obj/structure/cable{
	dir = 4;
	icon_state = "1-2"
	},
/obj/structure/cable{
	d1 = 16;
	d2 = 0;
	dir = 1;
	icon_state = "0-4"
	},
/obj/effect/landmark/clear,
/turf/template_noop,
/area/map_template/ecprobe/solarss)
"ky" = (
/obj/structure/cable{
	icon_state = "1-2"
	},
/obj/structure/cable{
	icon_state = "2-8"
	},
/obj/structure/cable{
	dir = 8;
	icon_state = "1-4"
	},
/obj/structure/catwalk,
/obj/effect/landmark/clear,
/turf/template_noop,
/area/map_template/ecprobe/solarsp)
"kM" = (
/turf/simulated/wall/r_wall/hull,
/area/map_template/ecprobe/engineering)
"ld" = (
/obj/structure/cable{
	icon_state = "1-2"
	},
/obj/structure/cable{
	dir = 8;
	icon_state = "1-4"
	},
/obj/structure/cable{
	icon_state = "2-8"
	},
/obj/structure/catwalk,
/mob/living/simple_animal/hostile/hivebot/ranged_damage/strong/guard,
/obj/effect/landmark/clear,
/turf/template_noop,
/area/map_template/ecprobe/solarsp)
"lO" = (
/obj/effect/floor_decal/solarpanel,
/obj/machinery/power/solar,
/obj/structure/cable{
	d1 = 16;
	d2 = 0;
	dir = 1;
	icon_state = "0-4"
	},
/obj/structure/cable{
	dir = 4;
	icon_state = "1-2"
	},
/obj/effect/landmark/clear,
/turf/template_noop,
/area/map_template/ecprobe/solarss)
"mE" = (
/obj/machinery/telecomms/broadcaster,
/obj/effect/landmark/clear,
/obj/effect/landmark/scorcher,
/turf/simulated/floor,
/area/map_template/ecprobe/bridge)
"mG" = (
/obj/structure/cable{
	icon_state = "2-8"
	},
/turf/simulated/floor/tiled/techfloor/grid,
/area/map_template/ecprobe/bridge)
"mH" = (
/obj/structure/cable{
	dir = 8;
	icon_state = "1-4"
	},
/turf/simulated/floor/reinforced,
/area/map_template/ecprobe/engineering)
"mJ" = (
/obj/machinery/computer/ship/engines{
	dir = 8
	},
/obj/effect/floor_decal/corner/blue/border{
	dir = 4
	},
/turf/simulated/floor/tiled/techfloor,
/area/map_template/ecprobe/bridge)
"nJ" = (
/obj/effect/landmark/clear,
/turf/simulated/wall/r_wall/hull,
/area/map_template/ecprobe/engineering)
"nP" = (
/obj/structure/cable{
	d2 = 2;
	icon_state = "0-2"
	},
/obj/item/material/shard,
/obj/structure/catwalk,
/obj/effect/landmark/clear,
/turf/template_noop,
/area/map_template/ecprobe/solarsp)
"oa" = (
/obj/structure/shuttle/engine/propulsion{
	dir = 8
	},
/obj/effect/landmark/clear,
/obj/effect/landmark/scorcher,
/turf/template_noop,
/area/map_template/ecprobe/engineering)
"pi" = (
/obj/machinery/door/airlock/multi_tile/glass/sol{
	dir = 8
	},
/obj/structure/cable{
	dir = 4;
	icon_state = "1-2"
	},
/turf/simulated/floor/tiled/techfloor/grid,
/area/map_template/ecprobe/bridge)
"pv" = (
/obj/machinery/telecomms/server,
/obj/structure/window/reinforced,
/obj/structure/window/reinforced{
	dir = 4
	},
/turf/simulated/floor/bluegrid,
/area/map_template/ecprobe/engineering)
"px" = (
/obj/machinery/atmospherics/pipe/simple/hidden/fuel{
	dir = 4
	},
/turf/simulated/floor/reinforced,
/area/map_template/ecprobe/engineering)
"pA" = (
/obj/structure/cable{
	icon_state = "1-2"
	},
/obj/structure/catwalk,
/obj/effect/landmark/clear,
/turf/template_noop,
/area/map_template/ecprobe/solarsp)
"pG" = (
/obj/structure/shuttle/engine/heater{
	dir = 8
	},
/obj/structure/window/reinforced{
	dir = 4
	},
/obj/machinery/atmospherics/pipe/manifold/visible/fuel{
	dir = 4
	},
/turf/template_noop,
/area/map_template/ecprobe/engineering)
"pX" = (
/obj/structure/shuttle/engine/propulsion{
	dir = 8
	},
/obj/effect/landmark/clear,
/obj/effect/landmark/scorcher,
/turf/template_noop,
/area/template_noop)
"qp" = (
/obj/effect/landmark/clear,
/obj/machinery/atmospherics/pipe/simple/visible/fuel{
	dir = 8
	},
/turf/template_noop,
/area/map_template/ecprobe/engineering)
"qz" = (
/obj/effect/decal/cleanable/blood/gibs/robot{
	pixel_x = 1
	},
/obj/structure/window/reinforced,
/obj/structure/window/reinforced{
	dir = 4
	},
/turf/simulated/floor,
/area/map_template/ecprobe/engineering)
"rg" = (
/obj/structure/catwalk,
/obj/structure/cable{
	dir = 4;
	icon_state = "1-4"
	},
/obj/structure/cable{
	d1 = 1;
	d2 = 4;
	icon_state = "1-4"
	},
/obj/structure/cable{
	icon_state = "1-2"
	},
/obj/effect/landmark/clear,
/obj/effect/landmark/clear,
/turf/template_noop,
/area/map_template/ecprobe/solarss)
"rw" = (
/obj/structure/sign/warning/server_room,
/turf/simulated/wall/r_wall/hull,
/area/map_template/ecprobe/engineering)
"rW" = (
/obj/machinery/computer/modular/preset/civilian,
/obj/effect/floor_decal/corner/blue/border{
	dir = 1
	},
/turf/simulated/floor/tiled/techfloor,
/area/map_template/ecprobe/bridge)
"sk" = (
/obj/effect/landmark/clear,
/obj/effect/landmark/scorcher,
/turf/template_noop,
/area/template_noop)
"so" = (
/obj/item/stack/material/rods,
/obj/item/material/shard,
/obj/effect/landmark/clear,
/turf/template_noop,
/area/template_noop)
"sw" = (
/obj/machinery/computer/ship/sensors{
	dir = 8
	},
/obj/effect/floor_decal/corner/blue/border{
	dir = 4
	},
/turf/simulated/floor/tiled/techfloor,
/area/map_template/ecprobe/bridge)
"th" = (
/obj/machinery/atmospherics/pipe/simple/hidden/fuel{
	dir = 10
	},
/turf/simulated/floor/reinforced,
/area/map_template/ecprobe/engineering)
"tm" = (
/obj/structure/filingcabinet/chestdrawer,
/obj/effect/floor_decal/corner/blue/border{
	dir = 6
	},
/obj/random_multi/single_item/memo_away,
/turf/simulated/floor/tiled/techfloor,
/area/map_template/ecprobe/bridge)
"tQ" = (
/obj/effect/floor_decal/solarpanel,
/obj/machinery/power/solar,
/obj/structure/cable{
	d2 = 4;
	icon_state = "0-4"
	},
/obj/effect/landmark/clear,
/turf/template_noop,
/area/map_template/ecprobe/solarsp)
"uw" = (
/obj/structure/cable{
	icon_state = "1-2"
	},
/obj/structure/catwalk,
/obj/effect/landmark/clear,
/turf/template_noop,
/area/map_template/ecprobe/solarss)
"uG" = (
/obj/machinery/atmospherics/unary/tank/carbon_dioxide{
	dir = 1;
	start_pressure = 1013.25
	},
/obj/effect/floor_decal/industrial/outline/orange,
/turf/simulated/floor/reinforced,
/area/map_template/ecprobe/engineering)
"uK" = (
/turf/simulated/floor/reinforced,
/area/map_template/ecprobe/engineering)
"uT" = (
/obj/effect/landmark/clear,
/obj/structure/shuttle/engine/heater{
	dir = 8
	},
/turf/template_noop,
/area/template_noop)
"uV" = (
/mob/living/simple_animal/hostile/hivebot/ranged_damage/strong/guard,
/turf/simulated/floor,
/area/map_template/ecprobe/engineering)
"vu" = (
/obj/item/stack/material/rods,
/obj/effect/landmark/clear,
/turf/template_noop,
/area/map_template/ecprobe/solarss)
"vz" = (
/turf/template_noop,
/area/template_noop)
"xm" = (
/obj/structure/window/reinforced,
/obj/machinery/door/window{
	dir = 8
	},
/mob/living/simple_animal/hostile/hijacked_drone,
/turf/simulated/floor/bluegrid,
/area/map_template/ecprobe/engineering)
"xr" = (
/obj/structure/cable{
	icon_state = "2-8"
	},
/obj/structure/cable{
	dir = 4;
	icon_state = "1-2"
	},
/mob/living/simple_animal/hostile/hivebot/ranged_damage/strong/guard,
/turf/simulated/floor/reinforced,
/area/map_template/ecprobe/engineering)
"xZ" = (
/obj/machinery/atmospherics/pipe/simple/hidden/fuel,
/turf/simulated/floor/reinforced,
/area/map_template/ecprobe/engineering)
"zp" = (
/obj/machinery/portable_atmospherics/canister/carbon_dioxide/engine_setup{
	start_pressure = 7498.00
	},
/obj/effect/floor_decal/industrial/outline/orange,
/turf/simulated/floor/reinforced,
/area/map_template/ecprobe/engineering)
"AH" = (
/obj/machinery/atmospherics/pipe/simple/hidden/fuel{
	dir = 9
	},
/turf/simulated/floor/reinforced,
/area/map_template/ecprobe/engineering)
"CA" = (
/obj/structure/catwalk,
/obj/structure/cable{
	dir = 4;
	icon_state = "1-4"
	},
/obj/structure/cable{
	d1 = 1;
	d2 = 4;
	icon_state = "1-4"
	},
/mob/living/simple_animal/hostile/hivebot/ranged_damage/strong/guard,
/obj/effect/landmark/clear,
/obj/effect/landmark/clear,
/turf/template_noop,
/area/map_template/ecprobe/solarss)
"DG" = (
/obj/item/material/shard,
/obj/effect/landmark/clear,
/turf/template_noop,
/area/map_template/ecprobe/solarss)
"DX" = (
/obj/machinery/computer/modular/preset/civilian,
/obj/effect/floor_decal/corner/blue/border{
	dir = 5
	},
/turf/simulated/floor/tiled/techfloor,
/area/map_template/ecprobe/bridge)
"Eh" = (
/obj/effect/landmark/clear,
/obj/effect/landmark/scorcher,
/obj/machinery/telecomms/receiver,
/turf/simulated/floor,
/area/map_template/ecprobe/bridge)
"Ez" = (
/obj/effect/landmark/clear,
/obj/item/material/shard,
/obj/machinery/atmospherics/pipe/manifold/visible/fuel{
	dir = 8
	},
/turf/template_noop,
/area/map_template/ecprobe/engineering)
"EI" = (
/obj/machinery/telecomms/processor,
/obj/structure/window/reinforced,
/obj/structure/window/reinforced{
	dir = 8
	},
/turf/simulated/floor/bluegrid,
/area/map_template/ecprobe/engineering)
"EP" = (
/mob/living/simple_animal/hostile/hivebot/ranged_damage/strong/guard,
/obj/effect/landmark/clear,
/turf/template_noop,
/area/template_noop)
"GB" = (
/obj/structure/cable{
	icon_state = "1-2"
	},
/obj/structure/handrail{
	dir = 4
	},
/turf/simulated/floor,
/area/map_template/ecprobe/engineering)
"GW" = (
/obj/item/stack/material/rods,
/obj/item/material/shard,
/obj/effect/landmark/clear,
/turf/template_noop,
/area/map_template/ecprobe/solarsp)
"Hu" = (
/obj/machinery/computer/ship/helm{
	req_access = list(list("ACCESS_EXPLO_HELM"));
	dir = 8
	},
/obj/effect/floor_decal/corner/blue/border{
	dir = 5
	},
/turf/simulated/floor/tiled/techfloor,
/area/map_template/ecprobe/bridge)
"Ix" = (
/obj/structure/bed/chair/office/light{
	dir = 4
	},
/mob/living/simple_animal/hostile/hijacked_drone,
/turf/simulated/floor/tiled/techfloor/grid,
/area/map_template/ecprobe/bridge)
"II" = (
/obj/effect/floor_decal/solarpanel,
/obj/machinery/power/solar,
/obj/structure/cable{
	dir = 4;
	icon_state = "1-2"
	},
/obj/structure/cable{
	d2 = 4;
	icon_state = "0-4"
	},
/obj/effect/landmark/clear,
/turf/template_noop,
/area/map_template/ecprobe/solarss)
"IP" = (
/obj/effect/floor_decal/corner/blue/bordercorner,
/turf/simulated/floor/tiled/techfloor/grid,
/area/map_template/ecprobe/bridge)
"IV" = (
/obj/machinery/telecomms/hub,
/obj/structure/window/reinforced{
	dir = 4
	},
/obj/structure/window/reinforced{
	dir = 1
	},
/turf/simulated/floor/bluegrid,
/area/map_template/ecprobe/engineering)
"JG" = (
/obj/structure/window/reinforced,
/obj/structure/window/reinforced{
	dir = 4
	},
/obj/item/stool,
/turf/simulated/floor/bluegrid,
/area/map_template/ecprobe/engineering)
"JO" = (
/obj/effect/landmark/clear,
/turf/template_noop,
/area/map_template/ecprobe/solarsp)
"Ke" = (
/obj/structure/shuttle/engine/heater{
	dir = 8
	},
/obj/structure/window/reinforced{
	dir = 4
	},
/obj/machinery/atmospherics/pipe/simple/visible/fuel{
	dir = 10
	},
/turf/template_noop,
/area/map_template/ecprobe/engineering)
"Ko" = (
/obj/effect/landmark/clear,
/turf/template_noop,
/area/map_template/ecprobe/engineering)
"KB" = (
/obj/machinery/telecomms/bus,
/obj/structure/window/reinforced{
	dir = 8
	},
/obj/structure/window/reinforced{
	dir = 1
	},
/turf/simulated/floor/bluegrid,
/area/map_template/ecprobe/engineering)
"KD" = (
/obj/effect/decal/cleanable/blood/gibs/robot{
	pixel_x = 1
	},
/obj/structure/window/reinforced{
	dir = 1
	},
/turf/simulated/floor,
/area/map_template/ecprobe/engineering)
"Lc" = (
/obj/structure/cable{
	d1 = 16;
	d2 = 0;
	dir = 4;
	icon_state = "0-2"
	},
/obj/machinery/atmospherics/pipe/manifold/hidden/fuel{
	dir = 4
	},
/turf/simulated/floor/reinforced,
/area/map_template/ecprobe/engineering)
"Ln" = (
/obj/machinery/power/smes/buildable,
/obj/structure/cable{
	d2 = 2;
	icon_state = "0-2"
	},
/turf/simulated/floor/reinforced,
/area/map_template/ecprobe/engineering)
"Lr" = (
/turf/simulated/wall/r_wall/hull,
/area/map_template/ecprobe/bridge)
"Mv" = (
/obj/structure/sign/warning/airlock,
/turf/simulated/wall/r_wall/hull,
/area/map_template/ecprobe/engineering)
"MX" = (
/obj/structure/cable{
	dir = 4;
	icon_state = "1-2"
	},
/obj/machinery/atmospherics/pipe/simple/hidden/fuel,
/turf/simulated/floor/reinforced,
/area/map_template/ecprobe/engineering)
"ND" = (
/turf/simulated/floor/tiled/techfloor/grid,
/area/map_template/ecprobe/bridge)
"NE" = (
/obj/structure/cable{
	dir = 4;
	icon_state = "1-2"
	},
/mob/living/simple_animal/hostile/hivebot/ranged_damage/strong/guard,
/turf/simulated/floor/reinforced,
/area/map_template/ecprobe/engineering)
"NP" = (
/obj/effect/floor_decal/solarpanel,
/obj/machinery/power/solar,
/obj/structure/cable{
	d1 = 16;
	d2 = 0;
	dir = 1;
	icon_state = "0-4"
	},
/obj/effect/landmark/clear,
/turf/template_noop,
/area/map_template/ecprobe/solarss)
"NX" = (
/obj/machinery/shipsensors/weak{
	desc = "Miniturized gravity scanner with various other sensors, used to detect irregularities in surrounding space. Can only run in vacuum to protect delicate quantum BS elements. These ones are completely torn up."
	},
/obj/effect/landmark/clear,
/obj/effect/landmark/scorcher,
/turf/simulated/floor,
/area/map_template/ecprobe/bridge)
"Ok" = (
/obj/effect/floor_decal/solarpanel,
/obj/machinery/power/solar,
/obj/structure/cable{
	d2 = 4;
	icon_state = "0-4"
	},
/obj/effect/landmark/clear,
/turf/template_noop,
/area/map_template/ecprobe/solarss)
"Ow" = (
/obj/structure/cable{
	icon_state = "2-8"
	},
/turf/simulated/floor/reinforced,
/area/map_template/ecprobe/engineering)
"OT" = (
/obj/effect/landmark/clear,
/turf/template_noop,
/area/map_template/ecprobe/solarss)
"OX" = (
/obj/item/stack/material/rods,
/obj/effect/landmark/clear,
/turf/template_noop,
/area/template_noop)
"Ps" = (
/obj/structure/cable{
	icon_state = "1-2"
	},
/mob/living/simple_animal/hostile/hivebot/ranged_damage/strong/guard,
/turf/simulated/floor/reinforced,
/area/map_template/ecprobe/engineering)
"PZ" = (
/obj/machinery/computer/telecomms,
/obj/structure/window/reinforced{
	dir = 4
	},
/obj/structure/window/reinforced{
	dir = 1
	},
/obj/item/disk/astrodata,
/obj/item/paper/ecprobelog,
/turf/simulated/floor/bluegrid,
/area/map_template/ecprobe/engineering)
"QE" = (
/obj/machinery/computer/shuttle_control{
	dir = 8;
	req_access = list("ACCESS_TORCH_PETROV_HELM");
	shuttle_tag = "Petrov"
	},
/obj/effect/floor_decal/corner/blue/border{
	dir = 6
	},
/turf/simulated/floor/tiled/techfloor,
/area/map_template/ecprobe/bridge)
"QF" = (
/obj/structure/cable,
/obj/machinery/power/apc{
	name = "south bump";
	pixel_y = -28
	},
/turf/simulated/floor/reinforced,
/area/map_template/ecprobe/engineering)
"Rs" = (
/obj/item/material/shard,
/obj/effect/landmark/clear,
/turf/template_noop,
/area/template_noop)
"RC" = (
/obj/item/stock_parts/circuitboard/ntnet_relay,
/obj/machinery/constructable_frame,
/obj/item/stack/cable_coil,
/obj/structure/window/reinforced{
	dir = 4
	},
/obj/structure/window/reinforced{
	dir = 1
	},
/turf/simulated/floor/bluegrid,
/area/map_template/ecprobe/engineering)
"RP" = (
/obj/effect/landmark/clear,
/turf/template_noop,
/area/template_noop)
"Sz" = (
/obj/structure/sign/warning/science{
	pixel_x = -32
	},
/obj/structure/cable{
	icon_state = "1-2"
	},
/turf/simulated/floor/tiled/techfloor/grid,
/area/map_template/ecprobe/bridge)
"SM" = (
/obj/item/stack/cable_coil,
/obj/item/stack/material/rods,
/obj/effect/landmark/clear,
/turf/template_noop,
/area/map_template/ecprobe/solarss)
"TJ" = (
/obj/machinery/power/terminal{
	dir = 8
	},
/obj/structure/cable{
	d1 = 16;
	d2 = 0;
	dir = 4;
	icon_state = "0-2"
	},
/obj/machinery/atmospherics/pipe/simple/hidden/fuel,
/turf/simulated/floor/reinforced,
/area/map_template/ecprobe/engineering)
"Uc" = (
/obj/structure/window/reinforced{
	dir = 8
	},
/obj/structure/window/reinforced{
	dir = 1
	},
/obj/structure/backup_server,
/turf/simulated/floor/bluegrid,
/area/map_template/ecprobe/engineering)
"Ug" = (
/obj/machinery/constructable_frame,
/obj/item/stack/cable_coil,
/obj/item/stock_parts/circuitboard/broken,
/obj/structure/window/reinforced,
/turf/simulated/floor/bluegrid,
/area/map_template/ecprobe/engineering)
"UJ" = (
/obj/item/material/shard,
/obj/item/stack/material/rods,
/obj/effect/landmark/clear,
/turf/template_noop,
/area/map_template/ecprobe/solarss)
"UW" = (
/obj/structure/cable{
	dir = 4;
	icon_state = "1-4"
	},
/turf/simulated/floor/reinforced,
/area/map_template/ecprobe/engineering)
"VZ" = (
/turf/simulated/wall/r_wall/hull,
/area/template_noop)
"XJ" = (
/obj/structure/cable{
	icon_state = "1-2"
	},
/obj/structure/cable{
	dir = 4;
	icon_state = "1-2"
	},
/turf/simulated/floor/reinforced,
/area/map_template/ecprobe/engineering)
"Yl" = (
/obj/effect/floor_decal/solarpanel,
/obj/machinery/power/solar,
/obj/structure/cable{
	dir = 4;
	icon_state = "1-2"
	},
/obj/structure/cable{
	d1 = 16;
	d2 = 0;
	dir = 1;
	icon_state = "0-4"
	},
/obj/effect/landmark/clear,
/turf/template_noop,
/area/map_template/ecprobe/solarsp)
"YK" = (
/obj/effect/floor_decal/solarpanel,
/obj/machinery/power/solar,
/obj/structure/cable{
	d1 = 16;
	d2 = 0;
	dir = 1;
	icon_state = "0-4"
	},
/obj/effect/landmark/clear,
/turf/template_noop,
/area/map_template/ecprobe/solarsp)
"YL" = (
/obj/item/stock_parts/circuitboard/smes,
/obj/item/stock_parts/smes_coil/weak,
/obj/item/stack/cable_coil,
/obj/machinery/constructable_frame,
/obj/machinery/atmospherics/pipe/simple/hidden/fuel{
	dir = 4
	},
/turf/simulated/floor/reinforced,
/area/map_template/ecprobe/engineering)
"YU" = (
/obj/machinery/door/airlock/external,
/obj/structure/cable{
	icon_state = "1-2"
	},
/turf/simulated/floor,
/area/map_template/ecprobe/engineering)
"Zp" = (
/obj/machinery/constructable_frame,
/obj/item/stack/cable_coil,
/obj/item/stock_parts/circuitboard/broken,
/obj/structure/window/reinforced{
	dir = 1
	},
/obj/structure/window/reinforced{
	dir = 8
	},
/turf/simulated/floor/bluegrid,
/area/map_template/ecprobe/engineering)
"ZC" = (
/obj/machinery/suit_storage_unit/engineering/salvage,
/turf/simulated/floor,
/area/map_template/ecprobe/engineering)

(1,1,1) = {"
vz
vz
vz
vz
vz
vz
vz
vz
vz
vz
vz
vz
vz
vz
vz
vz
vz
vz
vz
vz
vz
vz
vz
vz
vz
vz
vz
vz
vz
vz
"}
(2,1,1) = {"
vz
vz
vz
vz
vz
vz
vz
vz
vz
vz
vz
vz
RP
RP
pX
RP
vz
vz
vz
vz
vz
vz
vz
vz
vz
vz
vz
vz
vz
vz
"}
(3,1,1) = {"
vz
vz
vz
vz
vz
vz
vz
vz
vz
vz
vz
vz
RP
RP
RP
RP
vz
vz
vz
vz
vz
vz
vz
vz
vz
vz
vz
vz
vz
vz
"}
(4,1,1) = {"
vz
vz
vz
vz
vz
vz
vz
vz
vz
vz
vz
vz
RP
RP
RP
pX
vz
vz
vz
vz
vz
vz
vz
vz
vz
vz
vz
vz
vz
vz
"}
(5,1,1) = {"
vz
vz
vz
vz
vz
vz
vz
vz
vz
vz
vz
vz
RP
VZ
in
in
vz
vz
vz
vz
vz
vz
vz
vz
vz
vz
vz
vz
vz
vz
"}
(6,1,1) = {"
vz
vz
vz
vz
vz
vz
vz
RP
RP
RP
RP
RP
RP
RP
uT
RP
RP
RP
RP
RP
RP
RP
RP
vz
vz
vz
vz
vz
vz
vz
"}
(7,1,1) = {"
vz
vz
vz
RP
RP
RP
RP
RP
RP
RP
kM
kM
oa
oa
Ko
Ko
oa
oa
kM
kM
in
RP
RP
RP
RP
RP
RP
vz
vz
vz
"}
(8,1,1) = {"
vz
vz
vz
RP
RP
RP
RP
RP
RP
RP
kM
kM
Ke
pG
Ez
gl
pG
co
kM
kM
RP
RP
RP
RP
RP
RP
RP
vz
vz
vz
"}
(9,1,1) = {"
vz
vz
vz
RP
RP
RP
RP
RP
RP
kM
kM
uG
kM
kM
qp
kM
kM
kM
zp
kM
kM
RP
RP
RP
RP
RP
RP
vz
vz
vz
"}
(10,1,1) = {"
vz
vz
vz
RP
RP
RP
RP
RP
RP
kM
kM
px
uK
uK
YL
Ln
gs
uK
ee
kM
kM
RP
RP
RP
RP
RP
RP
vz
vz
vz
"}
(11,1,1) = {"
vz
vz
vz
OX
RP
RP
RP
RP
kM
kM
uK
th
xZ
xZ
Lc
TJ
MX
xZ
AH
uK
kM
kM
RP
RP
RP
RP
RP
vz
vz
vz
"}
(12,1,1) = {"
vz
vz
vz
Rs
RP
RP
RP
RP
kM
kM
uK
Zp
Ug
uK
gB
gB
gB
KD
uV
uK
kM
kM
RP
RP
EP
RP
RP
RP
RP
vz
"}
(13,1,1) = {"
RP
JO
GW
JO
tQ
tQ
JO
nJ
kM
kM
uK
cY
hQ
uK
gB
gB
gB
RC
qz
uK
kM
kM
nJ
OT
Ok
DG
OT
OT
DG
vz
"}
(14,1,1) = {"
RP
JO
JO
tQ
aq
aq
JO
rw
kM
Mv
uK
uK
uK
uK
gB
NE
gB
uK
uK
uK
Mv
kM
rw
OT
II
ba
UJ
OT
OT
vz
"}
(15,1,1) = {"
so
JO
nP
hV
ky
ld
pA
YU
GB
YU
id
id
id
Ps
UW
Ow
XJ
id
id
id
YU
GB
YU
uw
rg
CA
vu
SM
DG
vz
"}
(16,1,1) = {"
RP
JO
YK
Yl
Yl
Yl
JO
kM
ZC
kM
uK
uK
uK
uK
uK
uK
xr
id
id
QF
kM
ZC
kM
OT
jV
lO
vu
OT
OT
vz
"}
(17,1,1) = {"
RP
GW
YK
YK
YK
YK
JO
kM
kM
kM
uK
KB
EI
uK
uK
uK
gB
Uc
xm
uK
kM
kM
kM
OT
NP
NP
OT
UJ
OT
vz
"}
(18,1,1) = {"
vz
vz
vz
vz
vz
vz
vz
sk
kM
kM
uK
IV
pv
uK
uK
uK
gB
PZ
JG
uK
kM
kM
sk
RP
vz
vz
vz
vz
vz
vz
"}
(19,1,1) = {"
vz
vz
vz
vz
vz
vz
vz
sk
kM
kM
uK
uK
uK
uK
uK
uK
gB
uK
uK
uK
kM
kM
sk
RP
vz
vz
vz
vz
vz
vz
"}
(20,1,1) = {"
vz
vz
vz
vz
vz
vz
vz
sk
sk
kM
kM
uK
uK
uK
uK
mH
UW
uK
uK
kM
kM
sk
sk
RP
vz
vz
vz
vz
vz
vz
"}
(21,1,1) = {"
vz
vz
vz
vz
vz
vz
vz
sk
sk
Lr
Lr
Lr
Lr
Lr
ND
pi
Lr
Lr
Lr
Lr
Lr
sk
sk
RP
vz
vz
vz
vz
vz
vz
"}
(22,1,1) = {"
vz
vz
vz
vz
vz
vz
vz
RP
sk
sk
Lr
Lr
rW
bB
ND
mG
Sz
da
Lr
Lr
sk
sk
RP
RP
vz
vz
vz
vz
vz
vz
"}
(23,1,1) = {"
vz
vz
vz
vz
vz
vz
vz
RP
RP
sk
Lr
Lr
DX
dF
Ix
Ix
IP
tm
Lr
Lr
sk
RP
RP
RP
vz
vz
vz
vz
vz
vz
"}
(24,1,1) = {"
vz
vz
vz
vz
vz
vz
vz
RP
RP
sk
sk
Lr
Lr
Hu
sw
mJ
QE
Lr
Lr
sk
sk
RP
RP
RP
vz
vz
vz
vz
vz
vz
"}
(25,1,1) = {"
vz
vz
vz
vz
vz
vz
vz
RP
RP
sk
sk
Lr
Lr
Lr
Lr
Lr
Lr
Lr
Lr
sk
sk
RP
RP
RP
vz
vz
vz
vz
vz
vz
"}
(26,1,1) = {"
vz
vz
vz
vz
vz
vz
vz
vz
vz
vz
sk
sk
NX
Lr
Lr
Lr
Lr
mE
Eh
sk
vz
vz
vz
vz
vz
vz
vz
vz
vz
vz
"}
(27,1,1) = {"
vz
vz
vz
vz
vz
vz
vz
vz
vz
vz
vz
sk
sk
sk
sk
sk
sk
sk
sk
vz
vz
vz
vz
vz
vz
vz
vz
vz
vz
vz
"}
(28,1,1) = {"
vz
vz
vz
vz
vz
vz
vz
vz
vz
vz
vz
vz
vz
vz
vz
vz
vz
vz
vz
vz
vz
vz
vz
vz
vz
vz
vz
vz
vz
vz
"}
(29,1,1) = {"
vz
vz
vz
vz
vz
vz
vz
vz
vz
vz
vz
vz
vz
vz
vz
vz
vz
vz
vz
vz
vz
vz
vz
vz
vz
vz
vz
vz
vz
vz
"}
(30,1,1) = {"
vz
vz
vz
vz
vz
vz
vz
vz
vz
vz
vz
vz
vz
vz
vz
vz
vz
vz
vz
vz
vz
vz
vz
vz
vz
vz
vz
vz
vz
vz
"}
