"aa" = (/turf/space,/area/space)
"ab" = (/turf/simulated/wall/r_wall,/area/space)
"ac" = (/obj/machinery/light/colored/red{tag = "icon-red1 (EAST)"; icon_state = "red1"; dir = 4},/turf/simulated/floor/plating,/area/space)
"ad" = (/turf/simulated/floor/plating,/area/space)
"ae" = (/obj/machinery/light/colored/red{tag = "icon-red1 (WEST)"; icon_state = "red1"; dir = 8},/turf/simulated/floor/plating,/area/space)
"af" = (/obj/machinery/fusion_thruster/fueled{tag = "icon-nozzle1 (WEST)"; icon_state = "nozzle1"; dir = 8},/obj/structure/window/reinforced/treated{basestate = "invis"; dir = 4; icon_state = "invis"},/obj/structure/window/reinforced/treated{basestate = "invis"; dir = 4; icon_state = "invis"},/obj/structure/window/reinforced/treated{basestate = "invis"; dir = 4; icon_state = "invis"},/turf/simulated/floor/plating,/area/space)
"ag" = (/obj/machinery/door/airlock/halo,/obj/machinery/door/firedoor,/turf/simulated/floor/plating,/area/space)
"ah" = (/turf/simulated/floor/tiled/dark,/area/space)
"ai" = (/obj/structure/cable/blue{icon_state = "2-4"},/turf/simulated/floor/plating,/area/space)
"aj" = (/obj/structure/cable/blue{icon_state = "4-8"},/turf/simulated/floor/plating,/area/space)
"ak" = (/obj/structure/cable/blue{icon_state = "2-8"},/turf/simulated/floor/plating,/area/space)
"al" = (/obj/structure/cable/blue{dir = 2; icon_state = "1-2"},/turf/simulated/floor/plating,/area/space)
"am" = (/obj/machinery/light/colored/red{tag = "icon-red1 (WEST)"; icon_state = "red1"; dir = 8},/obj/machinery/power/apc{chargelevel = 0.001; dir = 2; name = "APC"; pixel_y = -24},/obj/structure/cable/blue,/turf/simulated/floor/plating,/area/space)
"an" = (/turf/simulated/floor/tech/gray,/area/space)
"ao" = (/obj/machinery/door/firedoor/multi_tile,/obj/machinery/door/airlock/multi_tile/halo{dir = 2; icon_state = "door_closed"; name = "Starboard Engine Room"; req_access = list(142); tag = "icon-door_closed"},/turf/simulated/floor/plating,/area/space)
"ap" = (/obj/structure/cable/blue{dir = 2; icon_state = "1-2"},/turf/simulated/floor/tiled/dark,/area/space)
"aq" = (/obj/machinery/light{dir = 1},/turf/simulated/floor/plating,/area/space)
"ar" = (/obj/structure/cable/blue{dir = 8; icon_state = "0-4"},/obj/structure/computerframe{anchored = 1; icon = 'code/modules/halo/icons/machinery/computer.dmi'; icon_state = "computer"; layer = 2; level = 1; tag = "icon-computer"},/obj/machinery/photocopier/faxmachine{department = "UNSC Fox"; icon = 'code/modules/halo/icons/machinery/computer.dmi'; icon_state = "nav"; name = "UNSC HIGHCOM Priority Communications Line"},/turf/simulated/wall/r_wall,/area/space)
"as" = (/obj/structure/cable/blue{dir = 8; icon_state = "0-4"},/obj/structure/computerframe{anchored = 1; icon = 'code/modules/halo/icons/machinery/computer.dmi'; icon_state = "computer"; layer = 2; level = 1; tag = "icon-computer"},/obj/machinery/computer/navigation{tag = "icon-engine"; icon = 'code/modules/halo/icons/machinery/computer.dmi'; icon_state = "engine"},/turf/simulated/wall/r_wall,/area/space)
"at" = (/turf/simulated/floor/tiled,/area/space)
"au" = (/obj/structure/cable/blue{icon_state = "0-2"},/turf/simulated/floor/tiled,/area/space)
"av" = (/obj/machinery/light{icon_state = "tube1"; dir = 8},/turf/simulated/floor/tiled/dark,/area/space)
"aw" = (/obj/structure/cable/blue{dir = 2; icon_state = "1-2"},/obj/machinery/light{dir = 4},/turf/simulated/floor/tiled/dark,/area/space)
"ax" = (/obj/structure/bed/chair/comfy/captain{dir = 1; icon_state = "capchair_preview"; name = "Bridge chair"; tag = "icon-capchair_preview (NORTH)"},/obj/structure/cable/blue{dir = 2; icon_state = "1-2"},/turf/simulated/floor/tiled/dark,/area/space)
"ay" = (/obj/structure/window/reinforced/treated{tag = "icon-fwindow (SOUTHWEST)"; icon_state = "fwindow"; dir = 10},/obj/structure/grille,/turf/simulated/floor/tiled/dark,/area/space)
"az" = (/obj/structure/cable/blue{dir = 2; icon_state = "1-2"},/turf/simulated/floor/tiled,/area/space)
"aA" = (/obj/machinery/light,/turf/simulated/floor/plating,/area/space)
"aB" = (/obj/structure/grille,/obj/machinery/door/blast/regular{_wifi_id = "prowlerbridge"; id = "prowlerbridge"; name = "Blast Shield"},/obj/structure/window/reinforced/treated{tag = "icon-fwindow (SOUTHWEST)"; icon_state = "fwindow"; dir = 10},/turf/simulated/floor/tiled/dark,/area/space)
"aC" = (/obj/machinery/light/colored/blue{tag = "icon-blue1 (NORTH)"; icon_state = "blue1"; dir = 1},/turf/simulated/floor/tiled/dark,/area/space)
"aD" = (/obj/machinery/door/firedoor,/obj/structure/cable/blue{dir = 2; icon_state = "1-2"},/turf/simulated/floor/tiled,/area/space)
"aE" = (/obj/structure/cable/blue{icon_state = "2-4"},/turf/simulated/floor/tiled/dark,/area/space)
"aF" = (/obj/structure/cable/blue{icon_state = "4-8"},/turf/simulated/floor/tiled/dark,/area/space)
"aG" = (/obj/structure/stairs_decorative{tag = "icon-stairs (EAST)"; icon_state = "stairs"; dir = 4},/obj/machinery/light/colored/blue{tag = "icon-blue1 (NORTH)"; icon_state = "blue1"; dir = 1},/obj/structure/cable/blue{icon_state = "4-8"},/turf/simulated/floor/tiled/dark,/area/space)
"aH" = (/obj/structure/cable/blue{icon_state = "4-8"},/obj/structure/cable/blue{icon_state = "2-4"},/turf/simulated/floor/tiled/dark,/area/space)
"aI" = (/obj/structure/cable/blue{icon_state = "4-8"},/obj/structure/cable/blue{icon_state = "1-8"},/obj/structure/cable/blue{icon_state = "2-8"},/turf/simulated/floor/tiled/dark,/area/space)
"aJ" = (/obj/structure/cable/blue{icon_state = "4-8"},/obj/structure/cable/blue{icon_state = "1-8"},/turf/simulated/floor/tiled/dark,/area/space)
"aK" = (/obj/structure/cable/blue{icon_state = "2-4"},/obj/structure/cable/blue{icon_state = "4-8"},/turf/simulated/floor/tiled/dark,/area/space)
"aL" = (/obj/structure/cable/blue{icon_state = "4-8"},/obj/machinery/light{dir = 1},/turf/simulated/floor/tiled/dark,/area/space)
"aM" = (/obj/structure/cable/blue{icon_state = "4-8"},/obj/structure/cable/blue{icon_state = "1-8"},/obj/structure/cable/blue{icon_state = "2-4"},/turf/simulated/floor/tiled/dark,/area/space)
"aN" = (/obj/structure/cable/blue{icon_state = "4-8"},/obj/structure/cable/blue{icon_state = "2-8"},/turf/simulated/floor/tiled/dark,/area/space)
"aO" = (/obj/structure/cable/blue{icon_state = "1-8"},/turf/simulated/floor/tiled/dark,/area/space)
"aP" = (/obj/structure/cable/blue{icon_state = "0-4"},/obj/machinery/computer/helm{tag = "icon-nav (WEST)"; icon = 'code/modules/halo/icons/machinery/computer.dmi'; icon_state = "nav"; dir = 8; icon_keyboard = ""; icon_screen = "covie_console_overlay"},/obj/structure/computerframe{anchored = 1; dir = 8; icon = 'code/modules/halo/icons/machinery/computer.dmi'; icon_state = "computer"; layer = 2; level = 1; tag = "icon-computer (WEST)"},/turf/simulated/floor/tiled/dark,/area/space)
"aQ" = (/obj/structure/bed/chair/comfy/captain{dir = 8; icon_state = "capchair_preview"; name = "Bridge chair"; tag = "icon-capchair_preview (WEST)"},/obj/structure/cable/blue{icon_state = "4-8"},/turf/simulated/floor/tiled/dark,/area/space)
"aR" = (/obj/structure/cable/blue{icon_state = "1-8"},/obj/structure/cable/blue{icon_state = "2-8"},/turf/simulated/floor/tiled/dark,/area/space)
"aS" = (/obj/structure/cable/blue{icon_state = "0-2"},/obj/machinery/computer/navigation{tag = "icon-engine"; icon = 'code/modules/halo/icons/machinery/computer.dmi'; icon_state = "engine"},/obj/structure/computerframe{anchored = 1; icon = 'code/modules/halo/icons/machinery/computer.dmi'; icon_state = "computer"; layer = 2; level = 1; tag = "icon-computer"},/turf/simulated/floor/tiled/dark,/area/space)
"aT" = (/obj/structure/stairs_decorative,/obj/structure/cable/blue{dir = 2; icon_state = "1-2"},/turf/simulated/floor/tiled/dark,/area/space)
"aU" = (/obj/structure/cable/blue,/obj/machinery/computer/engines{tag = "icon-nav (NORTH)"; icon = 'code/modules/halo/icons/machinery/computer.dmi'; icon_state = "nav"; dir = 1},/obj/structure/computerframe{anchored = 1; dir = 1; icon = 'code/modules/halo/icons/machinery/computer.dmi'; icon_state = "computer"; layer = 2; level = 1; tag = "icon-computer (NORTH)"},/turf/simulated/wall/r_wall,/area/space)
"aV" = (/obj/structure/cable/blue{dir = 2; icon_state = "1-2"},/obj/structure/cable/blue{icon_state = "2-4"},/turf/simulated/floor/tiled/dark,/area/space)
"aW" = (/obj/structure/cable/blue{icon_state = "2-8"},/turf/simulated/floor/tiled/dark,/area/space)
"aX" = (/obj/machinery/door/firedoor/multi_tile{tag = "icon-door_open (NORTH)"; icon_state = "door_open"; dir = 1},/obj/machinery/door/airlock/multi_tile/halo{name = "Bridge"; req_access = list(309)},/turf/simulated/floor/tiled/dark,/area/space)
"aY" = (/obj/machinery/light,/turf/simulated/floor/tiled/dark,/area/space)
"aZ" = (/obj/machinery/door/firedoor/multi_tile{tag = "icon-door_open (NORTH)"; icon_state = "door_open"; dir = 1},/turf/simulated/floor/tiled/dark,/area/space)
"ba" = (/obj/structure/bed/chair/comfy/captain{tag = "icon-capchair_preview (WEST)"; icon_state = "capchair_preview"; dir = 8},/obj/structure/cable/blue{icon_state = "2-4"},/obj/structure/cable/blue{icon_state = "1-4"},/turf/simulated/floor/tiled/dark,/area/space)
"bb" = (/obj/machinery/light/colored/blue{tag = "icon-blue1 (EAST)"; icon_state = "blue1"; dir = 4},/obj/machinery/power/apc{dir = 8; name = "APC"; pixel_x = -24},/obj/structure/cable/blue,/turf/simulated/floor/tiled/dark,/area/space)
"bc" = (/obj/machinery/door/firedoor,/obj/structure/cable/blue{dir = 2; icon_state = "1-2"},/turf/simulated/floor/tiled/freezer,/area/space)
"bd" = (/obj/structure/cable/blue{icon_state = "0-4"},/obj/machinery/computer/navigation{tag = "icon-engine (WEST)"; icon = 'code/modules/halo/icons/machinery/computer.dmi'; icon_state = "engine"; dir = 8},/obj/structure/computerframe{anchored = 1; dir = 8; icon = 'code/modules/halo/icons/machinery/computer.dmi'; icon_state = "computer"; layer = 2; level = 1; tag = "icon-computer (WEST)"},/turf/simulated/floor/tiled/dark,/area/space)
"be" = (/obj/structure/cable/blue,/obj/structure/computerframe{anchored = 1; dir = 1; icon = 'code/modules/halo/icons/machinery/computer.dmi'; icon_state = "computer_wide"; layer = 2; level = 1; tag = "icon-computer_wide (NORTH)"},/obj/machinery/overmap_weapon_console/npc_comms_console/unsc{tag = "icon-comm (NORTH)"; icon = 'code/modules/halo/icons/machinery/computer.dmi'; icon_state = "comm"; dir = 1},/turf/simulated/floor/tiled/dark,/area/space)
"bf" = (/obj/structure/stairs_decorative{tag = "icon-stairs (NORTH)"; icon_state = "stairs"; dir = 1},/obj/structure/cable/blue{dir = 2; icon_state = "1-2"},/turf/simulated/floor/tiled/dark,/area/space)
"bg" = (/obj/machinery/shower,/obj/machinery/light{tag = "icon-bulb0 (EAST)"; icon_state = "bulb0"; dir = 4},/turf/simulated/floor/tiled/freezer,/area/space)
"bh" = (/obj/structure/sink{dir = 1; pixel_y = 16},/obj/structure/mirror{pixel_x = 0; pixel_y = 30},/obj/machinery/light{icon_state = "tube1"; dir = 8},/turf/simulated/floor/tiled/freezer,/area/space)
"bi" = (/obj/structure/cable/blue{dir = 2; icon_state = "1-2"},/turf/simulated/floor/tiled/freezer,/area/space)
"bj" = (/obj/structure/sink{dir = 1; pixel_y = 16},/obj/structure/mirror{pixel_x = 0; pixel_y = 30},/obj/machinery/light{dir = 4},/turf/simulated/floor/tiled/freezer,/area/space)
"bk" = (/obj/structure/cable/blue{icon_state = "0-2"},/obj/machinery/power/apc{dir = 1; name = "APC"; pixel_y = 24},/turf/simulated/floor/tiled/dark,/area/space)
"bl" = (/obj/machinery/atmospherics/pipe/tank/oxygen{dir = 4},/obj/machinery/light/colored/red{tag = "icon-red1 (NORTH)"; icon_state = "red1"; dir = 1},/turf/simulated/floor/plating,/area/space)
"bm" = (/obj/machinery/atmospherics/pipe/manifold/visible/blue{dir = 1},/turf/simulated/floor/plating,/area/space)
"bn" = (/obj/machinery/atmospherics/binary/pump/high_power/on{dir = 4; target_pressure = 15000},/obj/structure/cable/blue{icon_state = "0-2"},/obj/machinery/power/apc{dir = 1; name = "APC"; pixel_y = 24},/turf/simulated/floor/plating,/area/space)
"bo" = (/obj/machinery/atmospherics/pipe/simple/visible/blue{dir = 4},/obj/structure/closet/walllocker/emerglocker/north,/turf/simulated/floor/plating,/area/space)
"bp" = (/obj/machinery/atmospherics/pipe/simple/visible/blue{dir = 4},/obj/structure/extinguisher_cabinet{pixel_y = 30},/turf/simulated/floor/plating,/area/space)
"bq" = (/obj/machinery/atmospherics/pipe/manifold/visible/blue{dir = 1},/obj/machinery/light/colored/red{tag = "icon-red1 (NORTH)"; icon_state = "red1"; dir = 1},/turf/simulated/floor/plating,/area/space)
"br" = (/obj/machinery/atmospherics/pipe/simple/visible/blue{dir = 4},/turf/simulated/floor/plating,/area/space)
"bs" = (/obj/machinery/atmospherics/pipe/simple/visible/blue{dir = 4},/obj/structure/reagent_dispensers/fueltank,/turf/simulated/floor/plating,/area/space)
"bt" = (/obj/machinery/atmospherics/binary/pump/high_power/on{dir = 4; target_pressure = 15000},/obj/structure/extinguisher_cabinet{pixel_y = 30},/turf/simulated/floor/plating,/area/space)
"bu" = (/obj/machinery/atmospherics/binary/fusion_cooling{tag = "icon-cooling_manifold (EAST)"; icon_state = "cooling_manifold"; dir = 4},/obj/machinery/light/colored/red{tag = "icon-red1 (NORTH)"; icon_state = "red1"; dir = 1},/turf/simulated/floor/plating,/area/space)
"bv" = (/obj/structure/closet/wall_medical{pixel_y = 32},/obj/machinery/atmospherics/pipe/simple/visible/blue{dir = 10},/turf/simulated/floor/plating,/area/space)
"bw" = (/obj/structure/cable/blue{icon_state = "1-4"},/turf/simulated/floor/tiled/dark,/area/space)
"bx" = (/obj/structure/cable/blue{icon_state = "4-8"},/obj/machinery/button/remote/blast_door{_wifi_id = "prowlerbridge"; id = "prowlerbridge"; name = "Bridge Shutters Control"; pixel_x = 0; pixel_y = -32},/turf/simulated/floor/tiled/dark,/area/space)
"by" = (/obj/structure/stairs_decorative{tag = "icon-stairs (EAST)"; icon_state = "stairs"; dir = 4},/obj/machinery/light/colored/blue,/obj/structure/cable/blue{icon_state = "4-8"},/turf/simulated/floor/tiled/dark,/area/space)
"bz" = (/obj/structure/cable/blue{icon_state = "4-8"},/obj/structure/cable/blue{icon_state = "1-4"},/turf/simulated/floor/tiled/dark,/area/space)
"bA" = (/obj/structure/cable/blue{icon_state = "1-8"},/obj/structure/cable/blue{icon_state = "2-8"},/obj/structure/cable/blue{icon_state = "4-8"},/turf/simulated/floor/tiled/dark,/area/space)
"bB" = (/obj/structure/cable/blue{icon_state = "2-8"},/obj/structure/cable/blue{icon_state = "4-8"},/turf/simulated/floor/tiled/dark,/area/space)
"bC" = (/obj/structure/curtain/open/shower,/turf/simulated/floor/tiled/freezer,/area/space)
"bD" = (/obj/structure/cable/blue{icon_state = "2-4"},/turf/simulated/floor/tiled/freezer,/area/space)
"bE" = (/obj/structure/cable/blue{icon_state = "1-8"},/turf/simulated/floor/tiled/freezer,/area/space)
"bF" = (/turf/simulated/floor/tiled/freezer,/area/space)
"bG" = (/obj/machinery/atmospherics/pipe/tank/oxygen{dir = 4},/obj/machinery/light/colored/red{tag = "icon-red1 (EAST)"; icon_state = "red1"; dir = 4},/turf/simulated/floor/plating,/area/space)
"bH" = (/obj/machinery/meter,/obj/machinery/atmospherics/pipe/manifold/visible/blue,/turf/simulated/floor/plating,/area/space)
"bI" = (/obj/machinery/atmospherics/binary/pump/high_power/on{dir = 8; target_pressure = 15000},/obj/structure/cable/blue{dir = 2; icon_state = "1-2"},/turf/simulated/floor/plating,/area/space)
"bJ" = (/obj/machinery/atmospherics/portables_connector{dir = 8},/obj/machinery/portable_atmospherics/canister/oxygen,/turf/simulated/floor/plating,/area/space)
"bK" = (/obj/machinery/atmospherics/pipe/manifold/visible/blue{tag = "icon-map (WEST)"; icon_state = "map"; dir = 8},/obj/machinery/portable_atmospherics/canister/oxygen,/turf/simulated/floor/plating,/area/space)
"bL" = (/obj/machinery/atmospherics/pipe/simple/visible/blue{dir = 10},/turf/simulated/floor/plating,/area/space)
"bM" = (/obj/structure/cable/blue{dir = 8; icon_state = "0-4"},/obj/machinery/power/fusion_drive,/turf/simulated/floor/plating,/area/space)
"bN" = (/obj/machinery/atmospherics/binary/fusion_cooling,/turf/simulated/floor/plating,/area/space)
"bO" = (/obj/machinery/light/colored/blue,/turf/simulated/floor/tiled/dark,/area/space)
"bP" = (/obj/machinery/vending/tool,/turf/simulated/floor/plating,/area/space)
"bQ" = (/obj/machinery/atmospherics/pipe/simple/visible/blue{dir = 5},/turf/simulated/floor/plating,/area/space)
"bR" = (/obj/machinery/atmospherics/unary/freezer{dir = 1; icon_state = "freezer_1"; set_temperature = 0; use_power = 1},/turf/simulated/floor/plating,/area/space)
"bS" = (/obj/machinery/atmospherics/binary/fusion_cooling{tag = "icon-cooling_manifold (WEST)"; icon_state = "cooling_manifold"; dir = 8},/obj/structure/cable/blue{dir = 2; icon_state = "1-2"},/turf/simulated/floor/plating,/area/space)
"bT" = (/obj/machinery/atmospherics/pipe/simple/visible/blue{dir = 9},/turf/simulated/floor/plating,/area/space)
"bU" = (/obj/structure/bed/chair/comfy/captain,/obj/structure/cable/blue{dir = 2; icon_state = "1-2"},/turf/simulated/floor/tiled/dark,/area/space)
"bV" = (/obj/structure/curtain/open,/turf/simulated/floor/tiled/freezer,/area/space)
"bW" = (/obj/structure/table/steel_reinforced,/obj/machinery/light{icon_state = "tube1"; dir = 8},/obj/structure/cable/blue,/obj/machinery/power/apc{dir = 2; name = "APC"; pixel_y = -24},/turf/simulated/floor/tiled/freezer,/area/space)
"bX" = (/obj/structure/table/steel_reinforced,/obj/item/weapon/towel/random,/obj/item/weapon/towel/random,/obj/item/weapon/towel/random,/obj/item/weapon/towel/random,/obj/item/weapon/towel/random,/obj/item/weapon/towel/random,/obj/item/weapon/towel/random,/obj/item/weapon/towel/random,/obj/machinery/alarm{dir = 1; icon_state = "alarm0"; pixel_y = -22},/obj/machinery/light{dir = 4},/turf/simulated/floor/tiled/freezer,/area/space)
"bY" = (/obj/structure/cable/blue{icon_state = "1-4"},/obj/structure/cable/blue{icon_state = "4-8"},/turf/simulated/floor/tiled/dark,/area/space)
"bZ" = (/obj/structure/cable/blue{icon_state = "4-8"},/obj/structure/cable/blue{icon_state = "2-4"},/turf/simulated/floor/plating,/area/space)
"ca" = (/obj/structure/cable/blue{icon_state = "4-8"},/obj/structure/cable/blue{icon_state = "1-4"},/turf/simulated/floor/plating,/area/space)
"cb" = (/obj/structure/cable/blue{icon_state = "4-8"},/obj/structure/cable/blue{icon_state = "2-8"},/turf/simulated/floor/plating,/area/space)
"cc" = (/obj/structure/cable/blue{icon_state = "4-8"},/obj/structure/cable/blue{icon_state = "1-8"},/turf/simulated/floor/plating,/area/space)
"cd" = (/obj/structure/cable/blue,/obj/structure/computerframe{anchored = 1; dir = 1; icon = 'code/modules/halo/icons/machinery/computer.dmi'; icon_state = "computer"; layer = 2; level = 1; tag = "icon-computer (NORTH)"},/turf/simulated/wall/r_wall,/area/space)
"ce" = (/obj/structure/cable/blue,/obj/machinery/overmap_weapon_console/deck_gun_control{tag = "icon-comm (NORTH)"; icon = 'code/modules/halo/icons/machinery/computer.dmi'; icon_state = "comm"; dir = 1},/obj/structure/computerframe{anchored = 1; dir = 1; icon = 'code/modules/halo/icons/machinery/computer.dmi'; icon_state = "computer_wide"; layer = 2; level = 1; tag = "icon-computer_wide (NORTH)"},/turf/simulated/wall/r_wall,/area/space)
"cf" = (/obj/structure/toilet{tag = "icon-toilet00 (NORTH)"; icon_state = "toilet00"; dir = 1},/obj/machinery/light{tag = "icon-bulb0 (EAST)"; icon_state = "bulb0"; dir = 4},/turf/simulated/floor/tiled/freezer,/area/space)
"cg" = (/obj/machinery/door/firedoor/multi_tile{tag = "icon-door_open (NORTH)"; icon_state = "door_open"; dir = 1},/obj/machinery/door/airlock/multi_tile/halo{name = "Reactor Core"; req_access = list(142)},/turf/simulated/floor/plating,/area/space)
"ch" = (/obj/structure/cable/blue{dir = 2; icon_state = "1-2"},/obj/structure/cable/blue{icon_state = "2-4"},/turf/simulated/floor/plating,/area/space)
"ci" = (/obj/machinery/light/colored/red,/obj/structure/cable/blue{icon_state = "4-8"},/turf/simulated/floor/plating,/area/space)
"cj" = (/obj/structure/cable/blue{dir = 2; icon_state = "1-2"},/obj/structure/cable/blue{icon_state = "2-8"},/turf/simulated/floor/plating,/area/space)
"ck" = (/obj/machinery/light/colored/red,/turf/simulated/floor/plating,/area/space)
"cl" = (/obj/structure/cable/blue{dir = 2; icon_state = "1-2"},/obj/machinery/light/colored/red{tag = "icon-red1 (EAST)"; icon_state = "red1"; dir = 4},/turf/simulated/floor/plating,/area/space)
"cm" = (/obj/machinery/door/firedoor/multi_tile,/obj/machinery/door/airlock/multi_tile/halo{tag = "icon-door_closed"; name = "Port Engine Room"; icon_state = "door_closed"; dir = 2; req_access = list(142)},/turf/simulated/floor/plating,/area/space)
"cn" = (/obj/machinery/light/colored/red{tag = "icon-red1 (WEST)"; icon_state = "red1"; dir = 8},/obj/machinery/power/apc{dir = 1; name = "APC"; pixel_y = 24},/obj/structure/cable/blue{icon_state = "0-2"},/turf/simulated/floor/plating,/area/space)
"co" = (/obj/structure/cable/blue{icon_state = "2-4"},/obj/structure/cable/blue{icon_state = "1-4"},/turf/simulated/floor/plating,/area/space)
"cp" = (/obj/structure/cable/blue{icon_state = "0-8"},/obj/machinery/power/smes/advanced{capacity = 1e+009; charge = 1e+009; input_attempt = 1; output_attempt = 1; outputting = 1},/turf/simulated/floor/plating,/area/space)
"cq" = (/obj/structure/cable/blue{icon_state = "1-4"},/turf/simulated/floor/plating,/area/space)
"cr" = (/obj/structure/cable/blue{icon_state = "1-8"},/turf/simulated/floor/plating,/area/space)
"cs" = (/obj/machinery/power/terminal{tag = "icon-term (NORTH)"; icon_state = "term"; dir = 1},/obj/structure/cable/blue{icon_state = "0-8"},/turf/simulated/floor/plating,/area/space)

(1,1,1) = {"
aaaaaaaaaaaaaaaaaaaaaaaaaaaaaaaaaaaaaaaaaaaaaaaaaaaaaaaaaaaaaaaaaaaaaaaaaaaaaaaaaaaaaaaaaaaaaaaaaaaaaaaaaaaaaaaaaaaaaaaa
aaaaaaaaaaaaaaaaaaaaaaaaaaaaaaaaaaaaaaaaaaaaaaaaaaaaaaaaaaaaaaaaaaaaaaaaaaaaaaaaaaaaaaaaaaaaaaaaaaaaaaaaaaaaaaaaaaaaaaaa
aaaaaaaaaaaaaaaaaaaaaaaaaaaaaaaaaaaaaaaaaaaaaaaaaaaaaaaaaaaaaaaaaaaaaaaaaaaaaaaaaaaaaaaaaaaaaaaaaaaaaaaaaaaaaaaaaaaaaaaa
aaaaaaaaaaaaaaaaaaaaaaaaaaaaaaaaaaaaaaaaaaaaaaaaaaaaaaaaaaaaaaaaaaaaaaaaaaaaaaaaaaaaaaaaaaaaaaaaaaaaaaaaaaaaaaaaaaaaaaaa
aaaaaaaaaaaaaaaaaaaaaaaaaaaaaaaaaaaaaaaaaaaaaaaaaaaaaaaaaaaaaaaaaaaaaaaaaaaaaaaaaaaaaaaaaaaaaaaaaaaaaaaaaaaaaaaaaaaaaaaa
aaaaaaaaaaaaaaaaaaaaaaaaaaaaaaaaaaaaaaaaaaaaaaaaaaaaaaaaaaaaaaaaaaaaaaaaaaaaaaaaaaaaaaaaaaaaaaaaaaaaaaaaaaaaaaaaaaaaaaaa
aaaaaaaaaaaaaaaaaaaaaaaaaaaaaaaaaaaaaaaaaaaaaaaaaaaaaaaaaaaaaaaaaaaaaaaaaaaaaaaaaaaaaaaaaaaaaaaaaaaaaaaaaaaaaaaaaaaaaaaa
aaaaaaaaaaaaaaaaaaaaaaaaaaaaaaaaaaaaaaaaaaaaaaaaaaaaaaaaaaaaaaaaaaaaaaaaaaaaaaaaaaaaaaaaaaaaaaaaaaaaaaaaaaaaaaaaaaaaaaaa
aaaaaaaaaaaaaaaaaaaaaaaaaaaaaaaaaaaaaaaaaaaaaaaaaaaaaaaaaaaaaaaaaaaaaaaaaaaaaaaaaaaaaaaaaaaaaaaaaaaaaaaaaaaaaaaaaaaaaaaa
aaaaaaaaaaaaaaaaaaaaaaaaaaaaaaaaaaaaaaaaaaaaaaaaaaaaaaaaaaaaaaaaaaaaaaaaaaaaaaaaaaaaaaaaaaaaaaaaaaaaaaaaaaaaaaaaaaaaaaaa
aaaaaaaaaaaaaaaaaaaaaaaaaaaaaaaaaaaaaaaaaaaaaaaaaaaaaaaaaaaaaaaaaaaaaaaaaaaaaaaaaaaaaaaaaaaaaaaaaaaaaaaaaaaaaaaaaaaaaaaa
aaaaaaaaaaaaaaaaaaaaaaaaaaaaaaaaaaaaaaaaaaaaaaaaaaaaaaaaaaaaaaaaaaaaaaaaaaaaaaaaaaaaaaaaaaaaaaaaaaaaaaaaaaaaaaaaaaaaaaaa
aaaaaaaaaaaaaaaaaaaaaaaaaaaaaaaaaaaaaaaaaaaaaaaaaaaaaaaaaaaaaaaaaaaaaaaaaaaaaaaaaaaaaaaaaaaaaaaaaaaaaaaaaaaaaaaaaaaaaaaa
aaaaaaaaaaaaaaaaaaaaaaaaaaaaaaaaaaaaaaaaaaaaaaaaaaaaaaaaaaaaaaaaaaaaaaaaaaaaaaaaaaaaaaabababababababaaaaaaaaaaaaaaaaaaaa
aaaaaaaaaaaaaaaaaaaaaaaaaaaaaaaaaaaaaaaaaaaaaaaaaaaaaaaaaaaaaaaaaaaaaaaaaaaaaaaaaaaaabababababababababaaaaaaaaaaaaaaaaaa
aaaaaaaaaaaaaaaaaaaaaaaaaaaaaaaaaaaaaaaaaaaaaaaaaaaaaaaaaaaaaaaaaaaaaaaaaaaaaaaaaaababababababababababababaaaaaaaaaaaaaa
aaaaaaaaaaaaaaaaaaaaaaaaaaaaaaaaaaaaaaaaaaaaaaaaaaaaaaaaaaaaaaaaaaaaaaaaaaaaaaaaabababababababababababababaaaaaaaaaaaaaa
aaaaaaaaaaaaaaaaaaaaaaaaaaaaaaaaaaaaaaaaaaaaaaaaaaaaaaaaaaaaaaaaaaaaaaaaaaaaaaababababacadadadadaeabadafaaaaaaaaaaaaaaaa
aaaaaaaaaaaaaaaaaaaaaaaaaaaaaaaaaaaaaaaaaaaaaaaaaaaaaaaaaaaaaaaaaaaaaaaaaaaaabababababadadadadadadabacafaaaaaaaaaaaaaaaa
aaaaaaaaaaaaaaaaaaaaaaaaaaaaaaaaaaaaaaaaaaaaaaaaaaaaaaaaaaaaaaaaaaaaaaaaaaababababababadadadadadadagadafaaaaaaaaaaaaaaaa
aaaaaaaaaaaaaaaaaaaaaaaaaaaaaaaaaaaaaaaaaaaaaaaaaaaaaaaaaaaaaaaaaaaaaaaaababahahahahabadadadadadadabadafaaaaaaaaaaaaaaaa
aaaaaaaaaaaaaaaaaaaaaaaaaaaaaaaaaaaaaaaaaaaaaaaaaaaaaaaaaaaaaaaaaaaaaaababahahahahahabadadadaiajakabacafaaaaaaaaaaaaaaaa
aaaaaaaaaaaaaaaaaaaaaaaaaaaaaaaaaaaaaaaaaaaaaaaaaaaaaaaaaaaaaaaaaaaaababahahahahahahabacadadaladamabadafaaaaaaaaaaaaaaaa
aaaaaaaaaaaaaaaaaaaaaaaaaaaaaaabababababaaaaaaaaaaaaaaaaaaababababababanananananananabababaoalababababababaaaaaaaaaaaaaa
aaaaaaaaaaaaaaaaaaaaaaaaaaabababababababababababababababababahahahahabanananananananananabahapabadaqadababaaaaaaaaaaaaaa
aaaaaaaaaaaaaaaaaaaaaaababababarabasabababatatatauatatatabahahahahahabanananananananananabavawabadadadababaaaaaaaaaaaaaa
aaaaaaaaaaaaaaaaaaababababababaxayaxabababatatatazatatatabahahahahahabanananananananananabahapabadaAadababaaaaaaaaaaaaaa
aaaaaaaaaaaaaaaaaBababababahaCapahapaCahababababaDababababababahabababababababababababababahapabadababababaaaaaaaaaaaaaa
aaaaaaaaaaaaaBaBaBaEaFaGaFaHaFaIaFaJaKaFaFaFaLaFaMaFaLaFaFaFaLaFaLaFaFaFaNaFaFaFaLaFaFaFaLaFaOahahahabababaaaaaaaaaaaaaa
aaaaaaaaaaaaaBaPaQaRahayaSaTabaUababaVaWaXahaYahapahaYahaZahaYahaYahaZahapaZahahaYahahahaYahahahaYahabababaaaaaaaaaaaaaa
aaaaaaaaaaaaababayapahaybaaRababababbbapababababbcababababababababababahapababababababababababababababababaaaaaaaaaaaaaa
aaaaaaaaaaaaaBbdaQaRahaybebfabasababahapabbgabbhbibjabbgabahahahahbkabahapabblbmbnbobpbqbrbsbtbobubvabababaaaaaaaaaaaaaa
aaaaaaaaaaaaaBaBaBbwbxbyaFbzaFbAaFbBaFaOabbCabbDbEbFabbCabahahahahapabavawabbGbHbIbmbJbKbmbmbrbLbMbNabababaaaaaaaaaaaaaa
aaaaaaaaaaaaaaaaaBababababahbOapahapbOahabbFbFbibFbFbFbFabahahahahapabahapabbPadalbQbJbRbRbRadbQbSbTabababaaaaaaaaaaaaaa
aaaaaaaaaaaaaaaaaaababababababbUaybUabababbVabbWbFbXabbVabahahahahbwaFaFbYajbZajcaajajajajajcbajccajabababaaaaaaaaaaaaaa
aaaaaaaaaaaaaaaaaaaaaaababababcdabceabababcfabababababcfabahahahahahaZahahcgaladadadadadadadaladadadabababaaaaaaaaaaaaaa
aaaaaaaaaaaaaaaaaaaaaaaaaaabababababababababababababababababababababababababchajajajajciajajcjadckadabababaaaaaaaaaaaaaa
aaaaaaaaaaaaaaaaaaaaaaaaaaaaaaabababababaaaaaaaaaaaaaaaaaaabababababababababcladadadabababcmalababababababaaaaaaaaaaaaaa
aaaaaaaaaaaaaaaaaaaaaaaaaaaaaaaaaaaaaaaaaaaaaaaaaaaaaaaaaaaaaaaaaaaaababababaladadadabacadadaladcnabadafaaaaaaaaaaaaaaaa
aaaaaaaaaaaaaaaaaaaaaaaaaaaaaaaaaaaaaaaaaaaaaaaaaaaaaaaaaaaaaaaaaaaaaaabababcocpadadabadadadcqajcrabacafaaaaaaaaaaaaaaaa
aaaaaaaaaaaaaaaaaaaaaaaaaaaaaaaaaaaaaaaaaaaaaaaaaaaaaaaaaaaaaaaaaaaaaaaaababchcsckadabadadadadadadabadafaaaaaaaaaaaaaaaa
aaaaaaaaaaaaaaaaaaaaaaaaaaaaaaaaaaaaaaaaaaaaaaaaaaaaaaaaaaaaaaaaaaaaaaaaaaababababababadadadadadadagadafaaaaaaaaaaaaaaaa
aaaaaaaaaaaaaaaaaaaaaaaaaaaaaaaaaaaaaaaaaaaaaaaaaaaaaaaaaaaaaaaaaaaaaaaaaaaaabababababadadadadadadabacafaaaaaaaaaaaaaaaa
aaaaaaaaaaaaaaaaaaaaaaaaaaaaaaaaaaaaaaaaaaaaaaaaaaaaaaaaaaaaaaaaaaaaaaaaaaaaaaababababacadadadadaeabadafaaaaaaaaaaaaaaaa
aaaaaaaaaaaaaaaaaaaaaaaaaaaaaaaaaaaaaaaaaaaaaaaaaaaaaaaaaaaaaaaaaaaaaaaaaaaaaaaaabababababababababababababaaaaaaaaaaaaaa
aaaaaaaaaaaaaaaaaaaaaaaaaaaaaaaaaaaaaaaaaaaaaaaaaaaaaaaaaaaaaaaaaaaaaaaaaaaaaaaaaaababababababababababababaaaaaaaaaaaaaa
aaaaaaaaaaaaaaaaaaaaaaaaaaaaaaaaaaaaaaaaaaaaaaaaaaaaaaaaaaaaaaaaaaaaaaaaaaaaaaaaaaaaabababababababababaaaaaaaaaaaaaaaaaa
aaaaaaaaaaaaaaaaaaaaaaaaaaaaaaaaaaaaaaaaaaaaaaaaaaaaaaaaaaaaaaaaaaaaaaaaaaaaaaaaaaaaaaabababababababaaaaaaaaaaaaaaaaaaaa
aaaaaaaaaaaaaaaaaaaaaaaaaaaaaaaaaaaaaaaaaaaaaaaaaaaaaaaaaaaaaaaaaaaaaaaaaaaaaaaaaaaaaaaaaaaaaaaaaaaaaaaaaaaaaaaaaaaaaaaa
aaaaaaaaaaaaaaaaaaaaaaaaaaaaaaaaaaaaaaaaaaaaaaaaaaaaaaaaaaaaaaaaaaaaaaaaaaaaaaaaaaaaaaaaaaaaaaaaaaaaaaaaaaaaaaaaaaaaaaaa
aaaaaaaaaaaaaaaaaaaaaaaaaaaaaaaaaaaaaaaaaaaaaaaaaaaaaaaaaaaaaaaaaaaaaaaaaaaaaaaaaaaaaaaaaaaaaaaaaaaaaaaaaaaaaaaaaaaaaaaa
aaaaaaaaaaaaaaaaaaaaaaaaaaaaaaaaaaaaaaaaaaaaaaaaaaaaaaaaaaaaaaaaaaaaaaaaaaaaaaaaaaaaaaaaaaaaaaaaaaaaaaaaaaaaaaaaaaaaaaaa
aaaaaaaaaaaaaaaaaaaaaaaaaaaaaaaaaaaaaaaaaaaaaaaaaaaaaaaaaaaaaaaaaaaaaaaaaaaaaaaaaaaaaaaaaaaaaaaaaaaaaaaaaaaaaaaaaaaaaaaa
aaaaaaaaaaaaaaaaaaaaaaaaaaaaaaaaaaaaaaaaaaaaaaaaaaaaaaaaaaaaaaaaaaaaaaaaaaaaaaaaaaaaaaaaaaaaaaaaaaaaaaaaaaaaaaaaaaaaaaaa
aaaaaaaaaaaaaaaaaaaaaaaaaaaaaaaaaaaaaaaaaaaaaaaaaaaaaaaaaaaaaaaaaaaaaaaaaaaaaaaaaaaaaaaaaaaaaaaaaaaaaaaaaaaaaaaaaaaaaaaa
aaaaaaaaaaaaaaaaaaaaaaaaaaaaaaaaaaaaaaaaaaaaaaaaaaaaaaaaaaaaaaaaaaaaaaaaaaaaaaaaaaaaaaaaaaaaaaaaaaaaaaaaaaaaaaaaaaaaaaaa
aaaaaaaaaaaaaaaaaaaaaaaaaaaaaaaaaaaaaaaaaaaaaaaaaaaaaaaaaaaaaaaaaaaaaaaaaaaaaaaaaaaaaaaaaaaaaaaaaaaaaaaaaaaaaaaaaaaaaaaa
aaaaaaaaaaaaaaaaaaaaaaaaaaaaaaaaaaaaaaaaaaaaaaaaaaaaaaaaaaaaaaaaaaaaaaaaaaaaaaaaaaaaaaaaaaaaaaaaaaaaaaaaaaaaaaaaaaaaaaaa
aaaaaaaaaaaaaaaaaaaaaaaaaaaaaaaaaaaaaaaaaaaaaaaaaaaaaaaaaaaaaaaaaaaaaaaaaaaaaaaaaaaaaaaaaaaaaaaaaaaaaaaaaaaaaaaaaaaaaaaa
aaaaaaaaaaaaaaaaaaaaaaaaaaaaaaaaaaaaaaaaaaaaaaaaaaaaaaaaaaaaaaaaaaaaaaaaaaaaaaaaaaaaaaaaaaaaaaaaaaaaaaaaaaaaaaaaaaaaaaaa
"}
