"a" = (/turf/space,/area/ship_battle/asteroid/s_two/one)
"b" = (/turf/space,/area/ship_battle/asteroid/s_two/two)
"c" = (/turf/unsimulated/mask,/area/ship_battle/asteroid/s_two/two)
"d" = (/turf/simulated/floor/asteroid,/area/ship_battle/asteroid/s_two/one)
"e" = (/turf/unsimulated/mask,/area/ship_battle/asteroid/s_two/one)
"f" = (/turf/simulated/floor/asteroid,/area/ship_battle/asteroid/s_two/two)
"g" = (/turf/space,/area/ship_battle/asteroid/s_two/three)
"h" = (/turf/unsimulated/mask,/area/ship_battle/asteroid/s_two/three)
"i" = (/turf/space,/area/ship_battle/asteroid/s_two/four)
"j" = (/turf/simulated/floor/asteroid,/area/ship_battle/asteroid/s_two/four)
"k" = (/turf/unsimulated/mask,/area/ship_battle/asteroid/s_two/four)
"l" = (/turf/simulated/floor/asteroid,/area/ship_battle/asteroid/s_two/three)
"m" = (/turf/simulated/floor/asteroid,/area/shuttle/mining_shuttle/destination)
"n" = (/turf/space,/area/shuttle/mining_shuttle/destination)
"o" = (/obj/effect/mapinfo/asteroid{dimensions_x = 50; dimensions_y = 50; landing_area = /area/shuttle/mining_shuttle/destination; name = "Small Asteroid"; overmap_state = "asteroid_small"},/turf/space,/area/ship_battle/asteroid/s_two/three)

(1,1,1) = {"
aaaaaaaaaaaaaaaaaaaaaaaaaaaaaaaaabbbbbbbbbbbbbbbbbbbbbbbbbbb
aaaaaaaaaaaaaaaaaaaaaaaaaaaaaaaaabbbbbbbbbbbbbbbbbbbbbbbbbbb
aaaaaaaaaaaaaaaaaaaaaaaaaaaaaaaaabbbbbbbbbbbbbbbbbbbbbbbbbbb
aaaaaaaaaaaaaaaaaaaaaaaaaaaaaaaaabbbbbbbbbbbbbbbbbbbbbbbbbbb
aaaaaaaaaaaaaaaaaaaaaaaaaaaaaaaaabbbbbbbbbbbbbbbbbbbbbbbbbbb
aaaaaaaaaaaaaaaaaaaaaaaaaaaaaaaaabbbbbbbbbbbbbbbbbbbbbbbbbbb
aaaaaaaaaaaaaaaaaaaaaaaaaaaaaaaaabbbbbbbbbbbbbbbbbbbbbbbbbbb
aaaaaaaaaaaaaaaaaaaaaaaaaaaaaaaaabbbbbbbbbbbbbbbbbbbbbbbbbbb
aaaaaaaaaaaaaaaaaaaaaaaaaaaaaaaaabbbbbbbbbbbbbbbbbbbbbbbbbbb
aaaaaaaaaaaaaaaaaaaaaaaaaaaaaaaaabbbbbbbbbbbbbbbbbbbbbbbbbbb
aaaaaaaaaaaaaaaaaaaaaaaaaaaaaaaaabbbbbbbbbbbbbbbbbbbbbbbbbbb
aaaaaaaaaaaaaaaaaaaaaaaaaaaaaaaaabbbbbbbbbbbbbbbbbbbbbbbbbbb
aaaaaaaaaaaaaaaaaaaaaaaaaaaaaaaaabbbbbbbbbbbbbbbbbbbbbbbbbbb
aaaaaaaaaaaaaaaaaaaaaaaaaaaaaaaaabbbbbbbbbbbbbbbbbbbbbbbbbbb
aaaaaaaaaaaaaaaaaaaaaaaaaaaaaaaaabbbbbbbbbbbbbbbbbbbbbbbbbbb
aaaaaaaaaaaaaaaaaaaaaaaaaaaaaaaaabbbbbbbbbbbbbbbbbbbbbbbbbbb
aaaaaaaaaaaaaaaaaaaaaaaaaaaaaaaaabbbbbbbbbbbbbbbbbbbbbbbbbbb
aaaaaaaaaaaaaaaaaaaaaaaaaaaaaaaaabbbcbccbbbbbbbbbbbbbbbbbbbb
aaaaaaaaaaaaaaaaaaaaaaaaaaaaaaaaabccccccccccbbbbbbbbbbbbbbbb
aaaaaaaaaaaaaaaaaaaadeeaaaaaaaaaabbccccccccccbbbbbbbbbbbbbbb
aaaaaaaaaaaaaaaaaaaaeeeeaaaaaaaaabccccccccccccbbbbbbbbbbbbbb
aaaaaaaaaaaaaaaaaaaeeeeeeaaaaaaaabccccccccccccbbbbbbbbbbbbbb
aaaaaaaaaaaaaaaaaaeeeeeeeeaaaaaaabcccccccccccbbbbbbbbbbbbbbb
aaaaaaaaaaaaaaaaaeeeeeeeeeeaaaaaaccccccccccccbbbbbbbbbbbbbbb
aaaaaaaaaaaaaaaaeeeeeeeeeeeeaaaaaccccccccccccbbbbbbbbbbbbbbb
aaaaaaaaaaaaaaaeeeeeeeeeeeeeeaaaabcccccffcccbbbbbbbbbbbbbbbb
aaaaaaaaaaaaaaeeeeeeeeeeeeeeeeaaabbccfffbbfbbbbbbbbbbbbbbbbb
aaaaaaaaaaaaaeeeeeeeeeeeeeeeeeeaabbbbbbbbbbbbbbbbbbbbbbbbbbb
aaaaaaaaaaaaaaeeeeeeeeeeeeeeeeaaabbbbbbbbbbbbbbbbbbbbbbbbbbb
ggggggggggggggghhhhhhhhhhhhhhgggiiiiiiiiiiiijjiiiiiiiiiiiiii
gggggggggggggggghhhhhhhhhhhhggggiiiiiiiiiiikkjiiiiiiiiiiiiii
ggggggggggggggggghhhhhhhhhhgggggiiiiiiiiiiijkkiiiiiiiiiiiiii
gggggggggggggggggghhhhhhhhgghgghiiiiiiiiiiikkkiiiiiiiiiiiiii
ggggggggggggggggllllhhhhhllghhhhikkiiiiiiiiiiiiiiiiiiiiiiiii
gggggggggggggggglllllhhhlllghhhhkkkkiiiiiiiiiiiiiiiiiiiiiiii
gggggggggggggggglllllhlllllhhhhhkkkkkiiiiiiiiiiiiiiiiiiiiiii
ggggggggggggggmmmmmmmmmmmmhhhhhhkkkkkiiiiiiiiiiiiiiiiiiiiiii
ggggggggggggggnnmmmmmmmmmmlhhhhhkkkkkkiiiiiiiiiiiiiiiiiiiiii
gggggggggghgggnnmmmmmmmmmmllhhhhkkkkkkkiiiiiiiiiiiiiiiiiiiii
ggggggggghhgggnnnnnmmmmmmmllhhhhkkkkkkiiiiiiiiiiiiiiiiiiiiii
ggggggggghhhggnnnnnmmmmmmmhhhhhhkkkkkkiiiiiiiiiiiiiiiiiiiiii
gggggggghhhhggnnnnmmmmmmmmlhhhhhkkkkkkiiiiiiiiiiiiiiiiiiiiii
gggggggghhhhggnnnnnmmmmmmmllhhhhkkkkiiiiiiiiiiiiiiiiiiiiiiii
ggggggghhhhhggnnnnnnnnmnmmlllllgkkkiiiiiiiiiiiiiiiiiiiiiiiii
ggggggghhhhhhgnnnnnnnnnnmmlllgggiiiiiiiiiiiiiiiiiiiiiiiiiiii
ggggghhhhhhhhgnnnnnnnnnnnngglgggiiiiiiiiiiiiiiiiiiiiiiiiiiii
gggggggghhhhhgnnnnnnnnnnnnggggggiiiiiiiiiiiiiiiiiiiiiiiiiiii
ggggggghhhhhhgnnnnnnnnnnnnggggggiiiiiiiiiiiiiiiiiiiiiiiiiiii
ggggggghhgghhhhgggggggggggggggggiiiiiiiiiiiiiiiiiiiiiiiiiiii
ggggggggggghghggggggggggggggggggiiiiiiiiiiiiiiiiiiiiiiiiiiii
ggggggggggggggggggggggggggggggggiiiiiiiiiiiiiiiiiiiiiiiiiiii
ggggggggggggggggggggggggggggggggiiiiiiiiiiiiiiiiiiiiiiiiiiii
ggggggggggggggggggggggggggggggggiiiiiiiiiiiiiiiiiiiiiiiiiiii
ggggggggggggggggggggggggggggggggiiiiiiiiiiiiiiiiiiiiiiiiiiii
ggggggggggggggggggggggggggggggggiiiiiiiiiiiiiiiiiiiiiiiiiiii
ggggggggggggggggggggggggggggggggiiiiiiiiiiiiiiiiiiiiiiiiiiii
ggggggggggggggggggggggggggggggggiiiiiiiiiiiiiiiiiiiiiiiiiiii
ggggggggggggggggggggggggggggggggiiiiiiiiiiiiiiiiiiiiiiiiiiii
ggggggggggggggggggggggggggggggggiiiiiiiiiiiiiiiiiiiiiiiiiiii
ogggggggggggggggggggggggggggggggiiiiiiiiiiiiiiiiiiiiiiiiiiii
"}
