"a" = (/turf/space,/area/ship_battle/asteroid/s_one/one)
"b" = (/turf/space,/area/ship_battle/asteroid/s_one/two)
"c" = (/turf/unsimulated/mask,/area/ship_battle/asteroid/s_one/one)
"d" = (/turf/simulated/floor/asteroid,/area/ship_battle/asteroid/s_one/one)
"e" = (/turf/space,/area/shuttle/mining_shuttle/destination)
"f" = (/turf/simulated/floor/asteroid,/area/ship_battle/asteroid/s_one/two)
"g" = (/turf/simulated/floor/asteroid,/area/shuttle/mining_shuttle/destination)
"h" = (/turf/unsimulated/mask,/area/ship_battle/asteroid/s_one/two)
"i" = (/turf/space,/area/ship_battle/asteroid/s_one/three)
"j" = (/turf/unsimulated/mask,/area/ship_battle/asteroid/s_one/three)
"k" = (/turf/unsimulated/mask,/area/ship_battle/asteroid/s_one/four)
"l" = (/turf/simulated/floor/asteroid,/area/ship_battle/asteroid/s_one/four)
"m" = (/turf/space,/area/ship_battle/asteroid/s_one/four)
"n" = (/turf/simulated/floor/asteroid,/area/ship_battle/asteroid/s_one/three)
"o" = (/obj/effect/mapinfo/asteroid{dimensions_x = 50; dimensions_y = 50; landing_area = /area/shuttle/mining_shuttle/destination; name = "Small Asteroid"; overmap_state = "asteroid_small"},/turf/space,/area/ship_battle/asteroid/s_one/three)

(1,1,1) = {"
aaaaaaaaaaaaaaaaaaaaaaaaaaaabbbbbbbbbbbbbbbbbbbbbb
aaaaaaaaaaaaaaaaaaaaaaaaaaaabbbbbbbbbbbbbbbbbbbbbb
aaaaaaaaaaaaaaaaaaaaaaaaaaaabbbbbbbbbbbbbbbbbbbbbb
aaaaaaaaaaaaaaaaaaaaaaaaaaaabbbbbbbbbbbbbbbbbbbbbb
aaaaaaaaaaaaaaaaaaaaaaaaaaaabbbbbbbbbbbbbbbbbbbbbb
aaaaaaaaaaaaaaaaaaaaaaaaaaaabbbbbbbbbbbbbbbbbbbbbb
aaaaaaaaaaaaaaaaaaaaaaaaaaaabbbbbbbbbbbbbbbbbbbbbb
aaaaaaaaaaaaaaaaaaaaaaaaaaaabbbbbbbbbbbbbbbbbbbbbb
aaaaaaaaaaaaaaaaaaaaaaaaaaaabbbbbbbbbbbbbbbbbbbbbb
aaaaaaaaaaaaaaaaaaaaaaaaaaaabbbbbbbbbbbbbbbbbbbbbb
aaaaaaaaaaaaaaaaaaaaaaaaaaaabbbbbbbbbbbbbbbbbbbbbb
aaaaaaaaaaaaaaacaaaaaaaaaaaabbbbbbbbbbbbbbbbbbbbbb
aaaaaaaaaaaaaaaaaaaaacaaaaaabbbbbbbbbbbbbbbbbbbbbb
aaaaaaaaaaaaaaaaaaaaaccaaaaabbbbbbbbbbbbbbbbbbbbbb
aaaaaaaaaaaaaaaaaaaaaacaaaaabbbbbbbbbbbbbbbbbbbbbb
aaaaaaaaaaaaaaacaaaaaaaaaaaabbbbbbbbbbbbbbbbbbbbbb
aaaaaaaaaaaaacdccaaaaaaaadaabbbbbbbbbbbbbbbbbbbbbb
aaaaaaaaaaacccccccdddcccadddbbbeeeeeeeeeeeebbbbbbb
aaaaaaaaaaccccccccddccccaccdffbeeeeeeeeeeeebbbbbbb
aaaaaaaaaccccccccccdccccccccfffeeeeeeeeeeeebbbbbbb
aaaaaaaddccccccccccccccccccdfffgeeeeeeeeeeebbbbbbb
aaaaaaadddccccccccccccccccccfffgeeeeeeeeeeebbbbbbb
aaaaaaaaddcccccccccccccccccchffeeeeeeeeeeeebbbbbbb
aaaaaaaaddcccccccccccccccccdfffggggeeeeeeeebbbbbbb
aaaaaaaccccccccccccccccccccddddggggeeeeeeeebbbbbbb
aaaaaaaaacccccccccccccccccccdcdggggeeeeeeeebbbbbbb
aaaaaaaaccccccccccccccccccccdcdggggeeeeeeeebbbbbbb
aaaaaaaadcccccccccccccccccccccdggggeeeeeeeebbbbbbb
aaaaaaaaadccccccccccccccccccccdggggeeeeeeeebbbbbbb
iiiiiiiiijjjjjjjjjjjjjjjjjjjkklllkkmmmmmmmmmmmmmmm
iiiiiiiiijijjjjjjjjjjjjjjjjjmmlllkkkmmmmmmmmmmmmmm
iiiiiiiiiiijjjjjjjjjjjjjjjjjmmmmkkkkkmmmmmmmmmmmmm
iiiiiiiiiiiijjjjjnjjjjjjjjjimmmmkmkmmmmmmmmmmmmmmm
iiiiiiiiiiiiijjjnnnnjjjjjjiimmmmmmmmmmmmmmmmmmmmmm
iiiiiiiiiiiiiijnnnnnjjjjjiiimmmmmmmmmmmmmmmmmmmmmm
iiiiiiiiiiiiiiijnnnnjjjiiiiimmmmmmmmmmmmmmmmmmmmmm
iiiiiiiiiiiiiiiiiiinjjiiiiiimmmmmmmmmmmmmmmmmmmmmm
iiiiiiiiiiiijjiiiiiiiiiiiiiimmmmmmmmmmmmmmmmmmmmmm
iiiiiiiiiiiijiiiiiiiiiiiiiiimmmmmmmmmmmmmmmmmmmmmm
iiiiiiiiiiiiiiiiiiiiiiiiiiiimmmmmmmmmmmmmmmmmmmmmm
iiiiiiiiiiiiiiiiiiiiiiiiiiiimmmmmmmmmmmmmmmmmmmmmm
iiiiiiiiiiiiiiiiiiiiiiiiiiiimmmmmmmmmmmmmmmmmmmmmm
iiiiiiiiiiiiiiiiiiiiiiiiiiiimmmmmmmmmmmmmmmmmmmmmm
iiiiiiiiiiiiiiiiiiiiiiiiiiiimmmmmmmmmmmmmmmmmmmmmm
iiiiiiiiiiiiiiiiiiiiiiiiiiiimmmmmmmmmmmmmmmmmmmmmm
iiiiiiiiiiiiiiiiiiiiiiiiiiiimmmmmmmmmmmmmmmmmmmmmm
iiiiiiiiiiiiiiiiiiiiiiiiiiiimmmmmmmmmmmmmmmmmmmmmm
iiiiiiiiiiiiiiiiiiiiiiiiiiiimmmmmmmmmmmmmmmmmmmmmm
iiiiiiiiiiiiiiiiiiiiiiiiiiiimmmmmmmmmmmmmmmmmmmmmm
oiiiiiiiiiiiiiiiiiiiiiiiiiiimmmmmmmmmmmmmmmmmmmmmm
"}
