"a" = (/turf/space,/area/ship_battle/asteroid/m_two/one)
"b" = (/turf/space,/area/ship_battle/asteroid/m_two/two)
"c" = (/turf/space,/area/sector/shuttle/asteroid)
"d" = (/turf/unsimulated/mask,/area/ship_battle/asteroid/m_two/one)
"e" = (/turf/simulated/floor/asteroid,/area/ship_battle/asteroid/m_two/one)
"f" = (/turf/simulated/floor/asteroid,/area/ship_battle/asteroid/m_two/two)
"g" = (/turf/simulated/floor/asteroid,/area/sector/shuttle/asteroid)
"h" = (/turf/unsimulated/mask,/area/ship_battle/asteroid/m_two/two)
"i" = (/turf/space,/area/ship_battle/asteroid/m_two/three)
"j" = (/turf/unsimulated/mask,/area/ship_battle/asteroid/m_two/three)
"k" = (/turf/simulated/floor/asteroid,/area/ship_battle/asteroid/m_two/three)
"l" = (/turf/space,/area/ship_battle/asteroid/m_two/four)
"m" = (/turf/simulated/floor/asteroid,/area/ship_battle/asteroid/m_two/four)
"n" = (/turf/unsimulated/mask,/area/ship_battle/asteroid/m_two/four)
"o" = (/obj/effect/overmap/station/asteroid{dimensions_x = 80; dimensions_y = 80; icon_state = "asteroid_medium"; name = "Broken Asteroid"},/turf/space,/area/ship_battle/asteroid/m_one/three)

(1,1,1) = {"
aaaaaaaaaaaaaaaaaaaaaaaaaaaaaaaaaaaaaaaaaaaaaaaaaaaaaaaabbbbbbbbbbbbbbbbbbbbbbbbbbbbbbbbbbbbbbbbbbbb
aaaaaaaaaaaaaaaaaaaaaaaaaaaaaaaaaaaaaaaaaaaaaaaaaaaaaaaabbbbbbbbbbbbbbbbbbbbbbbbbbbbbbbbbbbbbbbbbbbb
aaaaaaaaaaaaaaaaaaaaaaaaaaaaaaaaaaaaaaaaaaaaaaaaaaaaaaaabbbbbbbbbbbbbbbbbbbbbbbbbbbbbbbbbbbbbbbbbbbb
aaaaaaaaaaaaaaaaaaaaaaaaaaaaaaaaaaaaaaaaaaaaaaaaaaaaaaaabbbbbbbbbbbbbbbbbbbbbbbbbbbbbbbbbbbbbbbbbbbb
aaaaaaaaaaaaaaaaaaaaaaaaaaaaaaaaaaaaaaaaaaaaaaaaaaaaaaaabbbbbbbbbbbbbbbbbbbbbbbbbbbbbbbbbbbbbbbbbbbb
aaaaaaaaaaaaaaaaaaaaaaaaaaaaaaaaaaaaaaaaaaaaaaaaaaaaaaaabbbbbbbbbbbbbbbbbbbbbbbbbbbbbbbbbbbbbbbbbbbb
aaaaaaaaaaaaaaaaaaaaaaaaaaaaaaaaaaaaaaaaaaaaaaaaaaaaaaaabbbbbbbbbbbbbbbbbbbbbbbbbbbbbbbbbbbbbbbbbbbb
aaaaaaaaaaaaaaaaaaaaaaaaaaaaaaaaaaaaaaaaaaaaaaaaaaaaaaaabbbbbbbbbbbbbbbbbbbbbbbbbbbbbbbbbbbbbbbbbbbb
aaaaaaaaaaaaaaaaaaaaaaaaaaaaaaaaaaaaaaaaaaaaaaaaaaaaaaaabbbbbbbbbbbbbbbbbbbbbbbbbbbbbbbbbbbbbbbbbbbb
aaaaaaaaaaaaaaaaaaaaaaaaaaaaaaaaaaaaaaaaaaaaaaaaaaaaaaaabbbbbbbbbbbbbbbbbbbbbbbbbbbbbbbbbbbbbbbbbbbb
aaaaaaaaaaaaaaaaaaaaaaaaaaaaaaaaaaaaaaaaaaaaaaaaaaaaaaaabbbbbbbbbbbbbbbbbbbbbbbbbbbbbbbbbbbbbbbbbbbb
aaaaaaaaaaaaaaaaaaaaaaaaaaaaaaaaaaaaaaaaaaaaaaaaaaaaaaaabbbbbbbbbbbbbbbbbbbbbbbbbbbbbbbbbbbbbbbbbbbb
aaaaaaaaaaaaaaaaaaaaaaaaaaaaaaaaaaaaaaaaaaaaaaaaaaaaaaaabbbbbbbbbbbbbbbbbbbbbbbbbbbbbbbbbbbbbbbbbbbb
aaaaaaaaaaaaaaaaaaaaaaaaaaaaaaaaaaaaaaaaaaaaaaaaaaaaaaaabbbbbbbbbbbbbbbbbbbbbbbbbbbbbbbbbbbbbbbbbbbb
aaaaaaaaaaaaaaaaaaaaaaaaaaaaaaaaaaaaaaaaaaaaaaaaaaaaaaaabbbbbbbbbbbbbbbbbbbbbbbbbbbbbbbbbbbbbbbbbbbb
aaaaaaaaaaaaaaaaaaaaaaaaaaaaaaaaaaaaaaaaaaaaaaaaaaaaaaaabbbbbbbbbbbbbbbbbbbbbbbbbbbbbbbbbbbbbbbbbbbb
aaaaaaaaaaaaaaaaaaaaaaaaaaaaaaaaaaaaaaaaaaaaaaaaaaaaaaaabbbbbbbbbbbbbbbbbbbbbbbbbbbbbbbbbbbbbbbbbbbb
aaaaaaaaaaaaaaaaaaaaaaaaaaaaaaaaaaaaaaaaaaaaaaaaaaaaaaaabbbbbbbbbbbbbbbbbbbbbbbbbbbbbbbbbbbbbbbbbbbb
aaaaaaaaaaaaaaaaaaaaaaaaaaaaaaaaaaaaaaaaaaaaaaaaaaaaaaaabbbbbbbbbbbbbbbbbbbbbbbbbbbbbbbbbbbbbbbbbbbb
aaaaaaaaaaaaaaaaaaaaaaaaaaaaaaaaaaaaaaaaaaaaaaaaaaaaaaaabbbbbbbbbbbbbbbbbbbbbbbbbbbbbbbbbbbbbbbbbbbb
aaaaaaaaaaaaaaaaaaaaaaaaaaaaaaaaaaaaaaaaaaaaaaaaaaaaaaaabbbbbbbbbbbbbbbbbbbbbbbbbbbbbbbbbbbbbbbbbbbb
aaaaaaaaaaaaaaaaaaaaaaaaaaaaaaaaaaaaaaaaaaaaaaaaaaaaaaaabbbbbbbccccccccccccbbbbbbbbbbbbbbbbbbbbbbbbb
aaaaaaaaaaaaaaaaaaaaaaaaaaaaaaaaaaaaaaaaaaadddaaddaaaaaabbbbbbbccccccccccccbbbbbbbbbbbbbbbbbbbbbbbbb
aaaaaaaaaaaaaaaaaaaaaaaaaaaaaaaaaaaaaaaadeedddddddddaaaabbbbbbbccccccccccccbbbbbbbbbbbbbbbbbbbbbbbbb
aaaaaaaaaaaaaaaaaaaaaaaaaaaaaaaaaaaadddedeeeedddddddaaaabbbbbbbccccccccccccbbbbbbbbbbbbbbbbbbbbbbbbb
aaaaaaaaaaaaaaaaaaaaaaaaaaaaaaaaaaaadddedeedddddddddddaabbbbbbbccccccccccccbbbbbbbbbbbbbbbbbbbbbbbbb
aaaaaaaaaaaaaaaaaaaaaaaaaaaaaaaaaaaadddeedddddddddddddaabbbbbbbccccccccccccbbbbbbbbbbbbbbbbbbbbbbbbb
aaaaaaaaaaaaaaaaaaaaaaaaaaaaadddddddddddddddddddddddaaaabbbbbffggggggccccccbbbbbbbbbbbbbbbbbbbbbbbbb
aaaaaaaaaaaaaaaaaaaaaaaaaaaaadddddddddddddddddddddddaddebbbbbffggggggccgcccbbbbbbbbbbbbbbbbbbbbbbbbb
aaaaaaaaaaaaaaaaaaaaaaaaaaaaaddddddddddddddddddddddddddebbbbbbfgggggggggggcbbbbbbbbbbbbbbbbbbbbbbbbb
aaaaaaaaaaaaaaaaaaaaaaaaaaaaaddddddddddddddddddddddddddebbbbbffggggggggggggbbbbbbbbbbbbbbbbbbbbbbbbb
aaaaaaaaaaaaaaaaaaaaaaaaaaaaaddddddddddddddddddddddddddebbbbbffggggggggggggfbbbbbbbbbbbbbbbbbbbbbbbb
aaaaaaaaaaaaaaaaaaaaaaaaaadddddddddddddddddddddddddddeeebbbbbffggggggggggggfbbbbbbbbbbbbbbbbbbbbbbbb
aaaaaaaaaaaaaaaaaaaaaaaaaadddddddddddddddddddddddddddeaabbbffffffhfffffffffffbbbbbbbbbbbbbbbbbbbbbbb
aaaaaaaaaaaaaaaaaaaaaaaaaadddddddddddddddddddddddddddeaabbbfffhfhhffffffffffbbbbbbbbbbbbbbbbbbbbbbbb
aaaaaaaaaaaaaaaaaaaaaaaaaaddddddddddddddddddddddddddeeaabfffhhhhhhffhhhhhffffbbbbbbbbbbbbbbbbbbbbbbb
aaaaaaaaaaaaaaaaaaaaaaaaadddddddddddddddddddddddddddeaaabfhhhhhhhhhhhhhhhhfffbbbbbbbbbbbbbbbbbbbbbbb
aaaaaaaaaaaaaaaaaaaaaaaaaaddddddddddddddddddddddddddeaaaffhhhhhhhhhhhhhhhhffffbbbbbbbbbbbbbbbbbbbbbb
aaaaaaaaaaaaaaaaaaaaaaaaaaddddddddddddddddddddddddddeaaaffhhhhhhhhhhhhhhhhfffffbbbbbbbbbbbbbbbbbbbbb
aaaaaaaaaaaaaaaaaaaaaaaaaaddddddddddddddddddddddddddeaaaffhhhhhhhhhhhhhhhhhffffbbbbbbbbbbbbbbbbbbbbb
aaaaaaaaaaaaaaaaaaaaaaaaddddddddddddddddddddddddddddeaaabfhhhhhhhhhhhhhhhhhhhbbbbbbbbbbbbbbbbbbbbbbb
aaaaaaaaaaaaaaaaaaaaaaaaddddddddddddddddddddddddddddeeeabfhhhhhhhhhhhhhhhhhhhbbbbbbbbbbbbbbbbbbbbbbb
aaaaaaaaaaaaaaaaaaaaaaaaddddddddddddddddddddddddddddeeaabfhhhhhhhhhhhhhhhhhhhbbbbbbbbbbbbbbbbbbbbbbb
aaaaaaaaaaaaaaaaaaaaaaadddddddddddddddddddddddddddddeeaabfhhhhhhhhhhhhhhhhhhbbbbbbbbbbbbbbbbbbbbbbbb
aaaaaaaaaaaaaaaaaaaaaaaddddddddddddddddddddddddddddeedaaffhhhhhhhhhhhhhhhhhhbbbbbbbbbbbbbbbbbbbbbbbb
aaaaaaaaaaaaaaaaaaaaaaaddddddddddddddddddddddddddddeeaaafhhhhhhhhhhhhhhhhhhhhbbbbbbbbbbbbbbbbbbbbbbb
iiiiiiiiiiiiiiiiiiiiiiijjkjjjjjjjjjjjjjjjjjjjjjjjjjkilllmnnnnnnnnnnnnnnnnlnnnlllllllllllllllllllllll
iiiiiiiiiiiiiiiiiiiiiikkkkjjjjjjjjjjjjjjjjjjjjjjjkkkilmmmnnnnnnnnnnnnnnnnlnnnlllllllllllllllllllllll
iiiiiiiiiiiiiiiiiiiiiikkkjjjjjjjjjjjjjjjjjjjjjjjjkkiilmnnnnnnnnnnnnnnnnnnnllllllllllllllllllllllllll
iiiiiiiiiiiiiiiiiiiiikkkkjjjjjjjjjjjjjjjjjjjjjjjjkjiimmnnnnnnnnnnnnnnnnnnnllllllllllllllllllllllllll
iiiiiiiiiiiiiiiiiiiiikkkkjjjjjjjjjjjjjjjjjjjjjjjkiiiimnnnnnnnnnnnnnnnnnnnnnlllllllllllllllllllllllll
iiiiiiiiiiiiiiiiiiiiiijjkjjjjjjjjjjjjjjjjjjjjjkkkiikkmnnnnnnnnnnnnnnnnnnnnllllllllllllllllllllllllll
iiiiiiiiiiiiiiiiiiiiijjjjjjjjjjjjjjjjjjjjjjjjjkkkiikkmnnnnnnnnnnnnnnnnnnnlllllllllllllllllllllllllll
iiiiiiiiiiiiiiiiiiiiijjjjjjjjjjjjjjjjjjjjjjjjjkkkiiiimnnnnnnnnnnlnnnnnnnnlllllllllllllllllllllllllll
iiiiiiiiiiiiiiiiiiiiijjjjjjjjjjjjjjjjjjjjjjjjjjjkkiiimnnnnnnnnnnllllllllllllllllllllllllllllllllllll
iiiiiiiiiiiiiiiiiiiiijjjjjjjjjjjjjjjjjjjjjjjjjjjjkiiimnnnnnnnnnnnnnnllllllllllllllllllllllllllllllll
iiiiiiiiiiiiiiiiiiiiiiijjjjjjjjjjjjjjjjjjjjjjjjjjkiiimnnnnnnnnnnnnnnllllllllllllllllllllllllllllllll
iiiiiiiiiiiiiiiiiiiiijjjjjjjjjjjjjjjjjjjjjjjjjjjjkiiimnnnnnnnnnnnnnnnnllllllllllllllllllllllllllllll
iiiiiiiiiiiiiiiiiiiiijjjjjjjjjjjjjjjjjjjjjjjjjjjjiiikmnnnnnnnnnnnnnnnnnnnlllllllllllllllllllllllllll
iiiiiiiiiiiiiiiiiiiiiiiiiijjjjjjjjjjjjjjjjjjjjjjkiiiknnnnnnnnnnnnnnnnnnlllllllllllllllllllllllllllll
iiiiiiiiiiiiiiiiiiiiiiiiijjjjjjjjjjjjjjjjjjjjjjjkiiiknnnnnnnnnnnnnnnnnnnnnllllllllllllllllllllllllll
iiiiiiiiiiiiiiiiiiiiiiiijjjjjjjjjjjjjjjjjjjjjjjjiikkknnnnnnnnnnnnnnnnnnnnnllllllllllllllllllllllllll
iiiiiiiiiiiiiiiiiiiiiiiijjjjjjjjjjjjjjjjjjjjjjjjiiikknnnnnnnnnnnnnnnnlllllllllllllllllllllllllllllll
iiiiiiiiiiiiiiiiiiiiiiiijjjjjjjjjjjjjjjjjjjjjjjjkiikjnnnnnnnnnnnnnnnnlllllllllllllllllllllllllllllll
iiiiiiiiiiiiiiiiiiiiiiiijjijjjjjjkjjjjjjkjjkjjjjkikkjnnnnnnnnnnnnnnnllllllllllllllllllllllllllllllll
iiiiiiiiiiiiiiiiiiiiiiiiiiijjjjjjjjjjkkkjjjkjjjiiikjjnnnnnnnnnnnnnnnllllllllllllllllllllllllllllllll
iiiiiiiiiiiiiiiiiiiiiiiiiijjjjjjjjjjjjjjjjjkkjjiikkjjnnnnnnnnnnnnnnnllllllllllllllllllllllllllllllll
iiiiiiiiiiiiiiiiiiiiiiiiiijjjjjjjkkjkkkkkikjkjjiijjjjnnnnnnnnnnnnlllllllllllllllllllllllllllllllllll
iiiiiiiiiiiiiiiiiiiiiiiiiijjjjjjjkkkjjkkkkijkjjiijiijnnnnnnnnnnnllllllllllllllllllllllllllllllllllll
iiiiiiiiiiiiiiiiiiiiiiiiiiijjjjjjkkkkkkkkkiiiiiiiiiiillnnnnnnnnlllllllllllllllllllllllllllllllllllll
iiiiiiiiiiiiiiiiiiiiiiiiiiiiiiijjkkkkkiiiiiiiiiiiijjjnnnnnnnnnnlllllllllllllllllllllllllllllllllllll
iiiiiiiiiiiiiiiiiiiiiiiiiiiiiiiiiiiiiiiiiiiiiiiiiijjjnnnnnnnnlllllllllllllllllllllllllllllllllllllll
iiiiiiiiiiiiiiiiiiiiiiiiiiiiiiiiiiiiiiiiiiiiiiiiiijjjnnnnnnnnlllllllllllllllllllllllllllllllllllllll
iiiiiiiiiiiiiiiiiiiiiiiiiiiiiiiiiiiiiiiiiiiiiiiiijjjjnnnnnnnnlllllllllllllllllllllllllllllllllllllll
iiiiiiiiiiiiiiiiiiiiiiiiiiiiiiiiiiiiiiiiiiiiiiiiiiijjnnnllllllllllllllllllllllllllllllllllllllllllll
iiiiiiiiiiiiiiiiiiiiiiiiiiiiiiiiiiiiiiiiiiiiiiiiiiiiilllllllllllllllllllllllllllllllllllllllllllllll
iiiiiiiiiiiiiiiiiiiiiiiiiiiiiiiiiiiiiiiiiiiiiiiiiiiiilllllllllllllllllllllllllllllllllllllllllllllll
iiiiiiiiiiiiiiiiiiiiiiiiiiiiiiiiiiiiiiiiiiiiiiiiiiiiilllllllllllllllllllllllllllllllllllllllllllllll
iiiiiiiiiiiiiiiiiiiiiiiiiiiiiiiiiiiiiiiiiiiiiiiiiiiiilllllllllllllllllllllllllllllllllllllllllllllll
iiiiiiiiiiiiiiiiiiiiiiiiiiiiiiiiiiiiiiiiiiiiiiiiiiiiilllllllllllllllllllllllllllllllllllllllllllllll
iiiiiiiiiiiiiiiiiiiiiiiiiiiiiiiiiiiiiiiiiiiiiiiiiiiiilllllllllllllllllllllllllllllllllllllllllllllll
iiiiiiiiiiiiiiiiiiiiiiiiiiiiiiiiiiiiiiiiiiiiiiiiiiiiilllllllllllllllllllllllllllllllllllllllllllllll
iiiiiiiiiiiiiiiiiiiiiiiiiiiiiiiiiiiiiiiiiiiiiiiiiiiiilllllllllllllllllllllllllllllllllllllllllllllll
iiiiiiiiiiiiiiiiiiiiiiiiiiiiiiiiiiiiiiiiiiiiiiiiiiiiilllllllllllllllllllllllllllllllllllllllllllllll
iiiiiiiiiiiiiiiiiiiiiiiiiiiiiiiiiiiiiiiiiiiiiiiiiiiiilllllllllllllllllllllllllllllllllllllllllllllll
iiiiiiiiiiiiiiiiiiiiiiiiiiiiiiiiiiiiiiiiiiiiiiiiiiiiilllllllllllllllllllllllllllllllllllllllllllllll
iiiiiiiiiiiiiiiiiiiiiiiiiiiiiiiiiiiiiiiiiiiiiiiiiiiiilllllllllllllllllllllllllllllllllllllllllllllll
iiiiiiiiiiiiiiiiiiiiiiiiiiiiiiiiiiiiiiiiiiiiiiiiiiiiilllllllllllllllllllllllllllllllllllllllllllllll
iiiiiiiiiiiiiiiiiiiiiiiiiiiiiiiiiiiiiiiiiiiiiiiiiiiiilllllllllllllllllllllllllllllllllllllllllllllll
iiiiiiiiiiiiiiiiiiiiiiiiiiiiiiiiiiiiiiiiiiiiiiiiiiiiilllllllllllllllllllllllllllllllllllllllllllllll
iiiiiiiiiiiiiiiiiiiiiiiiiiiiiiiiiiiiiiiiiiiiiiiiiiiiilllllllllllllllllllllllllllllllllllllllllllllll
iiiiiiiiiiiiiiiiiiiiiiiiiiiiiiiiiiiiiiiiiiiiiiiiiiiiilllllllllllllllllllllllllllllllllllllllllllllll
iiiiiiiiiiiiiiiiiiiiiiiiiiiiiiiiiiiiiiiiiiiiiiiiiiiiilllllllllllllllllllllllllllllllllllllllllllllll
iiiiiiiiiiiiiiiiiiiiiiiiiiiiiiiiiiiiiiiiiiiiiiiiiiiiilllllllllllllllllllllllllllllllllllllllllllllll
iiiiiiiiiiiiiiiiiiiiiiiiiiiiiiiiiiiiiiiiiiiiiiiiiiiiilllllllllllllllllllllllllllllllllllllllllllllll
iiiiiiiiiiiiiiiiiiiiiiiiiiiiiiiiiiiiiiiiiiiiiiiiiiiiilllllllllllllllllllllllllllllllllllllllllllllll
iiiiiiiiiiiiiiiiiiiiiiiiiiiiiiiiiiiiiiiiiiiiiiiiiiiiilllllllllllllllllllllllllllllllllllllllllllllll
iiiiiiiiiiiiiiiiiiiiiiiiiiiiiiiiiiiiiiiiiiiiiiiiiiiiilllllllllllllllllllllllllllllllllllllllllllllll
iiiiiiiiiiiiiiiiiiiiiiiiiiiiiiiiiiiiiiiiiiiiiiiiiiiiilllllllllllllllllllllllllllllllllllllllllllllll
oiiiiiiiiiiiiiiiiiiiiiiiiiiiiiiiiiiiiiiiiiiiiiiiiiiiilllllllllllllllllllllllllllllllllllllllllllllll
"}
