//MAP CONVERTED BY dmm2tgm.py THIS HEADER COMMENT PREVENTS RECONVERSION, DO NOT REMOVE
"aa" = (
/turf/simulated/floor/tiled/dark,
/area/map_template/deepmaint)
"ab" = (
/turf/simulated/wall/r_wall,
/area/map_template/deepmaint)
"ac" = (
/obj/structure/table/woodentable,
/turf/simulated/floor/carpet/red,
/area/map_template/deepmaint)
"ad" = (
/obj/machinery/computer/modular/preset/civilian,
/turf/simulated/floor/carpet/red,
/area/map_template/deepmaint)
"ae" = (
/obj/structure/table/woodentable,
/obj/item/device/flashlight/lamp/green,
/obj/random/energy,
/turf/simulated/floor/carpet/red,
/area/map_template/deepmaint)
"af" = (
/turf/simulated/wall,
/area/map_template/deepmaint)
"ag" = (
/obj/structure/closet/fridge/meat,
/obj/random/mre,
/obj/random/mre,
/obj/random/mre,
/turf/simulated/floor/tiled/white,
/area/map_template/deepmaint)
"ah" = (
/obj/structure/table/standard,
/obj/machinery/microwave{
	pixel_x = -3;
	pixel_y = 6
	},
/turf/simulated/floor/tiled/white,
/area/map_template/deepmaint)
"ai" = (
/obj/random/junk,
/obj/machinery/light,
/turf/simulated/floor/tiled/dark,
/area/map_template/deepmaint)
"aj" = (
/obj/structure/table/standard,
/obj/item/reagent_containers/glass/beaker{
	pixel_x = 5
	},
/obj/item/reagent_containers/glass/beaker{
	pixel_x = 5
	},
/obj/item/material/kitchen/rollingpin,
/turf/simulated/floor/tiled/white,
/area/map_template/deepmaint)
"ak" = (
/obj/random/pack/machine,
/turf/simulated/floor/tiled/techfloor,
/area/map_template/deepmaint)
"al" = (
/obj/structure/table/rack,
/obj/random/pack/tech_loot,
/obj/random/pack/tech_loot,
/obj/random/pack/tech_loot,
/turf/simulated/floor/tiled/techfloor,
/area/map_template/deepmaint)
"am" = (
/obj/random/junk,
/turf/simulated/floor/tiled/dark,
/area/map_template/deepmaint)
"ao" = (
/turf/simulated/floor/tiled/white,
/area/map_template/deepmaint)
"ap" = (
/obj/structure/catwalk,
/turf/simulated/floor/plating,
/area/map_template/deepmaint)
"aq" = (
/obj/structure/table/woodentable,
/obj/random/pack/rare,
/obj/random/pack/rare,
/turf/simulated/floor/carpet/red,
/area/map_template/deepmaint)
"as" = (
/obj/structure/flora/pottedplant{
	icon_state = "plant-21"
	},
/turf/simulated/floor/wood,
/area/map_template/deepmaint)
"at" = (
/obj/machinery/door/airlock,
/turf/simulated/floor/tiled/dark,
/area/map_template/deepmaint)
"au" = (
/obj/structure/bed/chair/comfy/black{
	dir = 1
	},
/turf/simulated/floor/wood,
/area/map_template/deepmaint)
"av" = (
/obj/structure/table/rack,
/obj/random/drinkbottle,
/obj/random/drinkbottle,
/obj/random/drinkbottle,
/obj/random/junk,
/obj/random/junk,
/turf/simulated/floor/tiled/white,
/area/map_template/deepmaint)
"aw" = (
/obj/structure/bookcase,
/turf/simulated/floor/wood,
/area/map_template/deepmaint)
"ax" = (
/obj/structure/table/woodentable,
/obj/machinery/computer/modular/preset/library,
/turf/simulated/floor/wood,
/area/map_template/deepmaint)
"ay" = (
/obj/machinery/door/airlock/glass,
/obj/structure/girder,
/obj/structure/barricade,
/obj/machinery/door/airlock,
/turf/simulated/floor/tiled/dark,
/area/map_template/deepmaint)
"az" = (
/obj/machinery/barrier,
/obj/structure/barricade,
/turf/simulated/floor/tiled/steel_grid,
/area/map_template/deepmaint)
"aA" = (
/obj/structure/girder,
/obj/structure/barricade,
/turf/simulated/floor/tiled/steel_grid,
/area/map_template/deepmaint)
"aB" = (
/obj/structure/girder,
/obj/machinery/door/airlock,
/turf/simulated/floor/tiled/steel_ridged,
/area/map_template/deepmaint)
"aC" = (
/obj/structure/table/standard,
/obj/random/junkfood,
/obj/random/junkfood,
/turf/simulated/floor/tiled/white,
/area/map_template/deepmaint)
"aD" = (
/obj/structure/bed/chair/office/dark,
/turf/simulated/floor/wood,
/area/map_template/deepmaint)
"aE" = (
/obj/structure/girder,
/obj/structure/barricade,
/obj/machinery/door/airlock,
/turf/simulated/floor/tiled/steel_grid,
/area/map_template/deepmaint)
"aF" = (
/turf/simulated/floor/tiled/steel_ridged,
/area/map_template/deepmaint)
"aH" = (
/obj/structure/table/woodentable,
/obj/item/paper_bin,
/turf/simulated/floor/wood,
/area/map_template/deepmaint)
"aI" = (
/obj/structure/girder,
/turf/simulated/floor/wood,
/area/map_template/deepmaint)
"aJ" = (
/obj/machinery/door/airlock/glass,
/turf/simulated/floor/tiled/steel_grid,
/area/map_template/deepmaint)
"aK" = (
/obj/structure/barricade,
/turf/simulated/floor/wood,
/area/map_template/deepmaint)
"aL" = (
/obj/structure/bed/chair/comfy/black{
	dir = 4
	},
/turf/simulated/floor/carpet/red,
/area/map_template/deepmaint)
"aM" = (
/obj/machinery/vending/snack,
/turf/simulated/floor/tiled/steel_ridged,
/area/map_template/deepmaint)
"aN" = (
/obj/structure/flora/pottedplant{
	icon_state = "plant-10"
	},
/turf/simulated/floor/carpet/red,
/area/map_template/deepmaint)
"aO" = (
/obj/structure/table/woodentable,
/obj/random/loot,
/obj/random/loot,
/turf/simulated/floor/carpet/red,
/area/map_template/deepmaint)
"aP" = (
/obj/machinery/door/airlock/glass,
/obj/structure/barricade,
/turf/simulated/floor/tiled/steel_ridged,
/area/map_template/deepmaint)
"aQ" = (
/obj/structure/table/woodentable,
/obj/random/powercell,
/obj/random/powercell,
/obj/random/energy,
/obj/random/energy,
/turf/simulated/floor/carpet/red,
/area/map_template/deepmaint)
"aR" = (
/obj/item/remains/human,
/obj/structure/catwalk,
/turf/simulated/floor/plating,
/area/map_template/deepmaint)
"aS" = (
/obj/machinery/vending/cola,
/turf/simulated/floor/tiled/steel_ridged,
/area/map_template/deepmaint)
"aT" = (
/obj/decal/cleanable/blood,
/turf/simulated/floor/wood,
/area/map_template/deepmaint)
"aU" = (
/obj/machinery/light{
	dir = 8
	},
/turf/simulated/floor/wood,
/area/map_template/deepmaint)
"aV" = (
/obj/structure/table/woodentable,
/obj/item/pen/blue{
	pixel_x = 5;
	pixel_y = 5
	},
/obj/item/pen/red{
	pixel_x = 2;
	pixel_y = 6
	},
/turf/simulated/floor/wood,
/area/map_template/deepmaint)
"aW" = (
/obj/machinery/libraryscanner,
/turf/simulated/floor/wood,
/area/map_template/deepmaint)
"aX" = (
/turf/simulated/floor/wood,
/area/map_template/deepmaint)
"aY" = (
/obj/structure/table/woodentable,
/turf/simulated/floor/wood,
/area/map_template/deepmaint)
"aZ" = (
/obj/structure/bed/chair/office/dark{
	dir = 1
	},
/turf/simulated/floor/wood,
/area/map_template/deepmaint)
"ba" = (
/obj/machinery/light{
	dir = 4;
	icon_state = "tube1"
	},
/turf/simulated/floor/wood,
/area/map_template/deepmaint)
"bb" = (
/obj/machinery/light{
	dir = 8
	},
/turf/simulated/floor/tiled/dark,
/area/map_template/deepmaint)
"bc" = (
/obj/item/remains/human,
/turf/simulated/floor/wood,
/area/map_template/deepmaint)
"bd" = (
/obj/random/junk,
/obj/random/junk,
/turf/simulated/floor/wood,
/area/map_template/deepmaint)
"be" = (
/obj/random/junk,
/turf/simulated/floor/wood,
/area/map_template/deepmaint)
"bf" = (
/obj/random/junk,
/obj/random/junk,
/obj/random/junk,
/turf/simulated/floor/wood,
/area/map_template/deepmaint)
"bg" = (
/turf/simulated/floor/plating,
/area/map_template/deepmaint)
"bh" = (
/obj/structure/reagent_dispensers/water_cooler,
/turf/simulated/floor/plating,
/area/map_template/deepmaint)
"bi" = (
/obj/random/junk,
/turf/simulated/floor/plating,
/area/map_template/deepmaint)
"bj" = (
/obj/structure/table/standard{
	name = "plastic table frame"
	},
/obj/item/storage/firstaid/regular,
/turf/simulated/floor/plating,
/area/map_template/deepmaint)
"bk" = (
/obj/item/stool,
/turf/simulated/floor/plating,
/area/map_template/deepmaint)
"bl" = (
/obj/structure/table/standard{
	name = "plastic table frame"
	},
/obj/random/medical,
/obj/random/medical,
/obj/random/medical,
/turf/simulated/floor/plating,
/area/map_template/deepmaint)
"bm" = (
/obj/machinery/light/small{
	dir = 4;
	pixel_y = 0
	},
/turf/simulated/floor/plating,
/area/map_template/deepmaint)
"bn" = (
/obj/structure/bed/chair,
/turf/simulated/floor/tiled/steel_ridged,
/area/map_template/deepmaint)
"bo" = (
/obj/random/junk,
/turf/simulated/floor/tiled/steel_ridged,
/area/map_template/deepmaint)
"bp" = (
/obj/random/junk,
/obj/machinery/light{
	dir = 4;
	icon_state = "tube1"
	},
/turf/simulated/floor/tiled/steel_ridged,
/area/map_template/deepmaint)
"bq" = (
/obj/structure/table/woodentable,
/obj/machinery/light{
	dir = 8
	},
/turf/simulated/floor/wood,
/area/map_template/deepmaint)
"br" = (
/obj/item/remains/human,
/obj/decal/cleanable/blood,
/obj/decal/cleanable/blood,
/turf/simulated/floor/wood,
/area/map_template/deepmaint)
"bt" = (
/obj/random/junk,
/turf/simulated/floor/carpet/red,
/area/map_template/deepmaint)
"bu" = (
/obj/structure/bed/chair{
	dir = 1
	},
/obj/random/junk,
/turf/simulated/floor/tiled/steel_ridged,
/area/map_template/deepmaint)
"bv" = (
/obj/structure/bed/chair{
	dir = 1
	},
/turf/simulated/floor/tiled/steel_ridged,
/area/map_template/deepmaint)
"by" = (
/obj/item/remains/human,
/obj/decal/cleanable/blood,
/turf/simulated/floor/wood,
/area/map_template/deepmaint)
"bz" = (
/obj/item/remains/human,
/turf/simulated/floor/carpet/red,
/area/map_template/deepmaint)
"bA" = (
/obj/decal/cleanable/blood,
/obj/random/junk,
/turf/simulated/floor/wood,
/area/map_template/deepmaint)
"bB" = (
/obj/machinery/light{
	dir = 8
	},
/turf/simulated/floor/carpet/red,
/area/map_template/deepmaint)
"bC" = (
/obj/random/junk,
/obj/machinery/light{
	dir = 4;
	icon_state = "tube1"
	},
/turf/simulated/floor/carpet/red,
/area/map_template/deepmaint)
"bD" = (
/obj/structure/table/woodentable,
/obj/random/pack/rare,
/obj/random/loot,
/turf/simulated/floor/wood,
/area/map_template/deepmaint)
"bE" = (
/obj/machinery/vending/coffee,
/turf/simulated/floor/tiled/steel_ridged,
/area/map_template/deepmaint)
"bF" = (
/obj/machinery/vending/cigarette,
/turf/simulated/floor/tiled/steel_ridged,
/area/map_template/deepmaint)
"bG" = (
/obj/machinery/light{
	dir = 1
	},
/turf/simulated/floor/tiled/dark,
/area/map_template/deepmaint)
"bI" = (
/obj/random/junk,
/obj/random/junk,
/turf/simulated/floor/tiled/steel_ridged,
/area/map_template/deepmaint)
"bK" = (
/obj/decal/cleanable/blood,
/obj/decal/cleanable/blood,
/obj/random/junk,
/turf/simulated/floor/wood,
/area/map_template/deepmaint)
"bL" = (
/turf/simulated/floor/carpet/red,
/area/map_template/deepmaint)
"xs" = (
/obj/structure/table/rack,
/obj/random/pack/tech_loot,
/obj/random/pack/tech_loot,
/obj/random/pack/tech_loot,
/turf/simulated/floor/tiled/dark,
/area/map_template/deepmaint)
"PX" = (
/mob/living/simple_animal/hostile/lar_maria/guard,
/turf/simulated/floor/wood,
/area/map_template/deepmaint)
"Tm" = (
/mob/living/simple_animal/hostile/lar_maria/guard,
/turf/simulated/floor/carpet/red,
/area/map_template/deepmaint)

(1,1,1) = {"
aa
aa
aa
aa
aa
aa
aa
aa
aa
aa
aa
aa
aa
aa
aa
aa
aa
am
aa
aa
aa
"}
(2,1,1) = {"
aa
ab
ab
ab
ab
ab
ab
ab
bn
bo
aF
aF
bu
ab
ab
ab
ab
ab
ab
ab
am
"}
(3,1,1) = {"
ai
ab
aq
aO
aU
bc
av
ab
bn
bp
bI
bo
bv
ab
aw
bL
bB
aX
bc
ab
bG
"}
(4,1,1) = {"
aa
ab
ad
bL
aX
au
af
ab
ab
ab
aJ
ab
ab
ab
aw
bL
Tm
aH
au
ab
aa
"}
(5,1,1) = {"
aa
ab
ac
bL
aX
au
af
ax
aX
bq
aX
aL
aL
af
aw
bt
bL
aV
aY
ab
aa
"}
(6,1,1) = {"
aa
ab
ae
aQ
aX
aX
af
PX
aD
aH
be
bL
bt
af
aw
bL
bL
aX
aX
ab
aa
"}
(7,1,1) = {"
aa
ab
af
af
as
aX
af
be
aX
aY
aX
bt
aN
af
aw
bL
bt
aH
au
ab
aa
"}
(8,1,1) = {"
aa
ab
ag
ao
aX
aX
af
ay
af
af
aJ
af
af
af
aw
bL
bL
aV
aY
ab
aa
"}
(9,1,1) = {"
am
ab
ah
ao
aX
aX
af
az
af
be
aX
aX
be
af
aw
bz
bL
aX
aX
ab
aa
"}
(10,1,1) = {"
aa
ab
aC
ao
aX
aX
at
aA
aE
aI
be
be
aX
aP
aX
bL
bL
aH
au
ab
am
"}
(11,1,1) = {"
aa
ab
aj
ao
ba
bd
af
aA
af
be
aX
be
bc
af
aw
bL
bC
aV
aY
ab
aa
"}
(12,1,1) = {"
aa
ab
ab
ab
ab
af
af
aB
af
af
aJ
af
af
af
af
af
ab
ab
ab
ab
aa
"}
(13,1,1) = {"
am
ab
ak
ap
at
aX
aU
aX
aX
be
aX
be
aX
aU
aX
aX
aJ
aU
be
ab
aa
"}
(14,1,1) = {"
aa
ab
ak
ap
ab
be
aw
aX
aw
aX
aK
aK
aw
be
aw
aX
bg
bD
aX
ab
aa
"}
(15,1,1) = {"
aa
ab
ak
ap
ab
be
aw
be
aw
be
aw
aX
aw
aX
aw
aX
bg
aW
aX
ab
aa
"}
(16,1,1) = {"
aa
ab
xs
aR
ab
bf
aw
be
aw
aX
aw
be
aw
aY
aw
aI
af
ax
aZ
ab
aa
"}
(17,1,1) = {"
aa
ab
al
ap
ab
bg
bg
bg
af
be
aw
PX
aw
be
be
bA
af
aX
be
ab
aa
"}
(18,1,1) = {"
aa
ab
al
ap
ab
bh
bj
bl
af
aT
aw
be
aw
be
bK
by
af
aX
bc
ab
aa
"}
(19,1,1) = {"
aa
ab
ab
ab
ab
bi
bk
bm
aJ
br
aw
be
aI
bc
by
bA
ab
ab
ab
ab
aa
"}
(20,1,1) = {"
aa
ab
aM
aS
ab
ab
ab
ab
ab
ab
ab
ab
ab
ab
ab
ab
ab
bE
bF
ab
aa
"}
(21,1,1) = {"
aa
aa
aa
am
bb
aa
aa
aa
am
aa
aa
aa
aa
aa
aa
aa
bb
aa
aa
aa
aa
"}
