//MAP CONVERTED BY dmm2tgm.py THIS HEADER COMMENT PREVENTS RECONVERSION, DO NOT REMOVE
"c" = (
/turf/simulated/floor/carpet/blue,
/area/portal_showcase/B)
"d" = (
/obj/effect/map_effect/portal/master/side_b{
	dir = 1
	},
/turf/simulated/floor/carpet/blue,
/area/portal_showcase/B)
"f" = (
/obj/effect/map_effect/portal/line/side_b{
	dir = 1
	},
/turf/simulated/floor/carpet/blue,
/area/portal_showcase/B)
"i" = (
/turf/simulated/floor/wood,
/area/portal_showcase/A)
"j" = (
/turf/space,
/area/space)
"l" = (
/turf/simulated/wall/concrete,
/area/portal_showcase/A)
"m" = (
/obj/effect/map_effect/portal/master/side_a,
/turf/simulated/floor/carpet,
/area/portal_showcase/A)
"n" = (
/obj/effect/map_effect/portal/line/side_a,
/turf/simulated/floor/carpet,
/area/portal_showcase/A)
"p" = (
/obj/effect/map_effect/portal/master/side_a{
	dir = 4;
	portal_id = "horizontal"
	},
/turf/simulated/floor/wood,
/area/portal_showcase/A)
"r" = (
/turf/simulated/floor/carpet,
/area/portal_showcase/A)
"E" = (
/obj/effect/map_effect/portal/master/side_b{
	dir = 8;
	portal_id = "horizontal"
	},
/turf/simulated/floor/wood,
/area/portal_showcase/A)
"G" = (
/obj/effect/map_effect/portal/line/side_a{
	dir = 4
	},
/turf/simulated/floor/wood,
/area/portal_showcase/A)
"L" = (
/obj/effect/map_effect/portal/line/side_b{
	dir = 8
	},
/turf/simulated/floor/wood,
/area/portal_showcase/A)
"N" = (
/turf/simulated/wall/concrete,
/area/portal_showcase/B)
"V" = (
/turf/simulated/floor/tiled/techmaint,
/area/portal_showcase/B)

(1,1,1) = {"
j
j
j
j
j
j
j
j
j
j
j
j
j
j
j
j
j
j
j
j
j
j
j
j
j
j
j
j
j
"}
(2,1,1) = {"
j
j
j
j
j
j
j
j
j
j
j
j
j
j
j
j
j
j
j
j
j
j
j
j
j
j
j
j
j
"}
(3,1,1) = {"
j
j
j
j
j
j
j
j
j
j
j
j
j
j
j
j
j
j
j
j
j
j
j
j
j
j
j
j
j
"}
(4,1,1) = {"
j
j
j
j
j
j
j
N
N
N
N
N
j
j
j
j
j
j
j
j
j
j
j
l
l
l
l
l
j
"}
(5,1,1) = {"
j
j
j
j
j
j
j
N
V
V
V
N
j
j
j
j
j
j
j
j
j
j
j
l
p
G
G
l
j
"}
(6,1,1) = {"
j
j
j
j
j
j
j
N
V
V
V
N
j
j
j
j
j
j
j
j
j
j
j
l
i
i
i
l
j
"}
(7,1,1) = {"
j
j
j
j
j
j
j
N
V
V
V
N
j
j
j
j
j
j
j
j
j
j
l
l
i
i
i
l
j
"}
(8,1,1) = {"
j
j
j
j
j
j
j
N
V
V
V
N
j
j
j
j
j
j
j
j
j
j
l
i
i
i
i
l
j
"}
(9,1,1) = {"
j
j
j
j
j
j
j
N
V
V
V
N
j
j
j
j
j
j
j
j
j
j
l
l
i
i
i
l
j
"}
(10,1,1) = {"
j
j
j
j
j
j
j
N
V
V
V
N
N
j
j
j
j
j
j
j
j
j
j
l
i
i
i
l
j
"}
(11,1,1) = {"
j
j
j
j
j
j
j
N
V
V
V
V
N
j
j
j
j
j
j
j
j
j
j
l
i
i
i
l
j
"}
(12,1,1) = {"
j
j
j
j
j
j
j
N
V
V
V
N
N
j
j
j
j
j
j
j
j
j
j
l
i
i
i
l
j
"}
(13,1,1) = {"
j
j
j
j
j
j
j
N
V
V
V
N
j
j
j
j
j
j
j
j
j
j
j
l
i
i
i
l
j
"}
(14,1,1) = {"
j
j
j
j
j
j
j
N
V
V
V
N
j
j
j
j
j
j
j
j
j
j
j
l
i
i
i
l
j
"}
(15,1,1) = {"
j
j
j
j
j
j
j
N
V
V
V
N
N
N
N
j
j
j
j
j
j
j
l
l
i
i
i
l
j
"}
(16,1,1) = {"
j
j
j
j
j
j
j
N
c
c
c
c
c
d
N
j
j
j
j
j
j
j
l
m
r
r
r
l
j
"}
(17,1,1) = {"
j
j
j
j
j
j
j
N
c
c
c
c
c
f
N
j
j
j
j
j
j
j
l
n
r
r
r
l
j
"}
(18,1,1) = {"
j
j
j
j
j
j
j
N
c
c
c
c
c
f
N
j
j
j
j
j
j
j
l
n
r
r
r
l
j
"}
(19,1,1) = {"
j
j
j
j
j
j
j
N
N
N
N
N
N
N
N
j
j
j
j
j
j
j
l
l
i
i
i
l
j
"}
(20,1,1) = {"
j
j
j
j
j
j
j
j
j
j
j
j
j
j
j
j
j
j
j
j
j
j
j
l
i
i
i
l
j
"}
(21,1,1) = {"
j
j
j
j
j
j
j
j
j
j
j
j
j
j
j
j
j
j
j
j
j
j
j
l
i
i
i
l
j
"}
(22,1,1) = {"
j
j
j
j
j
j
j
j
j
j
j
j
j
j
j
j
j
j
j
j
j
j
j
l
i
i
i
l
j
"}
(23,1,1) = {"
j
j
j
j
j
j
j
j
j
j
j
j
j
j
j
j
j
j
j
j
j
j
j
l
i
i
i
l
j
"}
(24,1,1) = {"
j
j
j
j
j
j
j
j
j
j
j
j
j
j
j
j
j
j
j
j
j
j
j
l
i
i
i
l
j
"}
(25,1,1) = {"
j
j
j
j
j
j
j
j
j
j
j
j
j
j
j
j
j
j
j
j
j
j
j
l
i
i
i
l
j
"}
(26,1,1) = {"
j
j
j
j
j
j
j
j
j
j
j
j
j
j
j
j
j
j
j
j
j
j
j
l
i
i
i
l
j
"}
(27,1,1) = {"
j
j
j
j
j
j
j
j
j
j
j
j
j
j
j
j
j
j
j
j
j
j
j
l
i
i
i
l
j
"}
(28,1,1) = {"
j
j
j
j
j
j
j
j
j
j
j
j
j
j
j
j
j
j
j
j
j
j
j
l
i
i
i
l
j
"}
(29,1,1) = {"
j
j
j
j
j
j
j
j
j
j
j
j
j
j
j
j
j
j
j
j
j
j
j
l
E
L
L
l
j
"}
(30,1,1) = {"
j
j
j
j
j
j
j
j
j
j
j
j
j
j
j
j
j
j
j
j
j
j
j
l
l
l
l
l
j
"}
(31,1,1) = {"
j
j
j
j
j
j
j
j
j
j
j
j
j
j
j
j
j
j
j
j
j
j
j
j
j
j
j
j
j
"}
(32,1,1) = {"
j
j
j
j
j
j
j
j
j
j
j
j
j
j
j
j
j
j
j
j
j
j
j
j
j
j
j
j
j
"}
(33,1,1) = {"
j
j
j
j
j
j
j
j
j
j
j
j
j
j
j
j
j
j
j
j
j
j
j
j
j
j
j
j
j
"}
(34,1,1) = {"
j
j
j
j
j
j
j
j
j
j
j
j
j
j
j
j
j
j
j
j
j
j
j
j
j
j
j
j
j
"}
(35,1,1) = {"
j
j
j
j
j
j
j
j
j
j
j
j
j
j
j
j
j
j
j
j
j
j
j
j
j
j
j
j
j
"}
