//MAP CONVERTED BY dmm2tgm.py THIS HEADER COMMENT PREVENTS RECONVERSION, DO NOT REMOVE
"a" = (
/turf/template_noop,
/area/template_noop)
"b" = (
/obj/structure/flora/bush,
/turf/template_noop,
/area/map_template/oasis)
"c" = (
/turf/template_noop,
/area/map_template/oasis)
"d" = (
/obj/structure/flora/ausbushes/lavendergrass,
/turf/template_noop,
/area/map_template/oasis)
"e" = (
/obj/structure/flora/grass/green,
/turf/simulated/floor/exoplanet/grass,
/area/map_template/oasis)
"f" = (
/obj/structure/flora/grass/both,
/turf/simulated/floor/exoplanet/grass,
/area/map_template/oasis)
"g" = (
/turf/simulated/floor/exoplanet/water/shallow,
/area/map_template/oasis)
"h" = (
/obj/structure/flora/ausbushes/reedbush,
/turf/simulated/floor/exoplanet/water/shallow,
/area/map_template/oasis)
"i" = (
/obj/structure/flora/bush,
/turf/simulated/floor/exoplanet/grass,
/area/map_template/oasis)
"j" = (
/turf/simulated/floor/exoplanet/grass,
/area/map_template/oasis)
"k" = (
/obj/structure/flora/ausbushes/palebush,
/turf/simulated/floor/exoplanet/grass,
/area/map_template/oasis)
"l" = (
/obj/structure/flora/grass/brown,
/turf/simulated/floor/exoplanet/grass,
/area/map_template/oasis)
"m" = (
/obj/structure/flora/ausbushes,
/turf/simulated/floor/exoplanet/grass,
/area/map_template/oasis)

(1,1,1) = {"
a
a
a
a
a
a
a
"}
(2,1,1) = {"
a
a
a
d
a
a
a
"}
(3,1,1) = {"
a
b
c
f
c
a
a
"}
(4,1,1) = {"
a
c
f
g
e
j
a
"}
(5,1,1) = {"
a
d
e
g
g
k
a
"}
(6,1,1) = {"
a
e
g
g
g
g
j
"}
(7,1,1) = {"
a
c
e
g
g
l
j
"}
(8,1,1) = {"
a
e
h
g
g
l
a
"}
(9,1,1) = {"
a
c
e
g
g
i
a
"}
(10,1,1) = {"
a
a
c
f
h
j
a
"}
(11,1,1) = {"
a
a
a
i
j
m
a
"}
(12,1,1) = {"
a
a
a
a
a
a
a
"}
