//MAP CONVERTED BY dmm2tgm.py THIS HEADER COMMENT PREVENTS RECONVERSION, DO NOT REMOVE
"P" = (
/turf/simulated/floor/holofloor/reinforced,
/area/holodeck/plating)

(1,1,1) = {"
P
P
P
P
P
P
P
P
P
P
"}
(2,1,1) = {"
P
P
P
P
P
P
P
P
P
P
"}
(3,1,1) = {"
P
P
P
P
P
P
P
P
P
P
"}
(4,1,1) = {"
P
P
P
P
P
P
P
P
P
P
"}
(5,1,1) = {"
P
P
P
P
P
P
P
P
P
P
"}
(6,1,1) = {"
P
P
P
P
P
P
P
P
P
P
"}
(7,1,1) = {"
P
P
P
P
P
P
P
P
P
P
"}
(8,1,1) = {"
P
P
P
P
P
P
P
P
P
P
"}
(9,1,1) = {"
P
P
P
P
P
P
P
P
P
P
"}
(10,1,1) = {"
P
P
P
P
P
P
P
P
P
P
"}
