"aa" = (/turf/space,/area/space)
"ab" = (/turf/simulated/wall/covenant/reinforced,/area/om_ships/req_console_ship)
"ac" = (/obj/machinery/deck_gun/cov_pulse_turret{dir = 8},/turf/space,/area/space)
"ad" = (/turf/simulated/floor/covenant{icon_state = "cov_floor"},/area/om_ships/req_console_ship)
"ae" = (/obj/machinery/light/covenant/north,/turf/simulated/floor/covenant{icon_state = "cov_floor"},/area/om_ships/req_console_ship)
"af" = (/obj/machinery/light/covenant/west,/turf/simulated/floor/covenant{icon_state = "cov_floor"},/area/om_ships/req_console_ship)
"ag" = (/obj/effect/landmark/dropship_land_point/covenant,/turf/simulated/floor/covenant{icon_state = "cov_floor"},/area/om_ships/req_console_ship)
"ai" = (/turf/simulated/wall/covenant,/area/om_ships/req_console_ship)
"aj" = (/obj/machinery/light/covenant/south,/turf/simulated/floor/covenant{icon_state = "cov_floor"},/area/om_ships/req_console_ship)
"ak" = (/obj/machinery/door/airlock/covenant/cov_ship_preset,/turf/simulated/floor/covenant{icon_state = "cov_floor"},/area/om_ships/req_console_ship)
"al" = (/obj/structure/closet/secure_closet/freezer/kitchen{icon = 'code/modules/halo/icons/storage/covenant/crate.dmi'; icon_broken = "Covie Crate Closed"; icon_closed = "Covie Crate Closed"; icon_locked = "Covie Crate Closed"; icon_off = "Covie Crate Closed"; icon_opened = "Covie Crate Open"; icon_state = "Covie Crate Closed"},/turf/simulated/floor/covenant{icon_state = "cov_floor"},/area/om_ships/req_console_ship)
"am" = (/obj/machinery/cooker/grill{color = "#ff99ff"},/turf/simulated/floor/covenant{icon_state = "cov_floor"},/area/om_ships/req_console_ship)
"an" = (/obj/machinery/cooker/fryer{color = "#ff99ff"},/turf/simulated/floor/covenant{icon_state = "cov_floor"},/area/om_ships/req_console_ship)
"ao" = (/obj/machinery/cooker/oven{color = "#ff99ff"},/turf/simulated/floor/covenant{icon_state = "cov_floor"},/area/om_ships/req_console_ship)
"ap" = (/obj/item/weapon/weldingtool/covenant,/obj/item/weapon/weldingtool/covenant,/obj/structure/table/rack,/turf/simulated/floor/covenant{tag = "icon-cov_floor"; icon_state = "cov_floor"},/area/om_ships/req_console_ship)
"aq" = (/obj/item/weapon/screwdriver/covenant,/obj/item/weapon/screwdriver/covenant,/obj/structure/table/rack,/turf/simulated/floor/covenant{icon_state = "cov_floor"},/area/om_ships/req_console_ship)
"ar" = (/obj/item/weapon/wirecutters/covenant,/obj/item/weapon/wirecutters/covenant,/obj/structure/table/rack,/turf/simulated/floor/covenant{tag = "icon-cov_floor"; icon_state = "cov_floor"},/area/om_ships/req_console_ship)
"as" = (/obj/item/weapon/wrench/covenant,/obj/item/weapon/wrench/covenant,/obj/structure/table/rack,/turf/simulated/floor/covenant{tag = "icon-cov_floor"; icon_state = "cov_floor"},/area/om_ships/req_console_ship)
"at" = (/obj/structure/window/reinforced/projresist/covenant{dir = 1},/obj/structure/window/reinforced/projresist/covenant{dir = 8},/obj/structure/grille,/turf/simulated/floor/covenant{icon_state = "cov_floor"},/area/om_ships/req_console_ship)
"au" = (/obj/structure/window/reinforced/projresist/covenant{dir = 1},/obj/structure/window/reinforced/projresist/covenant{dir = 2},/obj/structure/window/reinforced/projresist/covenant{dir = 4},/obj/structure/grille,/turf/simulated/floor/covenant{icon_state = "cov_floor"},/area/om_ships/req_console_ship)
"av" = (/obj/machinery/telecomms/allinone{icon = 'code/modules/halo/icons/machinery/covenant/consoles.dmi'; icon_state = "covie_console"; name = "Battlenet Server Hub"; tag = "icon-covie_console_off"},/turf/simulated/floor/covenant{icon_state = "cov_floor"},/area/om_ships/req_console_ship)
"aw" = (/obj/item/weapon/storage/firstaid/unsc/cov,/obj/item/weapon/storage/firstaid/unsc/cov,/obj/item/weapon/storage/firstaid/unsc/cov,/obj/item/weapon/storage/firstaid/unsc/cov,/obj/structure/table/marble,/turf/simulated/floor/covenant{icon_state = "cov_floor"},/area/om_ships/req_console_ship)
"ax" = (/obj/structure/table/marble,/obj/item/bodybag/cryobag/covenant,/obj/item/bodybag/cryobag/covenant,/obj/item/bodybag/cryobag/covenant,/turf/simulated/floor/covenant{icon_state = "cov_floor"},/area/om_ships/req_console_ship)
"ay" = (/obj/structure/reagent_dispensers/fueltank{color = "#ff99ff"},/turf/simulated/floor/covenant{icon_state = "cov_floor"},/area/om_ships/req_console_ship)
"az" = (/obj/docking_umbilical/covenant/north,/turf/simulated/floor/covenant{icon_state = "cov_floor"},/area/om_ships/req_console_ship)
"aA" = (/obj/item/weapon/crowbar/covenant,/obj/item/weapon/crowbar/covenant,/obj/structure/table/rack,/turf/simulated/floor/covenant{tag = "icon-cov_floor"; icon_state = "cov_floor"},/area/om_ships/req_console_ship)
"aB" = (/obj/item/device/multitool/covenant,/obj/item/device/multitool/covenant,/obj/structure/table/rack,/turf/simulated/floor/covenant{tag = "icon-cov_floor"; icon_state = "cov_floor"},/area/om_ships/req_console_ship)
"aC" = (/obj/structure/window/reinforced/projresist/covenant{dir = 4},/turf/simulated/floor/covenant{icon_state = "cov_floor"},/area/om_ships/req_console_ship)
"aD" = (/obj/machinery/repulsor_engine{tag = "icon-nozzle (WEST)"; icon_state = "nozzle"; dir = 8},/turf/simulated/floor/covenant{icon_state = "cov_floor"},/area/om_ships/req_console_ship)
"aE" = (/obj/structure/window/reinforced/projresist/covenant{dir = 8},/obj/structure/window/reinforced/projresist/covenant{dir = 4},/obj/structure/grille,/turf/simulated/floor/covenant{icon_state = "cov_floor"},/area/om_ships/req_console_ship)
"aF" = (/obj/machinery/overmap_weapon_console/ship_scanning_console/cov,/turf/simulated/floor/covenant{icon_state = "cov_floor"},/area/om_ships/req_console_ship)
"aG" = (/obj/structure/closet/walllocker/emerglocker/covvie/north,/turf/simulated/floor/covenant{icon_state = "cov_floor"},/area/om_ships/req_console_ship)
"aH" = (/obj/structure/window/reinforced/projresist/covenant{dir = 2},/obj/structure/stairs_decorative{dir = 4; icon_state = "stairs"},/turf/simulated/floor/covenant{icon_state = "cov_floor"},/area/om_ships/req_console_ship)
"aI" = (/obj/structure/window/reinforced/projresist/covenant{dir = 1},/turf/simulated/floor/covenant{icon_state = "cov_floor"},/area/om_ships/req_console_ship)
"aJ" = (/obj/structure/window/reinforced/projresist/covenant{dir = 1},/obj/structure/bed/chair/covenant_stool,/turf/simulated/floor/covenant{icon_state = "cov_floor"},/area/om_ships/req_console_ship)
"aK" = (/obj/structure/window/reinforced/projresist/covenant{dir = 1},/obj/structure/window/reinforced/projresist/covenant{dir = 4},/obj/machinery/overmap_weapon_console/deck_gun_control/local/plastorp_control,/turf/simulated/floor/covenant{icon_state = "cov_floor"},/area/om_ships/req_console_ship)
"aL" = (/obj/structure/bed/chair/covenant_stool,/turf/simulated/floor/covenant{icon_state = "cov_floor"},/area/om_ships/req_console_ship)
"aM" = (/obj/structure/table/rack,/obj/item/clothing/head/welding/covenant,/obj/item/clothing/head/welding/covenant,/obj/machinery/light/covenant/east,/turf/simulated/floor/covenant{icon_state = "cov_floor"},/area/om_ships/req_console_ship)
"aN" = (/obj/machinery/light/covenant/south,/mob/living/bot/cleanbot/covenant,/turf/simulated/floor/covenant{icon_state = "cov_floor"},/area/om_ships/req_console_ship)
"aO" = (/obj/structure/closet/crate/covenant{name = "Building Supplies"},/obj/item/stack/material/steel/fifty,/turf/simulated/floor/covenant{icon_state = "cov_floor"},/area/om_ships/req_console_ship)
"aP" = (/obj/structure/closet/crate/covenant{name = "Building Supplies"},/obj/item/stack/material/glass/phoronrglass/ten,/turf/simulated/floor/covenant{icon_state = "cov_floor"},/area/om_ships/req_console_ship)
"aQ" = (/obj/structure/closet/crate/covenant{name = "Building Supplies"},/obj/item/stack/material/nanolaminate/fifty,/turf/simulated/floor/covenant{icon_state = "cov_floor"},/area/om_ships/req_console_ship)
"aR" = (/obj/machinery/computer/helm{icon = 'code/modules/halo/icons/machinery/covenant/consoles.dmi'; icon_state = "covie_nav"; icon_keyboard = ""; icon_screen = "covie_console_overlay"},/turf/simulated/floor/covenant{icon_state = "cov_floor"},/area/om_ships/req_console_ship)
"aS" = (/obj/structure/bed/chair/covenant_stool{dir = 8; icon_state = "coviechair2"; name = "Shipmaster's anti-grav chair"},/turf/simulated/floor/covenant{icon_state = "cov_floor"},/area/om_ships/req_console_ship)
"aT" = (/obj/machinery/computer/helm{icon = 'code/modules/halo/icons/machinery/covenant/consoles.dmi'; icon_state = "covie_nav"; icon_keyboard = ""; icon_screen = "covie_console_overlay"},/obj/structure/window/reinforced/projresist/covenant{dir = 8},/turf/simulated/floor/covenant{icon_state = "cov_floor"},/area/om_ships/req_console_ship)
"aU" = (/obj/structure/stairs_decorative{icon_state = "stairs"; dir = 8},/turf/simulated/floor/covenant{icon_state = "cov_floor"},/area/om_ships/req_console_ship)
"aV" = (/obj/structure/table/marble,/turf/simulated/floor/covenant{icon_state = "cov_floor"},/area/om_ships/req_console_ship)
"aW" = (/obj/machinery/light/covenant/east,/turf/simulated/floor/covenant{icon_state = "cov_floor"},/area/om_ships/req_console_ship)
"aX" = (/obj/machinery/portable_atmospherics/canister/oxygen{canister_color = "black"; icon_state = "black"; name = "\improper Covenant Canister: \[O2]"; start_pressure = 7559.63},/obj/machinery/light/covenant/west,/turf/simulated/floor/covenant{icon_state = "cov_floor"},/area/om_ships/req_console_ship)
"aY" = (/obj/machinery/repulsor_engine{tag = "icon-nozzle (WEST)"; icon_state = "nozzle"; dir = 8},/obj/structure/window/reinforced/projresist/covenant{dir = 8},/turf/simulated/floor/covenant{icon_state = "cov_floor"},/area/om_ships/req_console_ship)
"aZ" = (/obj/machinery/overmap_weapon_console/npc_comms_console/cov{icon_state = "covie_nav_off"},/turf/simulated/floor/covenant{icon_state = "cov_floor"},/area/om_ships/req_console_ship)
"ba" = (/obj/structure/closet/walllocker/emerglocker/covvie/south,/turf/simulated/floor/covenant{icon_state = "cov_floor"},/area/om_ships/req_console_ship)
"bb" = (/obj/structure/window/reinforced/projresist/covenant{dir = 1},/obj/structure/stairs_decorative{dir = 4; icon_state = "stairs"},/turf/simulated/floor/covenant{icon_state = "cov_floor"},/area/om_ships/req_console_ship)
"bc" = (/obj/structure/window/reinforced/projresist/covenant{dir = 2},/turf/simulated/floor/covenant{icon_state = "cov_floor"},/area/om_ships/req_console_ship)
"bd" = (/obj/structure/window/reinforced/projresist/covenant{dir = 2},/obj/structure/bed/chair/covenant_stool,/turf/simulated/floor/covenant{icon_state = "cov_floor"},/area/om_ships/req_console_ship)
"be" = (/obj/structure/window/reinforced/projresist/covenant{dir = 2},/obj/structure/window/reinforced/projresist/covenant{dir = 4},/obj/machinery/overmap_weapon_console/deck_gun_control/local/cov_pulse_turret,/turf/simulated/floor/covenant{icon_state = "cov_floor"},/area/om_ships/req_console_ship)
"bf" = (/obj/structure/janitorialcart{color = "#ff99ff"},/obj/item/weapon/mop{color = "#ff99ff"},/obj/item/weapon/reagent_containers/glass/bucket{color = "#ff99ff"},/obj/machinery/light/covenant/east,/turf/simulated/floor/covenant{icon_state = "cov_floor"},/area/om_ships/req_console_ship)
"bg" = (/obj/machinery/light/covenant/north,/mob/living/bot/cleanbot/covenant,/turf/simulated/floor/covenant{icon_state = "cov_floor"},/area/om_ships/req_console_ship)
"bh" = (/obj/structure/window/reinforced/projresist/covenant{dir = 8},/obj/structure/window/reinforced/projresist/covenant{dir = 2},/obj/structure/grille,/turf/simulated/floor/covenant{icon_state = "cov_floor"},/area/om_ships/req_console_ship)
"bi" = (/obj/structure/window/reinforced/projresist/covenant{dir = 2},/obj/structure/window/reinforced/projresist/covenant{dir = 1},/obj/structure/window/reinforced/projresist/covenant{dir = 4},/obj/structure/grille,/turf/simulated/floor/covenant{icon_state = "cov_floor"},/area/om_ships/req_console_ship)
"bj" = (/obj/machinery/nav_computer/covenant,/turf/simulated/floor/covenant{icon_state = "cov_floor"},/area/om_ships/req_console_ship)
"bk" = (/obj/item/weapon/storage/firstaid/o2/covenant,/obj/item/weapon/storage/firstaid/o2/covenant,/obj/structure/table/marble,/obj/item/weapon/storage/firstaid/o2/covenant,/obj/item/weapon/storage/firstaid/o2/covenant,/turf/simulated/floor/covenant{icon_state = "cov_floor"},/area/om_ships/req_console_ship)
"bl" = (/obj/structure/reagent_dispensers/watertank{color = "#ff99ff"},/turf/simulated/floor/covenant{icon_state = "cov_floor"},/area/om_ships/req_console_ship)
"bm" = (/obj/docking_umbilical/covenant/south,/turf/simulated/floor/covenant{icon_state = "cov_floor"},/area/om_ships/req_console_ship)
"bL" = (/obj/structure/table/marble,/obj/machinery/microwave{color = "#ff99ff"},/turf/simulated/floor/covenant{icon_state = "cov_floor"},/area/om_ships/req_console_ship)
"eh" = (/obj/structure/closet/walllocker/emerglocker/covvie/south,/obj/structure/closet/crate/covenant{name = "Supraluminal Communications Equipment"},/obj/item/weapon/pen,/obj/item/weapon/pen,/obj/item/weapon/card/id{desc = "Superluminal Communications Array Authentication Disk"; icon = 'code/modules/halo/covenant/Cards.dmi'; icon_state = "sangzealot_id"; name = "Superluminal Auth Disk."; tag = "icon-pinkGold"},/obj/item/weapon/paper,/obj/item/weapon/paper,/obj/item/weapon/paper,/obj/item/weapon/paper,/obj/item/weapon/paper,/obj/item/weapon/paper,/obj/item/weapon/paper,/obj/item/weapon/paper,/obj/item/weapon/paper,/obj/item/weapon/paper,/obj/item/weapon/paper,/obj/item/weapon/paper,/obj/item/weapon/paper,/turf/simulated/floor/covenant{tag = "icon-cov_floor"; icon_state = "cov_floor"},/area/om_ships/req_console_ship)
"fh" = (/obj/machinery/vending/armory/covenant/sangheili/food,/turf/simulated/floor/covenant{icon_state = "cov_floor"},/area/om_ships/req_console_ship)
"mC" = (/obj/machinery/vending/armory/covenant/jiralhanae/food,/turf/simulated/floor/covenant{icon_state = "cov_floor"},/area/om_ships/req_console_ship)
"rF" = (/obj/machinery/vending/armory/covenant/kigyar/food,/turf/simulated/floor/covenant{icon_state = "cov_floor"},/area/om_ships/req_console_ship)
"vj" = (/obj/structure/closet/secure_closet/freezer/fridge{icon = 'code/modules/halo/icons/storage/covenant/crate.dmi'; icon_broken = "Covie Crate Closed"; icon_closed = "Covie Crate Closed"; icon_locked = "Covie Crate Closed"; icon_off = "Covie Crate Closed"; icon_opened = "Covie Crate Open"; icon_state = "Covie Crate Closed"},/obj/structure/closet/walllocker/emerglocker/covvie/north,/turf/simulated/floor/covenant{icon_state = "cov_floor"},/area/om_ships/req_console_ship)
"wX" = (/obj/machinery/vending/dinnerware{icon = 'code/modules/halo/icons/machinery/covenant/covendor.dmi'; icon_deny = "covendor-deny"; icon_vend = null},/turf/simulated/floor/covenant{icon_state = "cov_floor"},/area/om_ships/req_console_ship)
"yj" = (/obj/structure/closet/walllocker/emerglocker/covvie/south,/obj/machinery/door/airlock/covenant/cov_ship_preset,/turf/simulated/floor/covenant{icon_state = "cov_floor"},/area/om_ships/req_console_ship)
"yC" = (/obj/effect/hull_segment,/turf/simulated/wall/covenant/reinforced,/area/om_ships/req_console_ship)
"yW" = (/turf/space,/area/om_ships/req_console_ship)
"BE" = (/obj/machinery/telecomms/relay/ship_relay{icon = 'code/modules/halo/icons/machinery/covenant/consoles.dmi'; icon_state = "covie_console"},/turf/simulated/floor/covenant{icon_state = "cov_floor"},/area/om_ships/req_console_ship)
"EN" = (/obj/vehicles/drop_pod/escape_pod/covenant/east,/turf/simulated/floor/covenant{icon_state = "cov_floor"},/area/om_ships/req_console_ship)
"Fe" = (/obj/structure/closet/walllocker/emerglocker/covvie/north,/obj/machinery/door/airlock/covenant/cov_ship_preset,/turf/simulated/floor/covenant{icon_state = "cov_floor"},/area/om_ships/req_console_ship)
"JR" = (/obj/machinery/photocopier/faxmachine{department = "CRS Unyielding Transgression"; icon = 'code/modules/halo/icons/machinery/covenant/consoles.dmi'; icon_state = "covie_console"; name = "Superluminal Communications Array"; tag = "icon-covie_console"},/turf/simulated/floor/covenant{icon_state = "cov_floor"},/area/om_ships/req_console_ship)
"Lo" = (/obj/structure/closet/secure_closet/freezer/meat{icon = 'code/modules/halo/icons/storage/covenant/crate.dmi'; icon_broken = "Covie Crate Closed"; icon_closed = "Covie Crate Closed"; icon_locked = "Covie Crate Closed"; icon_off = "Covie Crate Closed"; icon_opened = "Covie Crate Open"; icon_state = "Covie Crate Closed"},/obj/structure/sink/kitchen{pixel_y = 22},/turf/simulated/floor/covenant{icon_state = "cov_floor"},/area/om_ships/req_console_ship)
"MZ" = (/obj/machinery/telecomms/relay/long_range_emergency{icon = 'code/modules/halo/icons/machinery/covenant/consoles.dmi'; icon_state = "covie_console"},/turf/simulated/floor/covenant{icon_state = "cov_floor"},/area/om_ships/req_console_ship)
"PX" = (/obj/effect/hull_segment,/turf/simulated/wall/covenant,/area/om_ships/req_console_ship)

(1,1,1) = {"
aaaaaaaaaaaaaaaaaaaaaaaaaaaaaaaaaaaaaaaaaaaaaaaaaaaaaaaaaaaaaaaaaaaaaaaaaaaaaaaaaaaaaaaaaaaaaaaaaaaa
aaaaaaaaaaaaaaaaaaaaaaaaaaaaaaaaaaaaaaabababababababababababababaaaaaaaaaaaaaaaaaaaaaaaaaaaaaaaaaaaa
aaaaaaaaaaaaaaaaaaaaaaaaaaaaaaaaaaaaabababababababababababababababaaaaaaaaaaaaaaaaaaaaaaaaaaaaaaaaaa
aaaaaaaaaaaaaaaaaaaaaaacaaabababaaababababadadadadaeadadadadababababaaaaaaaaaaaaaaaaaaaaaaaaaaaaaaaa
aaaaaaaaaaaaaaaaacaaabababababaaaaababadadadadadadadadadadadadabababaaaaaaaaaaaaaaaaaaaaaaaaaaaaaaaa
aaaaaaaaaaacaaabababababaaaaaaaaaaababadadadadadadadadadadadadababababaaaaaaaaabababababababaaaaaaaa
aaaaaaaaabababababaaaaaaaaaaaaaaabababafadadadagadadadadadadadadabababababababababababababababaaaaaa
aaaaaaabababaaaaaaaaaaaaaaaaababababaiadadajadadadadadadadadadadadBEababababababababadadadabababaaaa
aaaaaaababababababababababababababaiaiPXaiaiadadadadadajadbaadadajadakadababababababENadadababababaa
aaaaaaabaiaiaiPXaiaiaiaiaiaiababaialamanaoaiaiaiakaiaiaiaiPXaiaiaiaiaiadapaqarasababadadadababaaaaaa
aaaaatauaiavaiaiadadadaeadadawaiLoadadadadvjaiaxadayaiaiadazadaiaiaAaBadadadadadadFeadajaCaDaaaaaaaa
aaaaaEaFaeadaGaiadaHaIaJaKadadaiafaLaLaLaLadakadadaMaiafadadadadakadadadaNadaOaPaQPXakaiaiaiaaaaaaaa
aaaaaEaRaSadadakadaTaSadadaUadakadbLaVaVaVaWaiaXadadakadadadadaWaiaiaiakaiakaiaiaiaiafaYyWyWaaaaaaaa
aaaaaEaZajadbaaiadbbbcbdbeadadaiafaLaLaLaLadakadadbfaiafadadadadakadadadbgadaOaPaQPXakaiaiaiaaaaaaaa
aaaabhbiaibjaiaiadadadajadadbkaiJRadadadadehaiaxadblaiaiadbmadaiaiaAaBadadadadadadyjadaeaCaDaaaaaaaa
aaaaaaababababyCababababababababaiwXmCfhrFaiaiaiakaiaiaiaiPXaiaiaiaiaiadapaqarasababadadadababaaaaaa
aaaaaaababababababababababababababaiaiPXaiaiadadadadadaeadaGadadaeadakadababababababadadadababababaa
aaaaaaabababaaaaaaaaaaaaaaaaababababaiadadaeadadadadadadadadadadadMZababababababababENadadabababaaaa
aaaaaaaaabababababaaaaaaaaaaaaaaabababafadadadadadadadadadadadadabababababababababababababababaaaaaa
aaaaaaaaaaacaaabababababaaaaaaaaaaababadadadadadadadadadadadadababababaaaaaaaaabababababababaaaaaaaa
aaaaaaaaaaaaaaaaacaaabababababaaaaababadadadagadadadadadadadadabababaaaaaaaaaaaaaaaaaaaaaaaaaaaaaaaa
aaaaaaaaaaaaaaaaaaaaaaacaaabababaaababababadadadadajadadadadababababaaaaaaaaaaaaaaaaaaaaaaaaaaaaaaaa
aaaaaaaaaaaaaaaaaaaaaaaaaaaaaaaaaaaaabababababababababababababababaaaaaaaaaaaaaaaaaaaaaaaaaaaaaaaaaa
aaaaaaaaaaaaaaaaaaaaaaaaaaaaaaaaaaaaaaabababababababababababababaaaaaaaaaaaaaaaaaaaaaaaaaaaaaaaaaaaa
aaaaaaaaaaaaaaaaaaaaaaaaaaaaaaaaaaaaaaaaaaaaaaaaaaaaaaaaaaaaaaaaaaaaaaaaaaaaaaaaaaaaaaaaaaaaaaaaaaaa
"}

