"aa" = (/turf/space,/area/space)
"ax" = (/obj/structure/closet/crate/covenant{name = "Building Supplies"},/obj/item/stack/material/glass/phoronrglass/ten,/obj/item/stack/material/glass/phoronrglass/ten,/obj/item/stack/material/glass/phoronrglass/ten,/obj/item/stack/material/glass/phoronrglass/ten,/obj/item/stack/material/glass/phoronrglass/ten,/turf/simulated/floor/covenant{icon_state = "cov_floor"},/area/om_ships/req_console_ship)
"bS" = (/obj/machinery/atmospherics/unary/freezer{dir = 1},/turf/simulated/floor/covenant{icon_state = "cov_floor"},/area/om_ships/req_console_ship)
"dz" = (/obj/machinery/atmospherics/unary/freezer,/turf/simulated/floor/covenant{icon_state = "cov_floor"},/area/om_ships/req_console_ship)
"dZ" = (/obj/structure/janitorialcart{color = "#ff99ff"},/obj/item/weapon/mop{color = "#ff99ff"},/obj/item/weapon/reagent_containers/glass/bucket{color = "#ff99ff"},/turf/simulated/floor/covenant{icon_state = "cov_floor"},/area/om_ships/req_console_ship)
"ef" = (/obj/structure/window/reinforced/projresist/covenant{dir = 1},/obj/structure/window/reinforced/projresist/covenant{dir = 2},/obj/structure/window/reinforced/projresist/covenant{dir = 4},/obj/structure/grille,/turf/simulated/floor/covenant{icon_state = "cov_floor"},/area/om_ships/req_console_ship)
"er" = (/obj/machinery/overmap_weapon_console/deck_gun_control/local/cov_pulse_turret,/obj/structure/window/reinforced/projresist/covenant{dir = 4},/turf/simulated/floor/covenant{icon_state = "cov_floor"},/area/om_ships/req_console_ship)
"eE" = (/obj/structure/reagent_dispensers/watertank{color = "#ff99ff"},/turf/simulated/floor/covenant{icon_state = "cov_floor"},/area/om_ships/req_console_ship)
"gw" = (/obj/machinery/cooker/oven{color = "#ff99ff"},/turf/simulated/floor/covenant{icon_state = "cov_floor"},/area/om_ships/req_console_ship)
"gX" = (/obj/machinery/cooker/fryer{color = "#ff99ff"},/turf/simulated/floor/covenant{icon_state = "cov_floor"},/area/om_ships/req_console_ship)
"ig" = (/obj/item/weapon/weldingtool/covenant,/obj/item/weapon/weldingtool/covenant,/obj/structure/table/rack,/turf/simulated/floor/covenant{tag = "icon-cov_floor"; icon_state = "cov_floor"},/area/om_ships/req_console_ship)
"in" = (/turf/simulated/wall/covenant/reinforced,/area/om_ships/req_console_ship)
"jb" = (/obj/structure/closet/secure_closet/freezer/meat{icon = 'code/modules/halo/icons/storage/covenant/crate.dmi'; icon_broken = "Covie Crate Closed"; icon_closed = "Covie Crate Closed"; icon_locked = "Covie Crate Closed"; icon_off = "Covie Crate Closed"; icon_opened = "Covie Crate Open"; icon_state = "Covie Crate Closed"},/turf/simulated/floor/covenant{icon_state = "cov_floor"},/area/om_ships/req_console_ship)
"jj" = (/obj/structure/table/marble,/turf/simulated/floor/covenant{icon_state = "cov_floor"},/area/om_ships/req_console_ship)
"jm" = (/turf/simulated/floor/covenant{icon_state = "cov_floor"},/area/om_ships/req_console_ship)
"kg" = (/obj/structure/window/reinforced/projresist/covenant{dir = 8},/obj/structure/window/reinforced/projresist/covenant{dir = 2},/obj/structure/grille,/turf/simulated/floor/covenant{icon_state = "cov_floor"},/area/om_ships/req_console_ship)
"km" = (/obj/machinery/cooker/grill{color = "#ff99ff"},/turf/simulated/floor/covenant{icon_state = "cov_floor"},/area/om_ships/req_console_ship)
"kJ" = (/obj/machinery/light/covenant/north,/obj/machinery/sleeper/covenant{dir = 2; icon_state = "sleeper_0"},/turf/simulated/floor/covenant{icon_state = "cov_floor"},/area/om_ships/req_console_ship)
"mp" = (/obj/structure/table/marble,/obj/item/weapon/storage/firstaid/surgery,/obj/item/weapon/reagent_containers/spray/cleaner{desc = "Someone has crossed out the Space from Space Cleaner and written in Surgery. 'Do not remove under punishment of death!!!' is scrawled on the back."; name = "Surgery Cleaner"},/obj/machinery/light/covenant/north,/turf/simulated/floor/covenant{icon_state = "cov_floor"},/area/om_ships/req_console_ship)
"mW" = (/obj/structure/reagent_dispensers/fueltank{color = "#ff99ff"},/turf/simulated/floor/covenant{icon_state = "cov_floor"},/area/om_ships/req_console_ship)
"nb" = (/obj/machinery/deck_gun/cov_pulse_turret{dir = 8},/turf/space,/area/space)
"ou" = (/obj/structure/table/rack,/obj/item/clothing/head/welding/covenant,/obj/item/clothing/head/welding/covenant,/turf/simulated/floor/covenant{icon_state = "cov_floor"},/area/om_ships/req_console_ship)
"pp" = (/obj/structure/bed/chair/covenant_stool,/turf/simulated/floor/covenant{icon_state = "cov_floor"},/area/om_ships/req_console_ship)
"pG" = (/obj/machinery/light/covenant/south,/turf/simulated/floor/covenant{icon_state = "cov_floor"},/area/om_ships/req_console_ship)
"pK" = (/obj/machinery/light/covenant/south,/mob/living/bot/cleanbot/covenant,/turf/simulated/floor/covenant{icon_state = "cov_floor"},/area/om_ships/req_console_ship)
"qk" = (/obj/machinery/body_scanconsole/covenant{icon_state = "body_scannerconsole"; dir = 8},/turf/simulated/floor/covenant{icon_state = "cov_floor"},/area/om_ships/req_console_ship)
"qy" = (/obj/structure/window/reinforced/projresist/covenant{dir = 2},/turf/simulated/floor/covenant{icon_state = "cov_floor"},/area/om_ships/req_console_ship)
"ra" = (/obj/machinery/door/airlock/covenant,/turf/simulated/floor/covenant{icon_state = "cov_floor"},/area/om_ships/req_console_ship)
"rP" = (/obj/structure/table/glass/purple,/obj/item/weapon/reagent_containers/blood/OMinus,/obj/item/weapon/reagent_containers/blood/OMinus,/obj/item/weapon/reagent_containers/blood/OMinus,/obj/item/weapon/reagent_containers/blood/OMinus,/obj/item/weapon/reagent_containers/blood/OMinus,/obj/item/weapon/reagent_containers/blood/OMinus,/turf/simulated/floor/covenant{icon_state = "cov_floor"},/area/om_ships/req_console_ship)
"sk" = (/obj/structure/table/glass/purple,/obj/item/weapon/storage/firstaid/unsc/cov,/obj/item/weapon/storage/firstaid/unsc/cov,/obj/item/weapon/storage/firstaid/unsc/cov,/obj/item/weapon/storage/firstaid/unsc/cov,/obj/item/weapon/storage/firstaid/unsc/cov,/obj/item/weapon/storage/firstaid/unsc/cov,/obj/item/weapon/reagent_containers/syringe/ld50_syringe/triadrenaline,/obj/item/weapon/reagent_containers/syringe/ld50_syringe/triadrenaline,/obj/item/weapon/reagent_containers/syringe/ld50_syringe/triadrenaline,/obj/item/weapon/reagent_containers/syringe/ld50_syringe/triadrenaline,/obj/item/weapon/reagent_containers/syringe/ld50_syringe/triadrenaline,/obj/item/weapon/reagent_containers/syringe/ld50_syringe/triadrenaline,/obj/item/weapon/reagent_containers/syringe/ld50_syringe/triadrenaline,/obj/item/weapon/reagent_containers/syringe/ld50_syringe/triadrenaline,/obj/item/bodybag/cryobag/covenant,/obj/item/bodybag/cryobag/covenant,/obj/item/bodybag/cryobag/covenant,/obj/item/bodybag/cryobag/covenant,/obj/item/bodybag/cryobag/covenant,/obj/item/bodybag/cryobag/covenant,/obj/item/bodybag/cryobag/covenant,/obj/item/bodybag/cryobag/covenant,/obj/item/bodybag/cryobag/covenant,/obj/item/bodybag/cryobag/covenant,/turf/simulated/floor/covenant{icon_state = "cov_floor"},/area/om_ships/req_console_ship)
"sm" = (/obj/docking_umbilical/covenant/south,/turf/simulated/floor/covenant{icon_state = "cov_floor"},/area/om_ships/req_console_ship)
"tq" = (/obj/structure/closet/secure_closet/freezer/fridge{icon = 'code/modules/halo/icons/storage/covenant/crate.dmi'; icon_broken = "Covie Crate Closed"; icon_closed = "Covie Crate Closed"; icon_locked = "Covie Crate Closed"; icon_off = "Covie Crate Closed"; icon_opened = "Covie Crate Open"; icon_state = "Covie Crate Closed"},/turf/simulated/floor/covenant{icon_state = "cov_floor"},/area/om_ships/req_console_ship)
"ue" = (/obj/item/weapon/screwdriver/covenant,/obj/item/weapon/screwdriver/covenant,/obj/structure/table/rack,/turf/simulated/floor/covenant{icon_state = "cov_floor"},/area/om_ships/req_console_ship)
"uh" = (/turf/simulated/wall/covenant,/area/om_ships/req_console_ship)
"uI" = (/obj/machinery/organ_printer/flesh/covenant,/turf/simulated/floor/covenant{icon_state = "cov_floor"},/area/om_ships/req_console_ship)
"vx" = (/obj/structure/window/reinforced/projresist/covenant{dir = 2},/obj/structure/window/reinforced/projresist/covenant{dir = 1},/obj/structure/window/reinforced/projresist/covenant{dir = 4},/obj/structure/grille,/turf/simulated/floor/covenant{icon_state = "cov_floor"},/area/om_ships/req_console_ship)
"wf" = (/obj/machinery/deck_gun/cov_pulse_turret{dir = 2},/turf/space,/area/space)
"wP" = (/obj/structure/bed/roller/covenant,/turf/simulated/floor/covenant{icon_state = "cov_floor"},/area/om_ships/req_console_ship)
"xk" = (/obj/machinery/autosurgeon/covenant,/turf/simulated/floor/covenant{icon_state = "cov_floor"},/area/om_ships/req_console_ship)
"xw" = (/obj/machinery/bodyscanner/covenant{icon_state = "body_scanner_0"; dir = 8},/turf/simulated/floor/covenant{icon_state = "cov_floor"},/area/om_ships/req_console_ship)
"xI" = (/obj/structure/table/marble,/obj/item/weapon/storage/box/gloves,/obj/item/weapon/autopsy_scanner,/turf/simulated/floor/covenant{icon_state = "cov_floor"},/area/om_ships/req_console_ship)
"xR" = (/obj/machinery/deck_gun/cov_pulse_turret{dir = 1},/turf/space,/area/space)
"Ad" = (/obj/machinery/overmap_weapon_console/ship_scanning_console/cov,/turf/simulated/floor/covenant{icon_state = "cov_floor"},/area/om_ships/req_console_ship)
"AT" = (/obj/machinery/repulsor_engine{tag = "icon-nozzle (WEST)"; icon_state = "nozzle"; dir = 8},/obj/structure/window/reinforced/projresist/covenant{dir = 8},/turf/simulated/floor/covenant{icon_state = "cov_floor"},/area/om_ships/req_console_ship)
"Ch" = (/obj/structure/closet/crate/covenant{name = "Building Supplies"},/obj/item/stack/material/steel/fifty,/obj/item/stack/material/steel/fifty,/obj/item/stack/material/steel/fifty,/obj/item/stack/material/steel/fifty,/obj/item/stack/material/steel/fifty,/turf/simulated/floor/covenant{icon_state = "cov_floor"},/area/om_ships/req_console_ship)
"Cu" = (/obj/machinery/portable_atmospherics/canister/oxygen{canister_color = "black"; icon_state = "black"; name = "\improper Covenant Canister: \[O2]"; start_pressure = 7559.63},/turf/simulated/floor/covenant{icon_state = "cov_floor"},/area/om_ships/req_console_ship)
"CB" = (/obj/machinery/atmospherics/pipe/manifold4w/visible/blue,/turf/simulated/floor/covenant{icon_state = "cov_floor"},/area/om_ships/req_console_ship)
"CX" = (/obj/structure/window/reinforced/projresist/covenant{dir = 2},/obj/structure/stairs_decorative{dir = 4; icon_state = "stairs"},/turf/simulated/floor/covenant{icon_state = "cov_floor"},/area/om_ships/req_console_ship)
"DZ" = (/obj/structure/window/reinforced/projresist/covenant{dir = 1},/obj/structure/stairs_decorative{dir = 4; icon_state = "stairs"},/turf/simulated/floor/covenant{icon_state = "cov_floor"},/area/om_ships/req_console_ship)
"Ea" = (/obj/structure/bed/chair/covenant_stool{dir = 8; icon_state = "coviechair2"; name = "Shipmaster's anti-grav chair"},/turf/simulated/floor/covenant{icon_state = "cov_floor"},/area/om_ships/req_console_ship)
"Eb" = (/obj/machinery/nav_computer/covenant,/turf/simulated/floor/covenant{icon_state = "cov_floor"},/area/om_ships/req_console_ship)
"Ey" = (/obj/machinery/light/covenant/north,/turf/simulated/floor/covenant{icon_state = "cov_floor"},/area/om_ships/req_console_ship)
"EE" = (/obj/structure/window/reinforced/projresist/covenant{dir = 4},/turf/simulated/floor/covenant{icon_state = "cov_floor"},/area/om_ships/req_console_ship)
"Fa" = (/obj/machinery/light/covenant/west,/turf/simulated/floor/covenant{icon_state = "cov_floor"},/area/om_ships/req_console_ship)
"GA" = (/obj/structure/stairs_decorative{icon_state = "stairs"; dir = 8},/turf/simulated/floor/covenant{icon_state = "cov_floor"},/area/om_ships/req_console_ship)
"HA" = (/obj/machinery/telecomms/allinone{icon = 'code/modules/halo/icons/machinery/covenant/consoles.dmi'; icon_state = "covie_console"; name = "Battlenet Server Hub"; tag = "icon-covie_console_off"},/turf/simulated/floor/covenant{icon_state = "cov_floor"},/area/om_ships/req_console_ship)
"Ij" = (/obj/structure/closet/crate/covenant{name = "Building Supplies"},/obj/item/stack/material/nanolaminate/fifty,/obj/item/stack/material/nanolaminate/fifty,/obj/item/stack/material/nanolaminate/fifty,/obj/item/stack/material/nanolaminate/fifty,/obj/item/stack/material/nanolaminate/fifty,/turf/simulated/floor/covenant{icon_state = "cov_floor"},/area/om_ships/req_console_ship)
"Jb" = (/obj/structure/window/reinforced/projresist/covenant{dir = 2},/obj/structure/table/glass/purple,/obj/structure/window/reinforced/projresist/covenant{dir = 4},/obj/item/weapon/reagent_containers/dropper,/obj/item/device/reagent_scanner/adv,/turf/simulated/floor/covenant{icon_state = "cov_floor"},/area/om_ships/req_console_ship)
"Jh" = (/obj/machinery/optable,/turf/simulated/floor/covenant{icon_state = "cov_floor"},/area/om_ships/req_console_ship)
"Kd" = (/obj/structure/window/reinforced/projresist/covenant{dir = 8},/obj/structure/window/reinforced/projresist/covenant{dir = 4},/obj/structure/grille,/turf/simulated/floor/covenant{icon_state = "cov_floor"},/area/om_ships/req_console_ship)
"KL" = (/obj/machinery/computer/helm{icon = 'code/modules/halo/icons/machinery/covenant/consoles.dmi'; icon_state = "covie_nav"; icon_keyboard = ""; icon_screen = "covie_console_overlay"},/obj/structure/window/reinforced/projresist/covenant{dir = 8},/turf/simulated/floor/covenant{icon_state = "cov_floor"},/area/om_ships/req_console_ship)
"KV" = (/obj/machinery/repulsor_engine{tag = "icon-nozzle (WEST)"; icon_state = "nozzle"; dir = 8},/turf/simulated/floor/covenant{icon_state = "cov_floor"},/area/om_ships/req_console_ship)
"Lo" = (/obj/machinery/overmap_weapon_console/npc_comms_console/cov{icon_state = "covie_nav_off"},/turf/simulated/floor/covenant{icon_state = "cov_floor"},/area/om_ships/req_console_ship)
"LK" = (/obj/item/device/multitool/covenant,/obj/item/device/multitool/covenant,/obj/structure/table/rack,/turf/simulated/floor/covenant{icon_state = "cov_floor"},/area/om_ships/req_console_ship)
"LX" = (/obj/structure/table/marble,/obj/item/weapon/storage/firstaid/surgery,/obj/item/weapon/reagent_containers/spray/cleaner{desc = "Someone has crossed out the Space from Space Cleaner and written in Surgery. 'Do not remove under punishment of death!!!' is scrawled on the back."; name = "Surgery Cleaner"},/obj/machinery/light/covenant/south,/turf/simulated/floor/covenant{icon_state = "cov_floor"},/area/om_ships/req_console_ship)
"LY" = (/obj/item/weapon/wirecutters/covenant,/obj/item/weapon/wirecutters/covenant,/obj/structure/table/rack,/turf/simulated/floor/covenant{tag = "icon-cov_floor"; icon_state = "cov_floor"},/area/om_ships/req_console_ship)
"Mu" = (/obj/structure/closet/walllocker/emerglocker/covvie/north,/turf/simulated/floor/covenant{icon_state = "cov_floor"},/area/om_ships/req_console_ship)
"Nd" = (/obj/structure/table/glass/purple,/obj/item/weapon/storage/firstaid/fire/covenant,/obj/item/weapon/storage/firstaid/fire/covenant,/obj/item/weapon/storage/firstaid/fire/covenant,/obj/item/weapon/storage/firstaid/fire/covenant,/obj/item/weapon/storage/firstaid/o2/covenant,/obj/item/weapon/storage/firstaid/o2/covenant,/obj/item/weapon/storage/firstaid/o2/covenant,/obj/item/weapon/storage/firstaid/o2/covenant,/obj/item/weapon/storage/firstaid/toxin/covenant,/obj/item/weapon/storage/firstaid/toxin/covenant,/obj/item/weapon/storage/firstaid/toxin/covenant,/obj/item/weapon/storage/firstaid/toxin/covenant,/turf/simulated/floor/covenant{icon_state = "cov_floor"},/area/om_ships/req_console_ship)
"Nk" = (/obj/item/weapon/wrench/covenant,/obj/item/weapon/wrench/covenant,/obj/structure/table/rack,/turf/simulated/floor/covenant{tag = "icon-cov_floor"; icon_state = "cov_floor"},/area/om_ships/req_console_ship)
"NM" = (/obj/structure/closet/secure_closet/freezer/kitchen{icon = 'code/modules/halo/icons/storage/covenant/crate.dmi'; icon_broken = "Covie Crate Closed"; icon_closed = "Covie Crate Closed"; icon_locked = "Covie Crate Closed"; icon_off = "Covie Crate Closed"; icon_opened = "Covie Crate Open"; icon_state = "Covie Crate Closed"},/turf/simulated/floor/covenant{icon_state = "cov_floor"},/area/om_ships/req_console_ship)
"OV" = (/obj/item/weapon/crowbar/covenant,/obj/item/weapon/crowbar/covenant,/obj/structure/table/rack,/turf/simulated/floor/covenant{tag = "icon-cov_floor"; icon_state = "cov_floor"},/area/om_ships/req_console_ship)
"Pu" = (/obj/structure/window/reinforced/projresist/covenant{dir = 2},/obj/structure/window/reinforced/projresist/covenant{dir = 8},/obj/machinery/chemical_dispenser/full/covenant,/turf/simulated/floor/covenant{icon_state = "cov_floor"},/area/om_ships/req_console_ship)
"Rf" = (/obj/machinery/iv_drip,/turf/simulated/floor/covenant{icon_state = "cov_floor"},/area/om_ships/req_console_ship)
"Rr" = (/obj/docking_umbilical/covenant/north,/turf/simulated/floor/covenant{icon_state = "cov_floor"},/area/om_ships/req_console_ship)
"RL" = (/obj/machinery/light/covenant/south,/obj/machinery/sleeper/covenant{icon_state = "sleeper_0"; dir = 1},/turf/simulated/floor/covenant{icon_state = "cov_floor"},/area/om_ships/req_console_ship)
"SR" = (/obj/machinery/computer/helm{icon = 'code/modules/halo/icons/machinery/covenant/consoles.dmi'; icon_state = "covie_nav"; icon_keyboard = ""; icon_screen = "covie_console_overlay"},/turf/simulated/floor/covenant{icon_state = "cov_floor"},/area/om_ships/req_console_ship)
"Tk" = (/obj/structure/table/glass/purple,/obj/item/weapon/storage/firstaid/adv,/obj/item/weapon/storage/firstaid/adv,/obj/item/weapon/storage/firstaid/adv,/obj/item/weapon/storage/firstaid/adv,/obj/item/weapon/storage/firstaid/combat/unsc/cov,/obj/item/weapon/storage/firstaid/combat/unsc/cov,/turf/simulated/floor/covenant{icon_state = "cov_floor"},/area/om_ships/req_console_ship)
"TE" = (/obj/machinery/light/covenant/east,/obj/machinery/atmospherics/portables_connector{dir = 8},/obj/machinery/portable_atmospherics/canister/oxygen{canister_color = "black"; icon_state = "black"; name = "\improper Covenant Canister: \[O2]"; start_pressure = 7559.63},/turf/simulated/floor/covenant{icon_state = "cov_floor"},/area/om_ships/req_console_ship)
"Ue" = (/obj/structure/window/reinforced/projresist/covenant{dir = 1},/obj/structure/window/reinforced/projresist/covenant{dir = 8},/obj/machinery/chem_master/covenant,/turf/simulated/floor/covenant{icon_state = "cov_floor"},/area/om_ships/req_console_ship)
"Vz" = (/obj/structure/window/reinforced/projresist/covenant{dir = 1},/obj/structure/table/glass/purple,/obj/structure/window/reinforced/projresist/covenant{dir = 4},/obj/item/weapon/storage/box/syringes,/obj/item/weapon/storage/box/pillbottles,/obj/item/weapon/hand_labeler,/turf/simulated/floor/covenant{icon_state = "cov_floor"},/area/om_ships/req_console_ship)
"Wm" = (/obj/machinery/vending/armory/covenant/general/food,/turf/simulated/floor/covenant{icon_state = "cov_floor"},/area/om_ships/req_console_ship)
"Wn" = (/obj/structure/window/reinforced/projresist/covenant{dir = 1},/obj/structure/window/reinforced/projresist/covenant{dir = 8},/obj/structure/grille,/turf/simulated/floor/covenant{icon_state = "cov_floor"},/area/om_ships/req_console_ship)
"WB" = (/obj/structure/window/reinforced/projresist/covenant{dir = 1},/turf/simulated/floor/covenant{icon_state = "cov_floor"},/area/om_ships/req_console_ship)
"Xj" = (/obj/machinery/atmospherics/unary/cryo_cell/covenant,/turf/simulated/floor/covenant{icon_state = "cov_floor"},/area/om_ships/req_console_ship)
"Xo" = (/obj/machinery/light/covenant/east,/turf/simulated/floor/covenant{icon_state = "cov_floor"},/area/om_ships/req_console_ship)
"XJ" = (/obj/machinery/light/covenant/north,/mob/living/bot/cleanbot/covenant,/turf/simulated/floor/covenant{icon_state = "cov_floor"},/area/om_ships/req_console_ship)
"Yh" = (/obj/structure/closet/walllocker/emerglocker/covvie/south,/turf/simulated/floor/covenant{icon_state = "cov_floor"},/area/om_ships/req_console_ship)
"Zm" = (/obj/item/weapon/crowbar/covenant,/obj/item/weapon/crowbar/covenant,/obj/structure/table/rack,/turf/simulated/floor/covenant{icon_state = "cov_floor"},/area/om_ships/req_console_ship)
"ZD" = (/obj/item/device/multitool/covenant,/obj/item/device/multitool/covenant,/obj/structure/table/rack,/turf/simulated/floor/covenant{tag = "icon-cov_floor"; icon_state = "cov_floor"},/area/om_ships/req_console_ship)
"ZM" = (/obj/structure/window/reinforced/projresist/covenant{dir = 8},/obj/structure/table/glass/purple,/obj/machinery/reagentgrinder,/obj/item/stack/material/phoron{amount = 10000},/obj/item/stack/material/phoron{amount = 10000},/obj/item/stack/material/phoron{amount = 10000},/obj/item/stack/material/phoron{amount = 10000},/obj/item/weapon/storage/box/beakers,/turf/simulated/floor/covenant{icon_state = "cov_floor"},/area/om_ships/req_console_ship)

(1,1,1) = {"
aaaaaaaaaaaaaaaaaaaaaaaaaaaaaaaaaaaaaaaaaaaaaaaaaaaaaaaaaaaaaaaaaaaaaaaaaaaaaaaaaaaaaaaaaaaaaaaaaaaa
aaaaaaaaaaaaaaaaaaaaaaaaaaaaaaaaaaaaaaaaaaaaaaaaaaaaaaaaaaaaaaaaaaaaaaaaaaaaaaaaaaaaaaaaaaaaaaaaaaaa
aaaaaaaaaaaaaaaaaaaaaaaaaanbaaininaaaaaainininininininininaaaaaaaaaaaaaaaaaaaaaaaaaaaaaaaaaaaaaaaaaa
aaaaaaaaaaaaaaaaaaaaaanbaainininaaxRininininininininininininininaaaaaaaaaaaaaaaaaaaaaaaaaaaaaaaaaaaa
aaaaaaaaaaaaaaaanbaainininininaaaainininininjmRrjminininininininininaaaaaaaaaaaaaaaaaaaaaaaaaaaaaaaa
aaaaaaaaaanbaainininininaaaaaaaaaainininxIuhjmjmjmuhCuCuCumWouininininaaaaaaaaaaaaaaaaaaaaaaaaaaaaaa
aaaaaaaainininininaaaaaaaaaaaaaainininjmjmrajmjmjmrajmpGjmjmjmjmjmininininaaaaaaaaaaaaaaaaaaaaaaaaaa
aaaaaainininaaaaaaaaaaaaaaaaininininuhJhLXuhFajmXouhuhuhuhuhuhuhjmjminininininininaaaaaaaaaaaaaaaaaa
aaaaaaininininininininininininininuhuhuhuhuhjmjmjmuhxwqkkJskTkuhpGjmrajminininininininininininaaaaaa
aaaaaainuhuhuhuhuhuhuhuhuhuhininuhNMkmgXgwuhuhrauhuhjmjmjmjmNduhuhuhuhjmigueLYNkinininininininaaaaaa
aaaaWnefuhHAuhuhjmjmjmEyjmjmjmuhjmjmjmjmjmjmuhjmjmEyjmjmjmjmjmjmrajmjmjmjmjmjmjmjmjmjmpGEEKVaaaaaaaa
aaaaKdAdEyjmMuuhjmCXWBWBWBGAjmuhFappppppppjmrajmUeVzuIjmjmjmdzjmuhZmLKjmpKjmChaxIjuhrauhuhuhaaaaaaaa
aaaaKdSREajmjmrajmKLEapperjmjmrajmjjjjjjjjXouhFaZMppjmjmjmXjCBTEuhuhuhrauhrauhuhuhuhFaATaaaaaaaaaaaa
aaaaKdLopGjmYhuhjmDZqyqyqyGAjmuhFappppppppjmrajmPuJbrPjmjmjmbSjmuhOVZDjmXJjmChaxIjuhrauhuhuhaaaaaaaa
aaaakgvxuhEbuhuhjmjmjmpGjmjmjmuhjmjmjmjmjmjmuhjmjmpGjmjmjmjmjmjmrajmjmjmjmjmjmjmjmjmjmEyEEKVaaaaaaaa
aaaaaainininininininininininininuhtqjbWmWmuhuhrauhuhwPwPjmjmjmuhuhuhuhjmigueLYNkinininininininaaaaaa
aaaaaaininininininininininininininuhuhuhuhuhjmjmjmuhRfRfRLxkjmuhEyjmrajminininininininininininaaaaaa
aaaaaainininaaaaaaaaaaaaaaaaininininuhJhmpinFajmXoinuhuhuhuhuhuhjmjminininininininaaaaaaaaaaaaaaaaaa
aaaaaaaainininininaaaaaaaaaaaaaainininjmjmrajmjmjmrajmEyjmjmjmjmjmininininaaaaaaaaaaaaaaaaaaaaaaaaaa
aaaaaaaaaanbaainininininaaaaaaaaaainininxIinjmjmjminCuCuCueEdZininininaaaaaaaaaaaaaaaaaaaaaaaaaaaaaa
aaaaaaaaaaaaaaaanbaainininininaaaainininininjmsmjminininininininininaaaaaaaaaaaaaaaaaaaaaaaaaaaaaaaa
aaaaaaaaaaaaaaaaaaaaaanbaainininaaaaininininininininininininininaaaaaaaaaaaaaaaaaaaaaaaaaaaaaaaaaaaa
aaaaaaaaaaaaaaaaaaaaaaaaaanbaaininwfaaaainininininininininaaaaaaaaaaaaaaaaaaaaaaaaaaaaaaaaaaaaaaaaaa
aaaaaaaaaaaaaaaaaaaaaaaaaaaaaaaaaaaaaaaaaaaaaaaaaaaaaaaaaaaaaaaaaaaaaaaaaaaaaaaaaaaaaaaaaaaaaaaaaaaa
aaaaaaaaaaaaaaaaaaaaaaaaaaaaaaaaaaaaaaaaaaaaaaaaaaaaaaaaaaaaaaaaaaaaaaaaaaaaaaaaaaaaaaaaaaaaaaaaaaaa
"}

