"aa" = (/turf/space,/area/space)
"ab" = (/turf/simulated/wall/covenant/reinforced,/area/om_ships/req_console_ship)
"ac" = (/turf/simulated/floor/covenant{icon_state = "cov_floor"},/area/om_ships/req_console_ship)
"ad" = (/obj/structure/window/reinforced/projresist/covenant{dir = 8},/obj/structure/window/reinforced/projresist/covenant{dir = 1},/obj/machinery/mac_cannon/capacitor/energy_projector,/turf/simulated/floor/covenant{icon_state = "cov_floor"},/area/om_ships/req_console_ship)
"ae" = (/obj/structure/window/reinforced/projresist/covenant{dir = 1},/obj/machinery/mac_cannon/capacitor/energy_projector,/turf/simulated/floor/covenant{icon_state = "cov_floor"},/area/om_ships/req_console_ship)
"af" = (/obj/structure/window/reinforced/projresist/covenant{dir = 4},/obj/structure/window/reinforced/projresist/covenant{dir = 1},/obj/machinery/mac_cannon/capacitor/energy_projector,/turf/simulated/floor/covenant{icon_state = "cov_floor"},/area/om_ships/req_console_ship)
"ag" = (/obj/structure/window/reinforced/projresist/covenant{dir = 8},/obj/machinery/mac_cannon/capacitor/energy_projector,/turf/simulated/floor/covenant{icon_state = "cov_floor"},/area/om_ships/req_console_ship)
"ah" = (/obj/machinery/mac_cannon/accelerator/energy_projector,/turf/simulated/floor/covenant{icon_state = "cov_floor"},/area/om_ships/req_console_ship)
"ai" = (/obj/structure/window/reinforced/projresist/covenant{dir = 4},/obj/machinery/mac_cannon/capacitor/energy_projector,/turf/simulated/floor/covenant{icon_state = "cov_floor"},/area/om_ships/req_console_ship)
"aj" = (/obj/structure/window/reinforced/projresist/covenant{dir = 8},/obj/structure/window/reinforced/projresist/covenant{dir = 2},/obj/machinery/mac_cannon/capacitor/energy_projector,/turf/simulated/floor/covenant{icon_state = "cov_floor"},/area/om_ships/req_console_ship)
"ak" = (/obj/structure/window/reinforced/projresist/covenant{dir = 2},/obj/machinery/mac_cannon/capacitor/energy_projector,/turf/simulated/floor/covenant{icon_state = "cov_floor"},/area/om_ships/req_console_ship)
"al" = (/obj/structure/window/reinforced/projresist/covenant{dir = 4},/obj/structure/window/reinforced/projresist/covenant{dir = 2},/obj/machinery/mac_cannon/capacitor/energy_projector,/turf/simulated/floor/covenant{icon_state = "cov_floor"},/area/om_ships/req_console_ship)
"am" = (/turf/simulated/wall/covenant,/area/om_ships/req_console_ship)
"an" = (/obj/machinery/light/covenant/south,/turf/simulated/floor/covenant{icon_state = "cov_floor"},/area/om_ships/req_console_ship)
"ao" = (/obj/machinery/overmap_weapon_console/mac/orbital_bombard/energy_projector,/turf/simulated/floor/covenant{icon_state = "cov_floor"},/area/om_ships/req_console_ship)
"ap" = (/obj/machinery/overmap_weapon_console/mac/energy_projector,/turf/simulated/floor/covenant{icon_state = "cov_floor"},/area/om_ships/req_console_ship)
"aq" = (/obj/machinery/mac_cannon/ammo_loader/energy_projector,/turf/simulated/floor/covenant{icon_state = "cov_floor"},/area/om_ships/req_console_ship)
"ar" = (/obj/machinery/door/airlock/covenant/cov_ship_preset,/turf/simulated/floor/covenant{icon_state = "cov_floor"},/area/om_ships/req_console_ship)
"as" = (/obj/structure/closet/secure_closet/freezer/kitchen{icon = 'code/modules/halo/icons/storage/covenant/crate.dmi'; icon_broken = "Covie Crate Closed"; icon_closed = "Covie Crate Closed"; icon_locked = "Covie Crate Closed"; icon_off = "Covie Crate Closed"; icon_opened = "Covie Crate Open"; icon_state = "Covie Crate Closed"},/turf/simulated/floor/covenant{icon_state = "cov_floor"},/area/om_ships/req_console_ship)
"at" = (/obj/machinery/cooker/grill{color = "#ff99ff"},/turf/simulated/floor/covenant{icon_state = "cov_floor"},/area/om_ships/req_console_ship)
"au" = (/obj/machinery/cooker/fryer{color = "#ff99ff"},/turf/simulated/floor/covenant{icon_state = "cov_floor"},/area/om_ships/req_console_ship)
"av" = (/obj/machinery/cooker/oven{color = "#ff99ff"},/turf/simulated/floor/covenant{icon_state = "cov_floor"},/area/om_ships/req_console_ship)
"aw" = (/obj/docking_umbilical/covenant/north,/turf/simulated/floor/covenant{icon_state = "cov_floor"},/area/om_ships/req_console_ship)
"ax" = (/obj/item/weapon/weldingtool/covenant,/obj/item/weapon/weldingtool/covenant,/obj/structure/table/rack,/turf/simulated/floor/covenant{tag = "icon-cov_floor"; icon_state = "cov_floor"},/area/om_ships/req_console_ship)
"ay" = (/obj/item/weapon/screwdriver/covenant,/obj/item/weapon/screwdriver/covenant,/obj/structure/table/rack,/turf/simulated/floor/covenant{icon_state = "cov_floor"},/area/om_ships/req_console_ship)
"az" = (/obj/item/weapon/wirecutters/covenant,/obj/item/weapon/wirecutters/covenant,/obj/structure/table/rack,/turf/simulated/floor/covenant{tag = "icon-cov_floor"; icon_state = "cov_floor"},/area/om_ships/req_console_ship)
"aA" = (/obj/item/weapon/wrench/covenant,/obj/item/weapon/wrench/covenant,/obj/structure/table/rack,/turf/simulated/floor/covenant{tag = "icon-cov_floor"; icon_state = "cov_floor"},/area/om_ships/req_console_ship)
"aB" = (/obj/structure/window/reinforced/projresist/covenant{dir = 1},/obj/structure/window/reinforced/projresist/covenant{dir = 8},/obj/structure/grille,/turf/simulated/floor/covenant{icon_state = "cov_floor"},/area/om_ships/req_console_ship)
"aC" = (/obj/structure/window/reinforced/projresist/covenant{dir = 1},/obj/structure/window/reinforced/projresist/covenant{dir = 2},/obj/structure/window/reinforced/projresist/covenant{dir = 4},/obj/structure/grille,/turf/simulated/floor/covenant{icon_state = "cov_floor"},/area/om_ships/req_console_ship)
"aD" = (/obj/machinery/telecomms/allinone{icon = 'code/modules/halo/icons/machinery/covenant/consoles.dmi'; icon_state = "covie_console"; name = "Battlenet Server Hub"; tag = "icon-covie_console_off"},/turf/simulated/floor/covenant{icon_state = "cov_floor"},/area/om_ships/req_console_ship)
"aE" = (/obj/machinery/light/covenant/north,/turf/simulated/floor/covenant{icon_state = "cov_floor"},/area/om_ships/req_console_ship)
"aF" = (/obj/structure/table/marble,/obj/item/weapon/storage/firstaid/unsc/cov,/obj/item/weapon/storage/firstaid/unsc/cov,/obj/item/weapon/storage/firstaid/unsc/cov,/obj/item/weapon/storage/firstaid/unsc/cov,/turf/simulated/floor/covenant{icon_state = "cov_floor"},/area/om_ships/req_console_ship)
"aG" = (/obj/structure/table/marble,/obj/item/bodybag/cryobag/covenant,/obj/item/bodybag/cryobag/covenant,/obj/item/bodybag/cryobag/covenant,/turf/simulated/floor/covenant{icon_state = "cov_floor"},/area/om_ships/req_console_ship)
"aH" = (/obj/structure/reagent_dispensers/fueltank{color = "#ff99ff"},/turf/simulated/floor/covenant{icon_state = "cov_floor"},/area/om_ships/req_console_ship)
"aI" = (/obj/item/weapon/crowbar/covenant,/obj/item/weapon/crowbar/covenant,/obj/structure/table/rack,/turf/simulated/floor/covenant{tag = "icon-cov_floor"; icon_state = "cov_floor"},/area/om_ships/req_console_ship)
"aJ" = (/obj/item/device/multitool/covenant,/obj/item/device/multitool/covenant,/obj/structure/table/rack,/turf/simulated/floor/covenant{tag = "icon-cov_floor"; icon_state = "cov_floor"},/area/om_ships/req_console_ship)
"aK" = (/obj/structure/window/reinforced/projresist/covenant{dir = 4},/turf/simulated/floor/covenant{icon_state = "cov_floor"},/area/om_ships/req_console_ship)
"aL" = (/obj/machinery/repulsor_engine{tag = "icon-nozzle (WEST)"; icon_state = "nozzle"; dir = 8},/turf/simulated/floor/covenant{icon_state = "cov_floor"},/area/om_ships/req_console_ship)
"aM" = (/obj/structure/window/reinforced/projresist/covenant{dir = 8},/obj/structure/window/reinforced/projresist/covenant{dir = 4},/obj/structure/grille,/turf/simulated/floor/covenant{icon_state = "cov_floor"},/area/om_ships/req_console_ship)
"aN" = (/obj/machinery/overmap_weapon_console/ship_scanning_console/cov,/turf/simulated/floor/covenant{icon_state = "cov_floor"},/area/om_ships/req_console_ship)
"aO" = (/obj/structure/closet/walllocker/emerglocker/covvie/north,/turf/simulated/floor/covenant{icon_state = "cov_floor"},/area/om_ships/req_console_ship)
"aP" = (/obj/structure/window/reinforced/projresist/covenant{dir = 2},/obj/structure/stairs_decorative{dir = 4; icon_state = "stairs"},/turf/simulated/floor/covenant{icon_state = "cov_floor"},/area/om_ships/req_console_ship)
"aQ" = (/obj/structure/window/reinforced/projresist/covenant{dir = 1},/turf/simulated/floor/covenant{icon_state = "cov_floor"},/area/om_ships/req_console_ship)
"aR" = (/obj/structure/window/reinforced/projresist/covenant{dir = 1},/obj/structure/bed/chair/covenant_stool,/turf/simulated/floor/covenant{icon_state = "cov_floor"},/area/om_ships/req_console_ship)
"aS" = (/obj/structure/window/reinforced/projresist/covenant{dir = 1},/obj/structure/window/reinforced/projresist/covenant{dir = 4},/obj/machinery/overmap_weapon_console/deck_gun_control/local/plastorp_control,/turf/simulated/floor/covenant{icon_state = "cov_floor"},/area/om_ships/req_console_ship)
"aT" = (/obj/machinery/light/covenant/west,/turf/simulated/floor/covenant{icon_state = "cov_floor"},/area/om_ships/req_console_ship)
"aU" = (/obj/structure/bed/chair/covenant_stool,/turf/simulated/floor/covenant{icon_state = "cov_floor"},/area/om_ships/req_console_ship)
"aV" = (/obj/structure/table/rack,/obj/item/clothing/head/welding/covenant,/obj/item/clothing/head/welding/covenant,/obj/machinery/light/covenant/east,/turf/simulated/floor/covenant{icon_state = "cov_floor"},/area/om_ships/req_console_ship)
"aW" = (/obj/machinery/light/covenant/south,/mob/living/bot/cleanbot/covenant,/turf/simulated/floor/covenant{icon_state = "cov_floor"},/area/om_ships/req_console_ship)
"aX" = (/obj/structure/closet/crate/covenant{name = "Building Supplies"},/obj/item/stack/material/steel/fifty,/turf/simulated/floor/covenant{icon_state = "cov_floor"},/area/om_ships/req_console_ship)
"aY" = (/obj/structure/closet/crate/covenant{name = "Building Supplies"},/obj/item/stack/material/glass/phoronrglass/ten,/turf/simulated/floor/covenant{icon_state = "cov_floor"},/area/om_ships/req_console_ship)
"aZ" = (/obj/structure/closet/crate/covenant{name = "Building Supplies"},/obj/item/stack/material/nanolaminate/fifty,/turf/simulated/floor/covenant{icon_state = "cov_floor"},/area/om_ships/req_console_ship)
"ba" = (/obj/machinery/computer/helm{icon = 'code/modules/halo/icons/machinery/covenant/consoles.dmi'; icon_state = "covie_nav"; icon_keyboard = ""; icon_screen = "covie_console_overlay"},/turf/simulated/floor/covenant{icon_state = "cov_floor"},/area/om_ships/req_console_ship)
"bb" = (/obj/structure/bed/chair/covenant_stool{dir = 8; icon_state = "coviechair2"; name = "Shipmaster's anti-grav chair"},/turf/simulated/floor/covenant{icon_state = "cov_floor"},/area/om_ships/req_console_ship)
"bc" = (/obj/machinery/computer/helm{icon = 'code/modules/halo/icons/machinery/covenant/consoles.dmi'; icon_state = "covie_nav"; icon_keyboard = ""; icon_screen = "covie_console_overlay"},/obj/structure/window/reinforced/projresist/covenant{dir = 8},/turf/simulated/floor/covenant{icon_state = "cov_floor"},/area/om_ships/req_console_ship)
"bd" = (/obj/structure/stairs_decorative{icon_state = "stairs"; dir = 8},/turf/simulated/floor/covenant{icon_state = "cov_floor"},/area/om_ships/req_console_ship)
"be" = (/obj/structure/table/marble,/turf/simulated/floor/covenant{icon_state = "cov_floor"},/area/om_ships/req_console_ship)
"bf" = (/obj/machinery/light/covenant/east,/turf/simulated/floor/covenant{icon_state = "cov_floor"},/area/om_ships/req_console_ship)
"bg" = (/obj/machinery/portable_atmospherics/canister/oxygen{canister_color = "black"; icon_state = "black"; name = "\improper Covenant Canister: \[O2]"; start_pressure = 7559.63},/obj/machinery/light/covenant/west,/turf/simulated/floor/covenant{icon_state = "cov_floor"},/area/om_ships/req_console_ship)
"bh" = (/obj/machinery/repulsor_engine{tag = "icon-nozzle (WEST)"; icon_state = "nozzle"; dir = 8},/obj/structure/window/reinforced/projresist/covenant{dir = 8},/turf/simulated/floor/covenant{icon_state = "cov_floor"},/area/om_ships/req_console_ship)
"bi" = (/obj/machinery/overmap_weapon_console/npc_comms_console/cov{icon_state = "covie_nav_off"},/turf/simulated/floor/covenant{icon_state = "cov_floor"},/area/om_ships/req_console_ship)
"bj" = (/obj/structure/closet/walllocker/emerglocker/covvie/south,/turf/simulated/floor/covenant{icon_state = "cov_floor"},/area/om_ships/req_console_ship)
"bk" = (/obj/structure/window/reinforced/projresist/covenant{dir = 1},/obj/structure/stairs_decorative{dir = 4; icon_state = "stairs"},/turf/simulated/floor/covenant{icon_state = "cov_floor"},/area/om_ships/req_console_ship)
"bl" = (/obj/structure/window/reinforced/projresist/covenant{dir = 2},/turf/simulated/floor/covenant{icon_state = "cov_floor"},/area/om_ships/req_console_ship)
"bm" = (/obj/structure/window/reinforced/projresist/covenant{dir = 2},/obj/structure/bed/chair/covenant_stool,/turf/simulated/floor/covenant{icon_state = "cov_floor"},/area/om_ships/req_console_ship)
"bn" = (/obj/structure/window/reinforced/projresist/covenant{dir = 2},/obj/structure/window/reinforced/projresist/covenant{dir = 4},/obj/machinery/overmap_weapon_console/deck_gun_control/local/cov_pulse_turret,/turf/simulated/floor/covenant{icon_state = "cov_floor"},/area/om_ships/req_console_ship)
"bo" = (/obj/structure/janitorialcart{color = "#ff99ff"},/obj/item/weapon/mop{color = "#ff99ff"},/obj/item/weapon/reagent_containers/glass/bucket{color = "#ff99ff"},/obj/machinery/light/covenant/east,/turf/simulated/floor/covenant{icon_state = "cov_floor"},/area/om_ships/req_console_ship)
"bp" = (/obj/machinery/light/covenant/north,/mob/living/bot/cleanbot/covenant,/turf/simulated/floor/covenant{icon_state = "cov_floor"},/area/om_ships/req_console_ship)
"bq" = (/obj/structure/window/reinforced/projresist/covenant{dir = 8},/obj/structure/window/reinforced/projresist/covenant{dir = 2},/obj/structure/grille,/turf/simulated/floor/covenant{icon_state = "cov_floor"},/area/om_ships/req_console_ship)
"br" = (/obj/structure/window/reinforced/projresist/covenant{dir = 2},/obj/structure/window/reinforced/projresist/covenant{dir = 1},/obj/structure/window/reinforced/projresist/covenant{dir = 4},/obj/structure/grille,/turf/simulated/floor/covenant{icon_state = "cov_floor"},/area/om_ships/req_console_ship)
"bs" = (/obj/machinery/nav_computer/covenant,/turf/simulated/floor/covenant{icon_state = "cov_floor"},/area/om_ships/req_console_ship)
"bt" = (/obj/structure/table/marble,/obj/item/weapon/storage/firstaid/o2/covenant,/obj/item/weapon/storage/firstaid/o2/covenant,/obj/item/weapon/storage/firstaid/o2/covenant,/obj/item/weapon/storage/firstaid/o2/covenant,/turf/simulated/floor/covenant{icon_state = "cov_floor"},/area/om_ships/req_console_ship)
"bu" = (/obj/structure/reagent_dispensers/watertank{color = "#ff99ff"},/turf/simulated/floor/covenant{icon_state = "cov_floor"},/area/om_ships/req_console_ship)
"bw" = (/obj/structure/closet/secure_closet/freezer/meat{icon = 'code/modules/halo/icons/storage/covenant/crate.dmi'; icon_broken = "Covie Crate Closed"; icon_closed = "Covie Crate Closed"; icon_locked = "Covie Crate Closed"; icon_off = "Covie Crate Closed"; icon_opened = "Covie Crate Open"; icon_state = "Covie Crate Closed"},/turf/simulated/floor/covenant{icon_state = "cov_floor"},/area/om_ships/req_console_ship)
"bx" = (/obj/machinery/vending/armory/covenant/general/food,/turf/simulated/floor/covenant{icon_state = "cov_floor"},/area/om_ships/req_console_ship)
"by" = (/obj/docking_umbilical/covenant/south,/turf/simulated/floor/covenant{icon_state = "cov_floor"},/area/om_ships/req_console_ship)
"mP" = (/obj/machinery/vending/armory/covenant/kigyar/food,/turf/simulated/floor/covenant{icon_state = "cov_floor"},/area/om_ships/req_console_ship)
"wM" = (/obj/machinery/vending/armory/covenant/jiralhanae/food,/turf/simulated/floor/covenant{icon_state = "cov_floor"},/area/om_ships/req_console_ship)
"MW" = (/obj/structure/closet/secure_closet/freezer/fridge{icon = 'code/modules/halo/icons/storage/covenant/crate.dmi'; icon_broken = "Covie Crate Closed"; icon_closed = "Covie Crate Closed"; icon_locked = "Covie Crate Closed"; icon_off = "Covie Crate Closed"; icon_opened = "Covie Crate Open"; icon_state = "Covie Crate Closed"},/obj/structure/closet/walllocker/emerglocker/covvie/north,/turf/simulated/floor/covenant{icon_state = "cov_floor"},/area/om_ships/req_console_ship)
"Sz" = (/obj/machinery/vending/armory/covenant/sangheili/food,/turf/simulated/floor/covenant{icon_state = "cov_floor"},/area/om_ships/req_console_ship)

(1,1,1) = {"
aaaaaaaaaaaaaaaaaaaaaaaaaaaaaaaaaaaaaaaaaaaaaaaaaaaaaaaaaaaaaaaaaaaaaaaaaaaaaaaaaaaaaaaaaaaaaaaaaaaa
aaaaaaaaaaaaaaaaaaaaaaaaaaaaaaaaaaaaaaaaaaaaaaaaaaaaaaaaaaaaaaaaaaaaaaaaaaaaaaaaaaaaaaaaaaaaaaaaaaaa
aaaaaaaaaaaaaaaaaaaaaaaaaaaaaaababaaaaaaabababababababababaaaaaaaaaaaaaaaaaaaaaaaaaaaaaaaaaaaaaaaaaa
aaaaaaaaaaaaaaaaaaaaaaaaaaabababaaaaababababababababababababababaaaaaaaaaaaaaaaaaaaaaaaaaaaaaaaaaaaa
aaaaaaaaaaaaaaaaaaaaabababababaaaaabababababacadaeafacabababababababaaaaaaaaaaaaaaaaaaaaaaaaaaaaaaaa
aaaaaaaaaaaaaaabababababaaaaaaaaaaababacacacacagahaiacacaOacacababababaaaaaaaaaaaaaaaaaaaaaaaaaaaaaa
aaaaaaaaabababababaaaaaaaaaaaaaaabababacacacacajakalacacacacacacabababababaaaaaaaaaaaaaaaaaaaaaaaaaa
aaaaaaabababaaaaaaaaaaaaaaaaababababamacacanacaoapaqacanacacacacacacabababababababaaaaaaaaaaaaaaaaaa
aaaaaaababababababababababababababamamamamamacacacacacamamamamamanacaracabababababababababababaaaaaa
aaaaaaabamamamamamamamamamamababamasatauavamamamaramamamacawacamamamamacaxayazaAabababababababaaaaaa
aaaaaBaCamaDamamacacacaEacacaFambwacacacacMWamaGacaHamacacacacacamaIaJacacacacacacaOacanaKaLaaaaaaaa
aaaaaMaNaEacaOamacaPaQaRaSacacamaTaUaUaUaUacaracacaVamaTacacacacaracacacaWacaXaYaZamaramamamaaaaaaaa
aaaaaMbabbacacaracbcbbacacbdacaracbebebebebfambgacacaracacacacbfamamamaramaramamamamaTbhaaaaaaaaaaaa
aaaaaMbianacbjamacbkblbmbnacacamaTaUaUaUaUacaracacboamaTacacacacaracacacbpacaXaYaZamaramamamaaaaaaaa
aaaabqbrambsamamacacacanacacbtamacacacacacbjamaGacbuamacacacacacamaIaJacacacacacacbjacaEaKaLaaaaaaaa
aaaaaaabababababababababababababambxwMSzmPamamamaramamamacbyacamamamamacaxayazaAabababababababaaaaaa
aaaaaaababababababababababababababamamamamamacacacacacamamamamamaEacaracabababababababababababaaaaaa
aaaaaaabababaaaaaaaaaaaaaaaaababababamacacaEacaoapaqacaEacacacacacacabababababababaaaaaaaaaaaaaaaaaa
aaaaaaaaabababababaaaaaaaaaaaaaaabababacacacacadaeafacacacacacacabababababaaaaaaaaaaaaaaaaaaaaaaaaaa
aaaaaaaaaaaaaaabababababaaaaaaaaaaababacacacacagahaiacacbjacacababababaaaaaaaaaaaaaaaaaaaaaaaaaaaaaa
aaaaaaaaaaaaaaaaaaaaabababababaaaaabababababacajakalacabababababababaaaaaaaaaaaaaaaaaaaaaaaaaaaaaaaa
aaaaaaaaaaaaaaaaaaaaaaaaaaabababaaaaababababababababababababababaaaaaaaaaaaaaaaaaaaaaaaaaaaaaaaaaaaa
aaaaaaaaaaaaaaaaaaaaaaaaaaaaaaababaaaaaaabababababababababaaaaaaaaaaaaaaaaaaaaaaaaaaaaaaaaaaaaaaaaaa
aaaaaaaaaaaaaaaaaaaaaaaaaaaaaaaaaaaaaaaaaaaaaaaaaaaaaaaaaaaaaaaaaaaaaaaaaaaaaaaaaaaaaaaaaaaaaaaaaaaa
aaaaaaaaaaaaaaaaaaaaaaaaaaaaaaaaaaaaaaaaaaaaaaaaaaaaaaaaaaaaaaaaaaaaaaaaaaaaaaaaaaaaaaaaaaaaaaaaaaaa
"}

