"aa" = (/turf/space,/area/space)
"ab" = (/obj/machinery/door/airlock/halo_maint/innie_ship_preset,/turf/simulated/floor/plating,/area/om_ships/req_console_ship)
"ac" = (/turf/simulated/floor/shuttle/black,/area/om_ships/req_console_ship)
"ad" = (/obj/structure/closet/crate/large{icon_state = "secgearcrate"; name = "Metal Crate"; tag = "icon-secgearcrate"},/obj/item/stack/material/steel/fifty,/turf/simulated/floor/shuttle/black,/area/om_ships/req_console_ship)
"ae" = (/obj/structure/table/rack,/obj/item/clothing/head/welding,/obj/item/clothing/head/welding,/turf/simulated/floor/shuttle/black,/area/om_ships/req_console_ship)
"af" = (/obj/structure/reagent_dispensers/fueltank,/turf/simulated/floor/shuttle/black,/area/om_ships/req_console_ship)
"ag" = (/obj/structure/closet/emcloset/legacy,/turf/simulated/floor/shuttle/black,/area/om_ships/req_console_ship)
"ah" = (/obj/structure/closet/emcloset/legacy,/turf/simulated/floor/shuttle/darkred,/area/om_ships/req_console_ship)
"ai" = (/obj/machinery/light{dir = 1},/turf/simulated/floor/shuttle/darkred,/area/om_ships/req_console_ship)
"aj" = (/turf/simulated/floor/shuttle/darkred,/area/om_ships/req_console_ship)
"ak" = (/obj/machinery/door/airlock/halo/innie_ship_preset,/turf/simulated/floor/shuttle/darkred,/area/om_ships/req_console_ship)
"al" = (/obj/machinery/door/airlock/halo/innie_ship_preset,/turf/simulated/floor/plating,/area/om_ships/req_console_ship)
"am" = (/obj/structure/closet/secure_closet/freezer/kitchen,/turf/simulated/floor/shuttle/black,/area/om_ships/req_console_ship)
"an" = (/obj/structure/closet/secure_closet/freezer/meat,/turf/simulated/floor/shuttle/black,/area/om_ships/req_console_ship)
"ao" = (/obj/structure/closet/secure_closet/freezer/fridge,/obj/structure/sink/kitchen{dir = 2; pixel_x = 16; pixel_y = 22},/turf/simulated/floor/shuttle/black,/area/om_ships/req_console_ship)
"ap" = (/obj/machinery/cooker/grill,/turf/simulated/floor/shuttle/black,/area/om_ships/req_console_ship)
"aq" = (/obj/machinery/cooker/fryer,/turf/simulated/floor/shuttle/black,/area/om_ships/req_console_ship)
"ar" = (/obj/machinery/cooker/oven,/turf/simulated/floor/shuttle/black,/area/om_ships/req_console_ship)
"as" = (/obj/docking_umbilical/north,/turf/simulated/floor/shuttle/black,/area/om_ships/req_console_ship)
"at" = (/obj/machinery/light{dir = 8},/turf/simulated/floor/shuttle/black,/area/om_ships/req_console_ship)
"au" = (/obj/machinery/door/airlock/halo_maint/innie_ship_preset,/turf/simulated/floor/shuttle/black,/area/om_ships/req_console_ship)
"av" = (/obj/machinery/light{dir = 1},/turf/simulated/floor/shuttle/black,/area/om_ships/req_console_ship)
"aw" = (/obj/machinery/door/airlock/halo/innie_ship_preset,/turf/simulated/floor/shuttle/black,/area/om_ships/req_console_ship)
"ax" = (/obj/machinery/telecomms/relay/long_range_emergency,/turf/simulated/floor/shuttle/black,/area/om_ships/req_console_ship)
"ay" = (/obj/machinery/overmap_weapon_console/npc_comms_console/unsc{dir = 8; germ_level = 110; icon = 'code/modules/halo/icons/machinery/computer.dmi'; icon_state = "nav"; tag = "icon-comm (NORTH)"},/obj/structure/computerframe{anchored = 1; dir = 8; icon = 'code/modules/halo/icons/machinery/computer.dmi'; icon_state = "computer"; layer = 2; level = 1; tag = "icon-computer (WEST)"},/turf/simulated/floor/shuttle/darkred,/area/om_ships/req_console_ship)
"az" = (/obj/machinery/overmap_comms/receiver,/turf/simulated/floor/shuttle/darkred,/area/om_ships/req_console_ship)
"aA" = (/obj/machinery/light{dir = 4},/turf/simulated/floor/shuttle/darkred,/area/om_ships/req_console_ship)
"aB" = (/obj/machinery/light{dir = 8},/turf/simulated/floor/shuttle/darkred,/area/om_ships/req_console_ship)
"aC" = (/obj/structure/drop_pod_launchbay,/turf/simulated/floor/shuttle/black,/area/om_ships/req_console_ship)
"aD" = (/obj/structure/drop_pod_launchbay,/obj/vehicles/drop_pod/overmap/supply_pod,/turf/simulated/floor/shuttle/black,/area/om_ships/req_console_ship)
"aE" = (/obj/vehicles/drop_pod/overmap/SOEIV,/turf/simulated/floor/shuttle/black,/area/om_ships/req_console_ship)
"aF" = (/obj/structure/bed/chair{dir = 2},/turf/simulated/floor/shuttle/black,/area/om_ships/req_console_ship)
"aG" = (/obj/machinery/door/airlock/multi_tile/halo/innie_ship_preset,/turf/simulated/floor/shuttle/black,/area/om_ships/req_console_ship)
"aH" = (/obj/machinery/light/spot{dir = 4},/turf/simulated/floor/shuttle/black,/area/om_ships/req_console_ship)
"aI" = (/obj/machinery/computer/helm{tag = "icon-nav (WEST)"; icon = 'code/modules/halo/icons/machinery/computer.dmi'; icon_state = "nav"; dir = 8; icon_keyboard = ""; icon_screen = "covie_console_overlay"},/obj/structure/computerframe{anchored = 1; dir = 8; icon = 'code/modules/halo/icons/machinery/computer.dmi'; icon_state = "computer"; layer = 2; level = 1; tag = "icon-computer (WEST)"},/turf/simulated/floor/shuttle/darkred,/area/om_ships/req_console_ship)
"aJ" = (/obj/structure/bed/chair/comfy/black{dir = 8},/turf/simulated/floor/shuttle/darkred,/area/om_ships/req_console_ship)
"aK" = (/obj/structure/bed/chair{dir = 4},/turf/simulated/floor/shuttle/darkred,/area/om_ships/req_console_ship)
"aL" = (/obj/machinery/overmap_weapon_console/deck_gun_control/local{dir = 4; icon = 'code/modules/halo/icons/machinery/computer.dmi'; icon_state = "engine"},/obj/structure/computerframe{anchored = 1; dir = 4; icon = 'code/modules/halo/icons/machinery/computer.dmi'; icon_state = "computer"; layer = 2; level = 1; tag = "icon-computer (WEST)"},/turf/simulated/floor/shuttle/darkred,/area/om_ships/req_console_ship)
"aM" = (/obj/vehicles/drop_pod/overmap/SOEIV,/obj/machinery/light{dir = 8},/turf/simulated/floor/shuttle/black,/area/om_ships/req_console_ship)
"aN" = (/obj/machinery/light{dir = 4},/turf/simulated/floor/shuttle/black,/area/om_ships/req_console_ship)
"aO" = (/obj/structure/computerframe{anchored = 1; dir = 8; icon = 'code/modules/halo/icons/machinery/computer.dmi'; icon_state = "computer"; layer = 2; level = 1; tag = "icon-computer"},/obj/structure/supply_pod_dispenser{dir = 8; germ_level = 110; icon = 'code/modules/halo/icons/machinery/computer.dmi'; icon_state = "gun"},/turf/simulated/floor/shuttle/black,/area/om_ships/req_console_ship)
"aP" = (/obj/structure/table/steel,/obj/item/drop_pod_beacon,/obj/item/drop_pod_beacon,/obj/item/drop_pod_beacon,/obj/item/drop_pod_beacon,/obj/item/drop_pod_beacon,/obj/item/drop_pod_beacon,/obj/item/drop_pod_beacon,/obj/item/drop_pod_beacon,/obj/item/drop_pod_beacon,/obj/item/drop_pod_beacon,/obj/item/drop_pod_beacon,/obj/item/drop_pod_beacon,/obj/item/drop_pod_beacon,/obj/item/drop_pod_beacon,/obj/item/drop_pod_beacon,/obj/machinery/light{dir = 4},/turf/simulated/floor/shuttle/black,/area/om_ships/req_console_ship)
"aQ" = (/obj/machinery/light/spot{dir = 8},/turf/simulated/floor/shuttle/black,/area/om_ships/req_console_ship)
"aR" = (/obj/structure/table/steel,/obj/machinery/microwave,/turf/simulated/floor/shuttle/black,/area/om_ships/req_console_ship)
"aS" = (/obj/structure/table/steel,/turf/simulated/floor/shuttle/black,/area/om_ships/req_console_ship)
"aT" = (/obj/structure/table/steel,/obj/item/weapon/paper_bin,/obj/item/weapon/pen,/turf/simulated/floor/shuttle/black,/area/om_ships/req_console_ship)
"aU" = (/obj/machinery/light/spot{dir = 4},/obj/machinery/photocopier/faxmachine{density = 0; department = "Deployed Vessel"; dir = 4; icon = 'code/modules/halo/icons/machinery/computer.dmi'; icon_state = "nav"; name = "UNSC HIGHCOM Priority Communications Line"; pixel_x = 32},/turf/simulated/floor/shuttle/black,/area/om_ships/req_console_ship)
"aV" = (/obj/machinery/light/small{dir = 4},/turf/simulated/floor/shuttle/black,/area/om_ships/req_console_ship)
"aW" = (/obj/structure/closet/crate,/obj/item/fusion_fuel,/obj/item/fusion_fuel,/obj/item/fusion_fuel,/obj/machinery/light/small{dir = 8},/turf/simulated/floor/shuttle/black,/area/om_ships/req_console_ship)
"aX" = (/obj/structure/computerframe{anchored = 1; dir = 8; icon = 'code/modules/halo/icons/machinery/computer.dmi'; icon_state = "computer"; layer = 2; level = 1; tag = "icon-computer (WEST)"},/turf/simulated/floor/shuttle/darkred,/area/om_ships/req_console_ship)
"aY" = (/obj/machinery/nav_computer/unsc,/turf/simulated/floor/shuttle/darkred,/area/om_ships/req_console_ship)
"aZ" = (/obj/structure/bed/chair{dir = 1},/turf/simulated/floor/shuttle/black,/area/om_ships/req_console_ship)
"ba" = (/obj/machinery/light{dir = 2},/turf/simulated/floor/shuttle/black,/area/om_ships/req_console_ship)
"bb" = (/obj/machinery/telecomms/relay/ship_relay,/turf/simulated/floor/shuttle/black,/area/om_ships/req_console_ship)
"bc" = (/obj/machinery/light,/turf/simulated/floor/shuttle/darkred,/area/om_ships/req_console_ship)
"bd" = (/obj/structure/table/steel,/obj/item/bodybag/cryobag,/obj/item/bodybag/cryobag,/obj/item/bodybag/cryobag,/obj/item/bodybag/cryobag,/obj/item/bodybag/cryobag,/obj/item/bodybag/cryobag,/obj/item/weapon/storage/firstaid/o2,/obj/item/weapon/storage/firstaid/o2,/obj/item/weapon/storage/firstaid/o2,/obj/item/weapon/storage/firstaid/o2,/obj/item/weapon/storage/firstaid/unsc,/obj/item/weapon/storage/firstaid/unsc,/obj/item/weapon/storage/firstaid/unsc,/obj/item/weapon/storage/firstaid/unsc,/turf/simulated/floor/shuttle/black,/area/om_ships/req_console_ship)
"be" = (/obj/machinery/vending/snack,/turf/simulated/floor/shuttle/black,/area/om_ships/req_console_ship)
"bf" = (/obj/machinery/vending/cigarette,/turf/simulated/floor/shuttle/black,/area/om_ships/req_console_ship)
"bg" = (/obj/machinery/vending/coffee,/turf/simulated/floor/shuttle/black,/area/om_ships/req_console_ship)
"bh" = (/obj/machinery/vending/cola,/turf/simulated/floor/shuttle/black,/area/om_ships/req_console_ship)
"bi" = (/obj/machinery/vending/dinnerware,/turf/simulated/floor/shuttle/black,/area/om_ships/req_console_ship)
"bj" = (/obj/docking_umbilical/south,/turf/simulated/floor/shuttle/black,/area/om_ships/req_console_ship)
"bk" = (/obj/structure/closet/crate/large{icon_state = "secgearcrate"; name = "Metal Crate"; tag = "icon-secgearcrate"},/obj/item/stack/material/glass/fifty,/obj/item/stack/material/glass/reinforced/fifty,/turf/simulated/floor/shuttle/black,/area/om_ships/req_console_ship)
"bl" = (/obj/structure/closet/crate/trashcart,/turf/simulated/floor/shuttle/black,/area/om_ships/req_console_ship)
"bm" = (/obj/structure/reagent_dispensers/watertank,/obj/machinery/light,/turf/simulated/floor/shuttle/black,/area/om_ships/req_console_ship)
"gE" = (/obj/structure/window/reinforced/projresist{dir = 8},/obj/structure/window/reinforced/projresist{dir = 4},/obj/structure/grille,/turf/simulated/floor/plating,/area/om_ships/req_console_ship)
"hI" = (/obj/structure/window/reinforced/projresist{dir = 8},/obj/structure/window/reinforced/projresist{dir = 1},/obj/structure/grille,/turf/simulated/floor/plating,/area/om_ships/req_console_ship)
"kO" = (/obj/structure/window/reinforced/projresist,/obj/structure/window/reinforced/projresist{dir = 4},/obj/structure/grille,/turf/simulated/floor/plating,/area/om_ships/req_console_ship)
"lq" = (/obj/machinery/light{dir = 1},/turf/simulated/floor/plating,/area/om_ships/req_console_ship)
"ls" = (/turf/simulated/wall/r_wall,/area/om_ships/req_console_ship)
"nm" = (/obj/structure/janitorialcart,/obj/item/weapon/mop,/obj/item/weapon/reagent_containers/glass/bucket,/turf/simulated/floor/plating,/area/om_ships/req_console_ship)
"ny" = (/obj/vehicles/drop_pod/escape_pod/bumblebee/west,/turf/simulated/floor/plating,/area/om_ships/req_console_ship)
"nP" = (/obj/structure/cable/blue{icon_state = "0-8"},/turf/simulated/floor/plating,/area/om_ships/req_console_ship)
"qk" = (/obj/machinery/overmap_weapon_console/boarding_beacon_launcher{dir = 1; icon = 'code/modules/halo/icons/machinery/computer.dmi'; icon_state = "gun"; tag = "icon-gun"},/obj/structure/computerframe{anchored = 1; dir = 1; icon = 'code/modules/halo/icons/machinery/computer.dmi'; icon_state = "computer"; layer = 2; level = 1; tag = "icon-computer"},/obj/machinery/light{dir = 2},/turf/simulated/floor/plating,/area/om_ships/req_console_ship)
"qL" = (/obj/machinery/portable_atmospherics/canister/oxygen,/turf/simulated/floor/plating,/area/om_ships/req_console_ship)
"qX" = (/turf/simulated/wall,/area/om_ships/req_console_ship)
"ru" = (/obj/structure/lattice,/turf/space,/area/space)
"rZ" = (/obj/structure/window/reinforced/projresist{dir = 8},/obj/structure/window/reinforced/projresist{dir = 4},/obj/structure/window/reinforced/projresist{dir = 1},/obj/structure/grille,/turf/simulated/floor/plating,/area/om_ships/req_console_ship)
"sh" = (/obj/machinery/fusion_thruster/fueled{dir = 8},/obj/structure/window/reinforced/projresist{dir = 8},/turf/simulated/floor/plating,/area/om_ships/req_console_ship)
"tH" = (/obj/machinery/deck_gun{dir = 8; icon_state = "deck_gun"},/turf/space,/area/space)
"vo" = (/obj/structure/window/reinforced/projresist{dir = 4},/obj/structure/window/reinforced/projresist{dir = 1},/obj/structure/grille,/turf/simulated/floor/plating,/area/om_ships/req_console_ship)
"yP" = (/obj/machinery/overmap_weapon_console/boarding_beacon_launcher{tag = "icon-gun"; icon = 'code/modules/halo/icons/machinery/computer.dmi'; icon_state = "gun"},/obj/structure/computerframe{anchored = 1; icon = 'code/modules/halo/icons/machinery/computer.dmi'; icon_state = "computer"; layer = 2; level = 1; tag = "icon-computer"},/obj/machinery/light{dir = 1},/turf/simulated/floor/plating,/area/om_ships/req_console_ship)
"CY" = (/obj/machinery/power/fusion_drive_simple,/obj/structure/cable/blue{icon_state = "0-4"},/turf/simulated/floor/plating,/area/om_ships/req_console_ship)
"Di" = (/obj/structure/window/reinforced/projresist{dir = 8},/obj/structure/window/reinforced/projresist,/obj/structure/grille,/turf/simulated/floor/plating,/area/om_ships/req_console_ship)
"Fc" = (/turf/simulated/floor/plating,/area/om_ships/req_console_ship)
"Gu" = (/obj/structure/window/reinforced/projresist{dir = 8},/obj/structure/window/reinforced/projresist,/obj/structure/window/reinforced/projresist{dir = 4},/obj/structure/grille,/turf/simulated/floor/plating,/area/om_ships/req_console_ship)
"GM" = (/obj/effect/hull_segment,/turf/simulated/wall,/area/om_ships/req_console_ship)
"GV" = (/obj/structure/drop_pod_launchbay,/turf/simulated/floor/plating,/area/om_ships/req_console_ship)
"IL" = (/obj/machinery/light,/turf/simulated/floor/plating,/area/om_ships/req_console_ship)
"SW" = (/obj/structure/drop_pod_launchbay,/obj/vehicles/drop_pod/overmap/boarding_pod/west,/turf/simulated/floor/plating,/area/om_ships/req_console_ship)
"TP" = (/obj/structure/drop_pod_launchbay,/obj/vehicles/drop_pod/overmap/boarding_pod/east,/turf/simulated/floor/plating,/area/om_ships/req_console_ship)
"UQ" = (/obj/machinery/light/small{dir = 8},/turf/simulated/floor/plating,/area/om_ships/req_console_ship)
"WL" = (/obj/machinery/vending/tool,/obj/machinery/light{dir = 8},/turf/simulated/floor/plating,/area/om_ships/req_console_ship)
"Yc" = (/obj/machinery/light{dir = 8},/obj/structure/table/steel_reinforced,/obj/item/weapon/reagent_containers/spray/cleaner,/obj/item/weapon/reagent_containers/spray/cleaner,/turf/simulated/floor/plating,/area/om_ships/req_console_ship)

(1,1,1) = {"
aaaaaaaaaaaaaaaaaaaaaaaaaaaaaaaaaaaaaaaaaaaaaaaaaaaaaaaaaaaaaaaaaaaaaaaaaaaaaaaaaaaaaaaaaaaaaaaaaaaaaaaaaaaaaaaaaaaaaaaaaaaaaaaaaaaaaaaaaaaaaaaaaaaaaa
aaaaaaaaaaaaaaaaaaaaaaaaaaaaaaaaaaaaaaaaaaaaaaaaaaaaaaaaaaaaaaaaaaaaaaaaaaaaaaaaaaaaaaaaaaaaaaaaaaaaaaaaaaaaaaaaaaaaaaaaaaaaaaaaaaaaaaaaaaaaaaaaaaaaaa
aaaaaaaaaaaaaaaaaaaaaaaaaaaaaaaaaaaaaaaaaaaaaaaaaaaaaaaaaaaaaaaaaaaaaaaaaaaaaaaaaaaaaaaaaaaaaaaaaaaaaaaaaaaaaaaaaaaaaaaaaaaaaaaaaaaaaaaaaaaaaaaaaaaaaa
aaaaaaaaaaaaaaaaaaaaaaaaaaaaaaaaaaaaaaaaaaaaaaaaaaaaaaaaaaaaaaaaaaaaaaaaaaaaaaaaaaaaaaaaaaaaaaaaaaaaaaaaaaaaaaaaaaaaaaaaaaaaaaaaaaaaaaaaaaaaaaaaaaaaaa
aaaaaaaaaaaaaaaaaaaaaaaaaaaaaaaaaaaaaaaaaaaaaaaaaaaaaaaaaaaaaaaaaaaaaaaaaaaaaaaaaaaaaaaaaaaaaaaaaaaaaaaaaaaaaaaaaaaaaaaaaaaaaaaaaaaaaaaaaaaaaaaaaaaaaa
aaaaaaaaaaaaaaaaaaaaaaaaaaaaaaaaaaaaaaaaaaaaaaaaaaaaaaaaaaaaaaaaaaaaaaaaaaaaaaaaaaaaaaaaaaaaaaaaaaaaaaaaaaaaaaaaaaaaaaaaaaaaaaaaaaaaaaaaaaaaaaaaaaaaaa
aaaaaaaaaaaaaaaaaaaaaaaaaaaaaaaaaaaaaaaaaaaaaaaaaaaaaaaaaaaaaaaaaaaaaaaaaaaaaaaaaaaaaaaaaaaaaaaaaaaaaaaaaaaaaaaaaaaaaaaaaaaaaaaaaaaaaaaaaaaaaaaaaaaaaa
aaaaaaaaaaaaaaaaaaaaaaaaaaaaaaaaaaaaaaaaaaaaaaaaaaaaaaaaaaaaaaaaaaaaaaaaaaaaaaaaaaaaaaaaaaaaaaaaaaaaaaaaaaaaaaaaaaaaaaaaaaaaaaaaaaaaaaaaaaaaaaaaaaaaaa
aaaaaaaaaaaaaaaaaaaaaaaaaaaaaaaaaaaaaaaaaaaaaaaaaaaaaaaaaaaaaaaaaaaaaaaaaaaaaaaaaaaaaaaaaaaaaaaaaaaaaaaaaaaaaaaaaaaaaaaaaaaaaaaaaaaaaaaaaaaaaaaaaaaaaa
aaaaaaaaaaaaaaaaaaaaaaaaaaaaaaaaaaaaaaaaaaaaaaaaaaaaaaaaaaaaaaaaaaaaaaaaaaaaaaaaaaaaaaaaaaaaaaaaaaaaaaaaaaaaaaaaaaaaaaaaaaaaaaaaaaaaaaaaaaaaaaaaaaaaaa
aaaaaaaaaaaaaaaaaaaaaaaaaaaaaaaaaaaaaaaaaaaaaaaaaaaaaaaaaaaaaaaaaaaaaaaaaaaaaaaaaaaaaaaaaaaaaaaaaaaaaaaaaaaaaaaaaaaaaaaaaaaaaaaaaaaaaaaaaaaaaaaaaaaaaa
aaaaaaaaaaaaaaaaaaaaaaaaaaaaaaaaaaaaaaaaaaaaaaaaaaaaaaaaaaaaaaaaaaaaaaaaaaaaaaaaaaaaaaaaaaaaaaaatHlslslslslslslslsaaaaaaaaaaaaaaaaaaaaaaaaaaaaaaaaaaaa
aaaaaaaaaaaaaaaaaaaaaaaaaaaaaaaaaaaaaaaaaaaaaaaaaaaaaaaaaaaaaaaaaaaaaaaaaaaaaaaaaaaaaaaaaaaaaatHlslslslslslslslslslsaaaaaaaaaaaaaaaaaaaaaaaaaaaaaaaaaa
aaaaaaaaaaaaaaaaaaaaaaaaaaaaaaaaaaaaaaaaaaaaaaaatHlslslslslslslslslslsaaaaaaaaaaaaaaaalslslslslslslslslslslslslslslslsaaaaaaaaaaaaaaaaaaaaaaaaaaaaaaaa
aaaaaaaaaaaaaaaaaaaaaaaaaaaaaaaaaaaaaaaaaaaaaatHlslslslslslslslslslslslsaaaaaaaaaalslslslslslslslslslslslslslslslslslsaaaaaaaaaaaaaaaaaaaaaaaaaaaaaaaa
aaaaaaaaaaaaaaaaaaaaaaaaaaaaaatHlslslslslslslslslslslslslslslslslslslslslslslsaaaalslslslslslslslslslsFcFcFcFclslslslsaaaaaaaaaaaaaaaaaaaaaaaaaaaaaaaa
aaaaaaaaaaaaaaaaaaaaaaaaaaaaaalslslslslslslslslslslslslslslslslslslslslslslslslslslslslslslslslslslsqXnyFcFcFcqXqXlslsaaaaaaaaaaaaaaaaaaaaaaaaaaaaaaaa
aaaaaaaaaaaaaaaaaaaaaaaaaaaalslslslslslslslslslslsqXqXGVGVGVqXGVGVGVqXlslslslslslsaaaaaaaaruaaaaaaaaqXFcFcILFcqXaaruaaaaaaaaaaaaaaaaaaaaaaaaaaaaaaaaaa
aaaaaaaaaaaaaaaaaaaaaaaaaaaalslslslslslslslslslsqXqXqXSWGVGVyPTPGVGVqXqXlslslslslslsaaaaaaqXqXqXqXqXqXqXqXqXabqXqXqXqXaaaaaaaaaaaaaaaaaaaaaaaaaaaaaaaa
aaaaaaaaaaaaaaaaaaaaaaaaaaaalslslsqXqXqXqXGMqXqXqXqXqXFcFcFcFcFcFcFcqXqXqXqXqXlslslslsqXGMqXqXqXacacadaeafagacqXFcFcshaaaaaaaaaaaaaaaaaaaaaaaaaaaaaaaa
aaaaaaaaaaaaaaaaaaaaaaaaaaaarZahaiajakajajajajajqXqXqXqXqXqXalqXGMqXqXqXamanaoapaqarqXacasacqXqXatacacacacacacauFcFcshaaaaaaaaaaaaaaaaaaaaaaaaaaaaaaaa
aaaaaaaaaaaaaaaaaaaaaaaaaahIkOajajqXqXajajajajajakacacacavacacacacacacawacacacacacacacacacacacqXacaxacqXqXabqXGMWLFcshaaaaaaaaaaaaaaaaaaaaaaaaaaaaaaaa
aaaaaaaaaaaaaaaaaaaaaaaaaagEayajajqXazaAqXaBajajqXaCqXaCqXaCqXaDqXacaEqXacaFaFaFaFacaGacacacaHqXauqXauqXFcFcFcqXqLFcshaaaaaaaaaaaaaaaaaaaaaaaaaaaaaaaa
aaaaaaaaaaaaaaaaaaaaaaaaaagEaIaJaAqXqXajaIaJaKaLqXaMacaEacaEacaNaOacaPqXaQaRaSaSaTaUqXaQacacacauaVqXaWqXUQCYnPqXqXqXqXaaaaaaaaaaaaaaaaaaaaaaaaaaaaaaaa
aaaaaaaaaaaaaaaaaaaaaaaaaagEaXajajqXaYaAqXaBajajqXaCqXaCqXaCqXaDqXacaEqXacaZaZaZaZacacacacacaHqXauqXauqXFcFcFcqXnmFcshaaaaaaaaaaaaaaaaaaaaaaaaaaaaaaaa
aaaaaaaaaaaaaaaaaaaaaaaaaaDivoajajqXqXajajajajajakacacacbaacacacacacacawacacacacacacaGacacacacqXacbbacqXqXabqXGMYcFcshaaaaaaaaaaaaaaaaaaaaaaaaaaaaaaaa
aaaaaaaaaaaaaaaaaaaaaaaaaaaaGuahbcajakajajajajajqXqXqXqXqXqXalqXGMqXqXqXbdbebfbgbhbiqXacbjacqXqXatacacacacacacauFcFcshaaaaaaaaaaaaaaaaaaaaaaaaaaaaaaaa
aaaaaaaaaaaaaaaaaaaaaaaaaaaalslslsqXqXqXqXGMqXqXqXqXqXFcFcFcFcFcFcFcqXqXqXqXqXlslslslsqXGMqXqXqXacacbkblbmagacqXFcFcshaaaaaaaaaaaaaaaaaaaaaaaaaaaaaaaa
aaaaaaaaaaaaaaaaaaaaaaaaaaaalslslslslslslslslslsqXqXqXGVGVGVqkGVGVGVqXqXlslslslslslsaaaaaaqXqXqXqXqXqXqXqXqXabqXqXqXqXaaaaaaaaaaaaaaaaaaaaaaaaaaaaaaaa
aaaaaaaaaaaaaaaaaaaaaaaaaaaalslslslslslslslslslslsqXqXSWGVGVqXTPGVGVqXlslslslslslsaaaaaaaaruaaaaaaaaqXFcFclqFcqXaaruaaaaaaaaaaaaaaaaaaaaaaaaaaaaaaaaaa
aaaaaaaaaaaaaaaaaaaaaaaaaaaaaalslslslslslslslslslslslslslslslslslslslslslslslslslslslslslslslslslslsqXFcFcFcFcqXqXlslsaaaaaaaaaaaaaaaaaaaaaaaaaaaaaaaa
aaaaaaaaaaaaaaaaaaaaaaaaaaaaaatHlslslslslslslslslslslslslslslslslslslslslslslsaaaalslslslslslslslslslsnyFcFcFclslslslsaaaaaaaaaaaaaaaaaaaaaaaaaaaaaaaa
aaaaaaaaaaaaaaaaaaaaaaaaaaaaaaaaaaaaaaaaaaaaaatHlslslslslslslslslslslslsaaaaaaaaaalslslslslslslslslslslslslslslslslslsaaaaaaaaaaaaaaaaaaaaaaaaaaaaaaaa
aaaaaaaaaaaaaaaaaaaaaaaaaaaaaaaaaaaaaaaaaaaaaaaatHlslslslslslslslslslsaaaaaaaaaaaaaaaalslslslslslslslslslslslslslslslsaaaaaaaaaaaaaaaaaaaaaaaaaaaaaaaa
aaaaaaaaaaaaaaaaaaaaaaaaaaaaaaaaaaaaaaaaaaaaaaaaaaaaaaaaaaaaaaaaaaaaaaaaaaaaaaaaaaaaaaaaaaaaaatHlslslslslslslslslslsaaaaaaaaaaaaaaaaaaaaaaaaaaaaaaaaaa
aaaaaaaaaaaaaaaaaaaaaaaaaaaaaaaaaaaaaaaaaaaaaaaaaaaaaaaaaaaaaaaaaaaaaaaaaaaaaaaaaaaaaaaaaaaaaaaatHlslslslslslslslsaaaaaaaaaaaaaaaaaaaaaaaaaaaaaaaaaaaa
aaaaaaaaaaaaaaaaaaaaaaaaaaaaaaaaaaaaaaaaaaaaaaaaaaaaaaaaaaaaaaaaaaaaaaaaaaaaaaaaaaaaaaaaaaaaaaaaaaaaaaaaaaaaaaaaaaaaaaaaaaaaaaaaaaaaaaaaaaaaaaaaaaaaaa
aaaaaaaaaaaaaaaaaaaaaaaaaaaaaaaaaaaaaaaaaaaaaaaaaaaaaaaaaaaaaaaaaaaaaaaaaaaaaaaaaaaaaaaaaaaaaaaaaaaaaaaaaaaaaaaaaaaaaaaaaaaaaaaaaaaaaaaaaaaaaaaaaaaaaa
aaaaaaaaaaaaaaaaaaaaaaaaaaaaaaaaaaaaaaaaaaaaaaaaaaaaaaaaaaaaaaaaaaaaaaaaaaaaaaaaaaaaaaaaaaaaaaaaaaaaaaaaaaaaaaaaaaaaaaaaaaaaaaaaaaaaaaaaaaaaaaaaaaaaaa
aaaaaaaaaaaaaaaaaaaaaaaaaaaaaaaaaaaaaaaaaaaaaaaaaaaaaaaaaaaaaaaaaaaaaaaaaaaaaaaaaaaaaaaaaaaaaaaaaaaaaaaaaaaaaaaaaaaaaaaaaaaaaaaaaaaaaaaaaaaaaaaaaaaaaa
aaaaaaaaaaaaaaaaaaaaaaaaaaaaaaaaaaaaaaaaaaaaaaaaaaaaaaaaaaaaaaaaaaaaaaaaaaaaaaaaaaaaaaaaaaaaaaaaaaaaaaaaaaaaaaaaaaaaaaaaaaaaaaaaaaaaaaaaaaaaaaaaaaaaaa
aaaaaaaaaaaaaaaaaaaaaaaaaaaaaaaaaaaaaaaaaaaaaaaaaaaaaaaaaaaaaaaaaaaaaaaaaaaaaaaaaaaaaaaaaaaaaaaaaaaaaaaaaaaaaaaaaaaaaaaaaaaaaaaaaaaaaaaaaaaaaaaaaaaaaa
aaaaaaaaaaaaaaaaaaaaaaaaaaaaaaaaaaaaaaaaaaaaaaaaaaaaaaaaaaaaaaaaaaaaaaaaaaaaaaaaaaaaaaaaaaaaaaaaaaaaaaaaaaaaaaaaaaaaaaaaaaaaaaaaaaaaaaaaaaaaaaaaaaaaaa
aaaaaaaaaaaaaaaaaaaaaaaaaaaaaaaaaaaaaaaaaaaaaaaaaaaaaaaaaaaaaaaaaaaaaaaaaaaaaaaaaaaaaaaaaaaaaaaaaaaaaaaaaaaaaaaaaaaaaaaaaaaaaaaaaaaaaaaaaaaaaaaaaaaaaa
aaaaaaaaaaaaaaaaaaaaaaaaaaaaaaaaaaaaaaaaaaaaaaaaaaaaaaaaaaaaaaaaaaaaaaaaaaaaaaaaaaaaaaaaaaaaaaaaaaaaaaaaaaaaaaaaaaaaaaaaaaaaaaaaaaaaaaaaaaaaaaaaaaaaaa
aaaaaaaaaaaaaaaaaaaaaaaaaaaaaaaaaaaaaaaaaaaaaaaaaaaaaaaaaaaaaaaaaaaaaaaaaaaaaaaaaaaaaaaaaaaaaaaaaaaaaaaaaaaaaaaaaaaaaaaaaaaaaaaaaaaaaaaaaaaaaaaaaaaaaa
aaaaaaaaaaaaaaaaaaaaaaaaaaaaaaaaaaaaaaaaaaaaaaaaaaaaaaaaaaaaaaaaaaaaaaaaaaaaaaaaaaaaaaaaaaaaaaaaaaaaaaaaaaaaaaaaaaaaaaaaaaaaaaaaaaaaaaaaaaaaaaaaaaaaaa
aaaaaaaaaaaaaaaaaaaaaaaaaaaaaaaaaaaaaaaaaaaaaaaaaaaaaaaaaaaaaaaaaaaaaaaaaaaaaaaaaaaaaaaaaaaaaaaaaaaaaaaaaaaaaaaaaaaaaaaaaaaaaaaaaaaaaaaaaaaaaaaaaaaaaa
aaaaaaaaaaaaaaaaaaaaaaaaaaaaaaaaaaaaaaaaaaaaaaaaaaaaaaaaaaaaaaaaaaaaaaaaaaaaaaaaaaaaaaaaaaaaaaaaaaaaaaaaaaaaaaaaaaaaaaaaaaaaaaaaaaaaaaaaaaaaaaaaaaaaaa
aaaaaaaaaaaaaaaaaaaaaaaaaaaaaaaaaaaaaaaaaaaaaaaaaaaaaaaaaaaaaaaaaaaaaaaaaaaaaaaaaaaaaaaaaaaaaaaaaaaaaaaaaaaaaaaaaaaaaaaaaaaaaaaaaaaaaaaaaaaaaaaaaaaaaa
"}
