"aa" = (/turf/space,/area/space)
"ab" = (/turf/simulated/wall/r_wall,/area/om_ships/req_console_ship)
"ac" = (/obj/structure/lattice,/turf/space,/area/space)
"ad" = (/turf/simulated/floor/plating,/area/om_ships/req_console_ship)
"ae" = (/turf/simulated/wall,/area/om_ships/req_console_ship)
"af" = (/obj/vehicles/drop_pod/escape_pod/bumblebee/west,/turf/simulated/floor/plating,/area/om_ships/req_console_ship)
"ag" = (/obj/machinery/light,/turf/simulated/floor/plating,/area/om_ships/req_console_ship)
"ah" = (/obj/machinery/door/airlock/halo_maint/innie_ship_preset,/turf/simulated/floor/plating,/area/om_ships/req_console_ship)
"ai" = (/turf/simulated/wall/silver{tag = "icon-solidfwall_opening"; icon_state = "solidfwall_opening"},/area/om_ships/req_console_ship)
"aj" = (/obj/machinery/vending/tool,/turf/simulated/floor/tiled,/area/om_ships/req_console_ship)
"ak" = (/obj/machinery/portable_atmospherics/canister/oxygen,/turf/simulated/floor/tiled,/area/om_ships/req_console_ship)
"al" = (/obj/structure/closet/crate/large{icon_state = "secgearcrate"; name = "Metal Crate"; tag = "icon-secgearcrate"},/obj/item/stack/material/steel/fifty,/obj/item/stack/material/steel/fifty,/obj/item/stack/material/steel/fifty,/obj/item/stack/material/steel/fifty,/obj/item/stack/material/steel/fifty,/obj/item/stack/material/steel/fifty,/obj/item/stack/material/steel/fifty,/obj/item/stack/material/steel/fifty,/obj/item/stack/material/steel/fifty,/obj/item/stack/material/steel/fifty,/turf/simulated/floor/tiled,/area/om_ships/req_console_ship)
"am" = (/obj/structure/reagent_dispensers/fueltank,/obj/machinery/light{dir = 1},/turf/simulated/floor/tiled,/area/om_ships/req_console_ship)
"an" = (/obj/structure/closet/emcloset/legacy,/turf/simulated/floor/tiled,/area/om_ships/req_console_ship)
"ao" = (/turf/simulated/floor/tiled,/area/om_ships/req_console_ship)
"ap" = (/obj/machinery/vending/tool,/obj/machinery/light{dir = 1},/turf/simulated/floor/plating,/area/om_ships/req_console_ship)
"aq" = (/obj/machinery/fusion_thruster/fueled{dir = 8},/obj/structure/window/reinforced/projresist{dir = 8},/turf/simulated/floor/plating,/area/om_ships/req_console_ship)
"ar" = (/obj/structure/window/reinforced/projresist{dir = 8},/obj/structure/window/reinforced/projresist{dir = 4},/obj/structure/window/reinforced/projresist{dir = 1},/obj/structure/grille,/turf/simulated/floor/plating,/area/om_ships/req_console_ship)
"as" = (/obj/structure/bed/chair/comfy/black{dir = 8},/turf/simulated/floor/tiled/dark,/area/om_ships/req_console_ship)
"at" = (/obj/machinery/light{dir = 1},/turf/simulated/floor/tiled/dark,/area/om_ships/req_console_ship)
"au" = (/turf/simulated/floor/tiled/dark,/area/om_ships/req_console_ship)
"av" = (/obj/machinery/door/airlock/halo/innie_ship_preset,/turf/simulated/floor/tiled/dark,/area/om_ships/req_console_ship)
"aw" = (/turf/simulated/floor/tiled/white,/area/om_ships/req_console_ship)
"ax" = (/obj/machinery/light{dir = 1},/turf/simulated/floor/tiled/white,/area/om_ships/req_console_ship)
"ay" = (/obj/machinery/door/airlock/halo_maint/innie_ship_preset,/turf/simulated/floor/tiled/white,/area/om_ships/req_console_ship)
"az" = (/obj/machinery/iv_drip,/turf/simulated/floor/tiled/white,/area/om_ships/req_console_ship)
"aA" = (/obj/structure/table/glass/white,/obj/item/weapon/reagent_containers/blood/OMinus,/obj/item/weapon/reagent_containers/blood/OMinus,/obj/item/weapon/reagent_containers/blood/OMinus,/obj/item/weapon/storage/firstaid/unsc,/obj/item/weapon/storage/firstaid/unsc,/obj/item/weapon/storage/firstaid/unsc,/obj/item/weapon/reagent_containers/syringe/ld50_syringe/triadrenaline,/obj/item/weapon/reagent_containers/syringe/ld50_syringe/triadrenaline,/obj/item/weapon/reagent_containers/syringe/ld50_syringe/triadrenaline,/obj/item/weapon/reagent_containers/syringe/ld50_syringe/triadrenaline,/obj/item/bodybag/cryobag,/obj/item/bodybag/cryobag,/obj/item/bodybag/cryobag,/obj/item/bodybag/cryobag,/obj/item/bodybag/cryobag,/turf/simulated/floor/tiled/white,/area/om_ships/req_console_ship)
"aB" = (/obj/structure/closet/secure_closet/freezer/kitchen,/turf/simulated/floor/tiled,/area/om_ships/req_console_ship)
"aC" = (/obj/structure/closet/secure_closet/freezer/meat,/turf/simulated/floor/tiled,/area/om_ships/req_console_ship)
"aD" = (/obj/structure/closet/secure_closet/freezer/fridge,/turf/simulated/floor/tiled,/area/om_ships/req_console_ship)
"aE" = (/obj/machinery/cooker/grill,/turf/simulated/floor/tiled,/area/om_ships/req_console_ship)
"aF" = (/obj/machinery/cooker/fryer,/turf/simulated/floor/tiled,/area/om_ships/req_console_ship)
"aG" = (/obj/machinery/cooker/oven,/turf/simulated/floor/tiled,/area/om_ships/req_console_ship)
"aH" = (/obj/docking_umbilical/north,/turf/simulated/floor/tiled,/area/om_ships/req_console_ship)
"aI" = (/obj/machinery/light{dir = 8},/turf/simulated/floor/tiled,/area/om_ships/req_console_ship)
"aJ" = (/obj/structure/window/reinforced/projresist{dir = 8},/obj/structure/window/reinforced/projresist{dir = 1},/obj/structure/grille,/turf/simulated/floor/plating,/area/om_ships/req_console_ship)
"aK" = (/obj/structure/window/reinforced/projresist,/obj/structure/window/reinforced/projresist{dir = 4},/obj/structure/grille,/turf/simulated/floor/plating,/area/om_ships/req_console_ship)
"aL" = (/obj/structure/closet/emcloset/legacy,/turf/simulated/floor/tiled/dark,/area/om_ships/req_console_ship)
"aM" = (/obj/structure/closet/secure_closet/medical2,/turf/simulated/floor/tiled/white,/area/om_ships/req_console_ship)
"aN" = (/obj/structure/table/glass/white,/obj/item/weapon/storage/firstaid/fire,/obj/item/weapon/storage/firstaid/fire,/obj/item/weapon/storage/firstaid/o2,/obj/item/weapon/storage/firstaid/o2,/obj/item/weapon/storage/firstaid/toxin,/obj/item/weapon/storage/firstaid/toxin,/turf/simulated/floor/tiled/white,/area/om_ships/req_console_ship)
"aO" = (/obj/machinery/organ_printer/flesh/mapped{max_stored_matter = 1e+007},/turf/simulated/floor/tiled/white,/area/om_ships/req_console_ship)
"aP" = (/obj/structure/table/glass/white,/obj/item/weapon/storage/firstaid/combat/unsc,/obj/item/weapon/storage/firstaid/adv,/obj/item/weapon/storage/firstaid/adv,/turf/simulated/floor/tiled/white,/area/om_ships/req_console_ship)
"aQ" = (/obj/structure/bed{tag = "icon-bed2 (EAST)"; icon_state = "bed2"; dir = 4},/turf/simulated/floor/tiled/white,/area/om_ships/req_console_ship)
"aR" = (/obj/machinery/sleeper{dir = 4; icon_state = "sleeper_0"; tag = "icon-sleeper_0 (WEST)"},/turf/simulated/floor/tiled/white,/area/om_ships/req_console_ship)
"aS" = (/obj/machinery/door/airlock/halo/innie_ship_preset,/turf/simulated/floor/tiled,/area/om_ships/req_console_ship)
"aT" = (/obj/machinery/light{dir = 8},/obj/structure/table/rack,/obj/item/clothing/head/welding,/obj/item/clothing/head/welding,/turf/simulated/floor/plating,/area/om_ships/req_console_ship)
"aU" = (/obj/structure/window/reinforced/projresist{dir = 8},/obj/structure/window/reinforced/projresist{dir = 4},/obj/structure/grille,/turf/simulated/floor/plating,/area/om_ships/req_console_ship)
"aV" = (/obj/machinery/overmap_weapon_console/npc_comms_console/unsc{dir = 8; germ_level = 110; icon = 'code/modules/halo/icons/machinery/computer.dmi'; icon_state = "nav"; tag = "icon-comm (NORTH)"},/obj/structure/computerframe{anchored = 1; dir = 8; icon = 'code/modules/halo/icons/machinery/computer.dmi'; icon_state = "computer"; layer = 2; level = 1; tag = "icon-computer (WEST)"},/turf/simulated/floor/tiled/dark,/area/om_ships/req_console_ship)
"aW" = (/obj/structure/window/reinforced/projresist{dir = 1},/obj/structure/window/reinforced/projresist{dir = 8},/obj/structure/table/glass/white,/obj/item/weapon/storage/box/gloves,/obj/item/weapon/autopsy_scanner,/obj/item/weapon/storage/firstaid/surgery,/obj/item/weapon/reagent_containers/spray/cleaner{desc = "Someone has crossed out the Space from Space Cleaner and written in Surgery. 'Do not remove under punishment of death!!!' is scrawled on the back."; name = "Surgery Cleaner"},/turf/simulated/floor/tiled/white,/area/om_ships/req_console_ship)
"aX" = (/obj/structure/window/reinforced/projresist{dir = 1},/obj/machinery/optable,/turf/simulated/floor/tiled/white,/area/om_ships/req_console_ship)
"aY" = (/obj/machinery/door/window/northleft,/turf/simulated/floor/tiled/white,/area/om_ships/req_console_ship)
"aZ" = (/obj/structure/table/glass,/obj/item/device/reagent_scanner/adv,/obj/item/weapon/reagent_containers/dropper,/obj/structure/window/reinforced/projresist{dir = 1},/turf/simulated/floor/tiled/white,/area/om_ships/req_console_ship)
"ba" = (/obj/machinery/door/window/northright,/turf/simulated/floor/tiled/white,/area/om_ships/req_console_ship)
"bb" = (/obj/machinery/chemical_dispenser/full,/obj/structure/window/reinforced/projresist{dir = 1},/obj/structure/window/reinforced/projresist{dir = 4},/turf/simulated/floor/tiled/white,/area/om_ships/req_console_ship)
"bc" = (/obj/machinery/atmospherics/unary/freezer{tag = "icon-freezer_1"; icon_state = "freezer_1"; dir = 2},/turf/simulated/floor/tiled/white,/area/om_ships/req_console_ship)
"bd" = (/obj/machinery/nav_computer/unsc,/turf/simulated/floor/tiled/dark,/area/om_ships/req_console_ship)
"be" = (/obj/machinery/light/spot{dir = 8},/turf/simulated/floor/tiled,/area/om_ships/req_console_ship)
"bf" = (/obj/structure/bed/chair{dir = 2},/turf/simulated/floor/tiled,/area/om_ships/req_console_ship)
"bg" = (/obj/machinery/door/airlock/multi_tile/halo/innie_ship_preset,/turf/simulated/floor/tiled,/area/om_ships/req_console_ship)
"bh" = (/obj/machinery/light/spot{dir = 4},/turf/simulated/floor/tiled,/area/om_ships/req_console_ship)
"bi" = (/obj/machinery/door/airlock/halo_maint/innie_ship_preset,/turf/simulated/floor/tiled,/area/om_ships/req_console_ship)
"bj" = (/obj/structure/window/reinforced/projresist{dir = 1},/obj/machinery/door/window/westleft,/turf/simulated/floor/plating,/area/om_ships/req_console_ship)
"bk" = (/obj/structure/window/reinforced/projresist{dir = 4},/obj/structure/window/reinforced/projresist{dir = 1},/turf/simulated/floor/plating,/area/om_ships/req_console_ship)
"bl" = (/obj/machinery/portable_atmospherics/canister/oxygen,/turf/simulated/floor/plating,/area/om_ships/req_console_ship)
"bm" = (/obj/machinery/computer/helm{tag = "icon-nav (WEST)"; icon = 'code/modules/halo/icons/machinery/computer.dmi'; icon_state = "nav"; dir = 8; icon_keyboard = ""; icon_screen = "covie_console_overlay"},/obj/structure/computerframe{anchored = 1; dir = 8; icon = 'code/modules/halo/icons/machinery/computer.dmi'; icon_state = "computer"; layer = 2; level = 1; tag = "icon-computer (WEST)"},/turf/simulated/floor/tiled/dark,/area/om_ships/req_console_ship)
"bn" = (/obj/machinery/light{dir = 4},/turf/simulated/floor/tiled/dark,/area/om_ships/req_console_ship)
"bo" = (/obj/structure/closet/emcloset/legacy,/obj/structure/window/reinforced/projresist{dir = 1},/obj/structure/window/reinforced/projresist{dir = 8},/obj/structure/window/reinforced/projresist{dir = 2},/obj/machinery/light{dir = 8},/turf/simulated/floor/tiled/white,/area/om_ships/req_console_ship)
"bp" = (/obj/structure/bed/chair/office/light{dir = 4},/turf/simulated/floor/tiled/white,/area/om_ships/req_console_ship)
"bq" = (/obj/structure/table/glass,/obj/machinery/reagentgrinder,/obj/item/stack/material/phoron{amount = 10000},/obj/item/stack/material/phoron{amount = 10000},/obj/item/stack/material/phoron{amount = 10000},/obj/item/stack/material/phoron{amount = 10000},/obj/item/weapon/storage/box/beakers,/obj/structure/window/reinforced/projresist{dir = 4},/turf/simulated/floor/tiled/white,/area/om_ships/req_console_ship)
"br" = (/obj/machinery/autosurgeon,/turf/simulated/floor/tiled/white,/area/om_ships/req_console_ship)
"bs" = (/obj/machinery/atmospherics/portables_connector{dir = 4},/obj/machinery/portable_atmospherics/canister/oxygen,/turf/simulated/floor/tiled/white,/area/om_ships/req_console_ship)
"bt" = (/obj/machinery/atmospherics/pipe/manifold4w/visible/blue,/turf/simulated/floor/tiled/white,/area/om_ships/req_console_ship)
"bu" = (/obj/machinery/atmospherics/unary/cryo_cell,/turf/simulated/floor/tiled/white,/area/om_ships/req_console_ship)
"bv" = (/obj/structure/table/steel,/turf/simulated/floor/tiled,/area/om_ships/req_console_ship)
"bw" = (/obj/machinery/light/small{dir = 4},/turf/simulated/floor/tiled,/area/om_ships/req_console_ship)
"bx" = (/obj/structure/closet/crate,/obj/item/fusion_fuel,/obj/item/fusion_fuel,/obj/item/fusion_fuel,/obj/machinery/light/small{dir = 8},/turf/simulated/floor/tiled,/area/om_ships/req_console_ship)
"by" = (/obj/machinery/light/small{dir = 8},/turf/simulated/floor/plating,/area/om_ships/req_console_ship)
"bz" = (/obj/machinery/power/fusion_drive_simple,/obj/structure/cable/blue{icon_state = "0-4"},/turf/simulated/floor/plating,/area/om_ships/req_console_ship)
"bA" = (/obj/structure/cable/blue{icon_state = "0-8"},/turf/simulated/floor/plating,/area/om_ships/req_console_ship)
"bB" = (/obj/machinery/slipspace_engine/human,/obj/structure/window/reinforced/projresist{dir = 2},/obj/machinery/door/window/westright,/turf/simulated/floor/plating,/area/om_ships/req_console_ship)
"bC" = (/obj/structure/window/reinforced/projresist{dir = 2},/obj/structure/window/reinforced/projresist{dir = 4},/turf/simulated/floor/plating,/area/om_ships/req_console_ship)
"bD" = (/obj/structure/computerframe{anchored = 1; dir = 8; icon = 'code/modules/halo/icons/machinery/computer.dmi'; icon_state = "computer"; layer = 2; level = 1; tag = "icon-computer (WEST)"},/turf/simulated/floor/tiled/dark,/area/om_ships/req_console_ship)
"bE" = (/obj/structure/window/reinforced/projresist{dir = 2},/obj/structure/window/reinforced/projresist{dir = 8},/obj/structure/table/glass/white,/obj/item/weapon/storage/box/gloves,/obj/item/weapon/autopsy_scanner,/obj/item/weapon/storage/firstaid/surgery,/obj/item/weapon/reagent_containers/spray/cleaner{desc = "Someone has crossed out the Space from Space Cleaner and written in Surgery. 'Do not remove under punishment of death!!!' is scrawled on the back."; name = "Surgery Cleaner"},/turf/simulated/floor/tiled/white,/area/om_ships/req_console_ship)
"bF" = (/obj/structure/window/reinforced/projresist{dir = 2},/obj/machinery/optable,/turf/simulated/floor/tiled/white,/area/om_ships/req_console_ship)
"bG" = (/obj/machinery/door/window/southleft,/turf/simulated/floor/tiled/white,/area/om_ships/req_console_ship)
"bH" = (/obj/structure/table/glass,/obj/item/weapon/storage/box/pillbottles,/obj/item/weapon/hand_labeler,/obj/structure/window/reinforced/projresist{dir = 2},/turf/simulated/floor/tiled/white,/area/om_ships/req_console_ship)
"bI" = (/obj/machinery/door/window/southright,/turf/simulated/floor/tiled/white,/area/om_ships/req_console_ship)
"bJ" = (/obj/machinery/chem_master,/obj/structure/window/reinforced/projresist{dir = 4},/obj/structure/window/reinforced/projresist{dir = 2},/turf/simulated/floor/tiled/white,/area/om_ships/req_console_ship)
"bK" = (/obj/machinery/bodyscanner{tag = "icon-body_scanner_0 (WEST)"; icon_state = "body_scanner_0"; dir = 8},/turf/simulated/floor/tiled/white,/area/om_ships/req_console_ship)
"bL" = (/obj/machinery/body_scanconsole{tag = "icon-body_scannerconsole (WEST)"; icon_state = "body_scannerconsole"; dir = 8},/turf/simulated/floor/tiled/white,/area/om_ships/req_console_ship)
"bM" = (/obj/machinery/atmospherics/unary/freezer{dir = 1; icon_state = "freezer_1"; tag = "icon-freezer_1"},/turf/simulated/floor/tiled/white,/area/om_ships/req_console_ship)
"bN" = (/obj/machinery/telecomms/allinone,/turf/simulated/floor/tiled/dark,/area/om_ships/req_console_ship)
"bO" = (/obj/structure/bed/chair{dir = 1},/turf/simulated/floor/tiled,/area/om_ships/req_console_ship)
"bP" = (/obj/machinery/telecomms/relay/long_range_emergency,/turf/simulated/floor/plating,/area/om_ships/req_console_ship)
"bQ" = (/obj/machinery/light/small{dir = 4},/obj/machinery/telecomms/relay/ship_relay,/turf/simulated/floor/plating,/area/om_ships/req_console_ship)
"bR" = (/obj/structure/janitorialcart,/obj/item/weapon/mop,/obj/item/weapon/reagent_containers/glass/bucket,/turf/simulated/floor/plating,/area/om_ships/req_console_ship)
"bS" = (/obj/structure/window/reinforced/projresist{dir = 8},/obj/structure/window/reinforced/projresist,/obj/structure/grille,/turf/simulated/floor/plating,/area/om_ships/req_console_ship)
"bT" = (/obj/structure/window/reinforced/projresist{dir = 4},/obj/structure/window/reinforced/projresist{dir = 1},/obj/structure/grille,/turf/simulated/floor/plating,/area/om_ships/req_console_ship)
"bU" = (/obj/machinery/organ_printer/robot/mapped,/turf/simulated/floor/tiled/white,/area/om_ships/req_console_ship)
"bV" = (/obj/structure/bed{tag = "icon-bed2 (EAST)"; icon_state = "bed2"; dir = 4},/obj/structure/bed{tag = "icon-bed2 (EAST)"; icon_state = "bed2"; dir = 4},/turf/simulated/floor/tiled/white,/area/om_ships/req_console_ship)
"bW" = (/obj/machinery/light{dir = 8},/obj/structure/closet/crate/trashcart,/turf/simulated/floor/plating,/area/om_ships/req_console_ship)
"bX" = (/obj/structure/window/reinforced/projresist{dir = 8},/obj/structure/window/reinforced/projresist,/obj/structure/window/reinforced/projresist{dir = 4},/obj/structure/grille,/turf/simulated/floor/plating,/area/om_ships/req_console_ship)
"bY" = (/obj/machinery/light,/turf/simulated/floor/tiled/dark,/area/om_ships/req_console_ship)
"bZ" = (/obj/machinery/light,/turf/simulated/floor/tiled/white,/area/om_ships/req_console_ship)
"ca" = (/obj/structure/lattice,/turf/simulated/floor/tiled/white,/area/om_ships/req_console_ship)
"cb" = (/obj/machinery/vending/props,/turf/simulated/floor/tiled,/area/om_ships/req_console_ship)
"cc" = (/obj/machinery/vending/fitness,/turf/simulated/floor/tiled,/area/om_ships/req_console_ship)
"cd" = (/obj/machinery/vending/cigarette,/turf/simulated/floor/tiled,/area/om_ships/req_console_ship)
"ce" = (/obj/machinery/vending/snack,/turf/simulated/wall/r_wall,/area/om_ships/req_console_ship)
"cf" = (/obj/machinery/vending/snack,/turf/simulated/floor/tiled,/area/om_ships/req_console_ship)
"cg" = (/obj/machinery/vending/coffee,/turf/simulated/floor/tiled,/area/om_ships/req_console_ship)
"ch" = (/obj/machinery/vending/cola,/turf/simulated/floor/tiled,/area/om_ships/req_console_ship)
"ci" = (/obj/machinery/vending/dinnerware,/turf/simulated/floor/tiled,/area/om_ships/req_console_ship)
"cj" = (/obj/docking_umbilical/south,/turf/simulated/floor/tiled,/area/om_ships/req_console_ship)
"ck" = (/obj/structure/closet/crate/large{icon_state = "secgearcrate"; name = "Metal Crate"; tag = "icon-secgearcrate"},/obj/item/stack/material/glass/fifty,/obj/item/stack/material/glass/fifty,/obj/item/stack/material/glass/fifty,/obj/item/stack/material/glass/reinforced/fifty,/obj/item/stack/material/glass/reinforced/fifty,/obj/item/stack/material/glass/reinforced/fifty,/turf/simulated/floor/tiled,/area/om_ships/req_console_ship)
"cl" = (/obj/structure/reagent_dispensers/watertank,/obj/machinery/light,/turf/simulated/floor/tiled,/area/om_ships/req_console_ship)
"cm" = (/obj/structure/table/steel_reinforced,/obj/item/weapon/reagent_containers/spray/cleaner,/obj/item/weapon/reagent_containers/spray/cleaner,/turf/simulated/floor/plating,/area/om_ships/req_console_ship)
"cn" = (/obj/machinery/light{dir = 1},/turf/simulated/floor/plating,/area/om_ships/req_console_ship)

(1,1,1) = {"
aaaaaaaaaaaaaaaaaaaaaaaaaaaaaaaaaaaaaaaaaaaaaaaaaaaaaaaaaaaaaaaaaaaaaaaaaaaaaaaaaaaaaaaaaaaaaaaaaaaa
aaaaaaaaaaaaaaaaaaaaaaaaaaaaaaaaaaaaaaaaaaaaaaaaaaaaaaaaaaaaaaaaaaaaaaaaaaaaaaaaaaaaaaaaaaaaaaaaaaaa
aaaaaaaaaaaaaaaaaaaaaaaaaaaaaaaaaaaaaaaaaaaaaaaaaaaaaaaaaaaaaaaaaaaaaaaaaaaaaaaaaaaaaaaaaaaaaaaaaaaa
aaaaaaaaaaaaaaaaaaaaaaaaaaaaaaaaaaaaaaaaaaaaaaaaaaaaaaaaaaaaaaaaaaaaaaaaaaababababababababababaaaaaa
aaaaaaaaaaaaaaaaaaaaaaaaaaaaaaaaabababababababacacacacacacacacabababababababababadadadadabababababaa
aaaaaaaaaaaaaaaaababababababababababacacacacacacababababababababacaaacaaaaaaaaaeafadadadaeaaaaaaaaaa
aaaaaaaaaaabababababaaaaaaaaacaaaaaaaaaaaaaaaaacaaaaaaaaaaaaaaacacacacaaaaaaaaaeadadagadaeaaacaaaaaa
aaaaaaaaabababababababababababababababababababacaaaaaaaaaaaaaaaaaaacaeaeaeaeaeaeaeaeaeahaeaeaeaeaaaa
aaaaaaabababaeaiaiaiaiaiaiaiaiaiaiaiaiaiaiaiababababaeaeaeaeaeaeaeaeaeajakakakalamanakaoaeapadaqaaaa
aaaaaaarasatauavawawaxawawawayawawawaxazaAaiananaBaCaDaEaFaGaeaoaHaoaeaIaoaoaoaoaoaoaoaoahadadaqaaaa
aaaaaJaKasauaLaiaMaNawaOawaPaiaQaRawawawawaSaoaoaoaoaoaoaoaoaoaoaoaoaeaoaoaoaeaeahaeaeaeaeaTadaqaaaa
aaaaaUaVauasaiaiaWaXaYaZbabbaiawawawawbcawaibdaebebfbfbfbfaobgaoaobhaebiaebiaeadadadbjbkaebladaqaaaa
aaaaaUbmasbnaiboawawawawbpbqaibrawawbsbtbuaibmasaobvbvbvbvbhaeaoaoaobibwaebxaebybzbAbBbCaeaeaeaeaaaa
aaaaaUbDauasaiaibEbFbGbHbIbJaibKbLawawbMawaibNaebebObObObOaoaoaoaobhaebiaebiaeadadadbPbQaebRadaqaaaa
aaaabSbTasauaLaiaMaNawbUawaPaiaQaRbVawawawaSaoaoaoaoaoaoaoaobgaoaoaoaeaoaoaoaeaeahaeaeaeaebWadaqaaaa
aaaaaabXasbYauavawawbZawawawaycaawawbZazaAaicbcccdcecfcgchciaeaocjaoaeaIaoaoaoaoaoaoaoaoahadadaqaaaa
aaaaaaababababaiaiaiaiaiaiaiaiaiaiaiaiaiaiaiababababaeaeaeaeaeaeaeaeaeajakakakckclanakaoaecmadaqaaaa
aaaaaaaaabababababababababababababababababababacaaaaaaaaaaaaaaaaaaacaeaeaeaeaeaeaeaeaeahaeaeaeaeaaaa
aaaaaaaaaaabababababaaaaaaaaacaaaaaaaaaaaaaaaaacaaaaaaaaaaaaaaacacacacaaaaaaaaaeadadcnadaeaaacaaaaaa
aaaaaaaaaaaaaaaaababababababababababacacacacacacababababababababacaaacaaaaaaaaaeadadadadaeaaaaaaaaaa
aaaaaaaaaaaaaaaaaaaaaaaaaaaaaaaaabababababababacacacacacacacacabababababababababafadadadabababababaa
aaaaaaaaaaaaaaaaaaaaaaaaaaaaaaaaaaaaaaaaaaaaaaaaaaaaaaaaaaaaaaaaaaaaaaaaaaababababababababababaaaaaa
aaaaaaaaaaaaaaaaaaaaaaaaaaaaaaaaaaaaaaaaaaaaaaaaaaaaaaaaaaaaaaaaaaaaaaaaaaaaaaaaaaaaaaaaaaaaaaaaaaaa
aaaaaaaaaaaaaaaaaaaaaaaaaaaaaaaaaaaaaaaaaaaaaaaaaaaaaaaaaaaaaaaaaaaaaaaaaaaaaaaaaaaaaaaaaaaaaaaaaaaa
aaaaaaaaaaaaaaaaaaaaaaaaaaaaaaaaaaaaaaaaaaaaaaaaaaaaaaaaaaaaaaaaaaaaaaaaaaaaaaaaaaaaaaaaaaaaaaaaaaaa
"}
