"aa" = (/turf/space,/area/space)
"ab" = (/obj/machinery/door/airlock/halo_maint/innie_ship_preset,/turf/simulated/floor/plating,/area/om_ships/req_console_ship)
"ac" = (/obj/machinery/door/airlock/halo/innie_ship_preset,/turf/simulated/floor/tiled/dark,/area/om_ships/req_console_ship)
"ad" = (/obj/machinery/door/airlock/halo/innie_ship_preset,/turf/simulated/floor/tiled,/area/om_ships/req_console_ship)
"ae" = (/obj/structure/closet/crate/large{icon_state = "secgearcrate"; name = "Metal Crate"; tag = "icon-secgearcrate"},/obj/item/stack/material/steel/fifty,/turf/simulated/floor/shuttle/darkred,/area/om_ships/req_console_ship)
"af" = (/obj/machinery/door/airlock/halo_maint/innie_ship_preset,/turf/simulated/floor/tiled,/area/om_ships/req_console_ship)
"ag" = (/turf/simulated/floor/shuttle/darkred,/area/om_ships/req_console_ship)
"ah" = (/obj/machinery/portable_atmospherics/canister/oxygen,/turf/simulated/floor/shuttle/darkred,/area/om_ships/req_console_ship)
"ai" = (/obj/structure/table/rack,/obj/item/clothing/head/welding,/obj/item/clothing/head/welding,/turf/simulated/floor/shuttle/darkred,/area/om_ships/req_console_ship)
"aj" = (/obj/machinery/vending/tool,/obj/machinery/light{dir = 1},/turf/simulated/floor/shuttle/darkred,/area/om_ships/req_console_ship)
"ak" = (/obj/structure/reagent_dispensers/fueltank,/turf/simulated/floor/shuttle/darkred,/area/om_ships/req_console_ship)
"al" = (/obj/structure/closet/emcloset/legacy,/turf/simulated/floor/shuttle/darkred,/area/om_ships/req_console_ship)
"am" = (/obj/machinery/light{dir = 1},/turf/simulated/floor/shuttle/darkred,/area/om_ships/req_console_ship)
"an" = (/obj/machinery/door/airlock/halo/innie_ship_preset,/turf/simulated/floor/shuttle/darkred,/area/om_ships/req_console_ship)
"ao" = (/obj/structure/closet/secure_closet/freezer/kitchen,/turf/simulated/floor/shuttle/darkred,/area/om_ships/req_console_ship)
"ap" = (/obj/structure/closet/secure_closet/freezer/meat,/turf/simulated/floor/shuttle/darkred,/area/om_ships/req_console_ship)
"aq" = (/obj/structure/closet/secure_closet/freezer/fridge,/obj/structure/sink/kitchen{dir = 2; pixel_x = 16; pixel_y = 22},/turf/simulated/floor/shuttle/darkred,/area/om_ships/req_console_ship)
"ar" = (/obj/machinery/cooker/grill,/turf/simulated/floor/shuttle/darkred,/area/om_ships/req_console_ship)
"as" = (/obj/machinery/cooker/fryer,/turf/simulated/floor/shuttle/darkred,/area/om_ships/req_console_ship)
"at" = (/obj/machinery/cooker/oven,/turf/simulated/floor/shuttle/darkred,/area/om_ships/req_console_ship)
"au" = (/obj/machinery/light{dir = 8},/turf/simulated/floor/shuttle/darkred,/area/om_ships/req_console_ship)
"av" = (/obj/effect/decal/cleanable/blood,/turf/simulated/floor/shuttle/darkred,/area/om_ships/req_console_ship)
"aw" = (/obj/effect/decal/cleanable/blood/splatter,/turf/simulated/floor/shuttle/darkred,/area/om_ships/req_console_ship)
"ax" = (/turf/simulated/floor/shuttle/red,/area/om_ships/req_console_ship)
"ay" = (/obj/machinery/light{dir = 4},/turf/simulated/floor/shuttle/darkred,/area/om_ships/req_console_ship)
"az" = (/obj/structure/bed/chair{dir = 4},/turf/simulated/floor/shuttle/darkred,/area/om_ships/req_console_ship)
"aA" = (/obj/structure/table/steel,/obj/item/weapon/storage/firstaid/o2,/obj/item/weapon/storage/firstaid/o2,/turf/simulated/floor/shuttle/darkred,/area/om_ships/req_console_ship)
"aB" = (/obj/structure/table/steel,/obj/item/weapon/storage/firstaid/unsc,/obj/item/weapon/storage/firstaid/unsc,/obj/machinery/light,/turf/simulated/floor/shuttle/darkred,/area/om_ships/req_console_ship)
"aC" = (/obj/structure/table/steel,/obj/item/bodybag/cryobag,/obj/item/bodybag/cryobag,/obj/item/bodybag/cryobag,/turf/simulated/floor/shuttle/darkred,/area/om_ships/req_console_ship)
"aD" = (/obj/structure/bed/chair{dir = 2},/turf/simulated/floor/shuttle/darkred,/area/om_ships/req_console_ship)
"aE" = (/obj/machinery/door/airlock/multi_tile/halo/innie_ship_preset,/turf/simulated/floor/shuttle/darkred,/area/om_ships/req_console_ship)
"aF" = (/obj/effect/decal/cleanable/blood,/turf/simulated/floor/shuttle/red,/area/om_ships/req_console_ship)
"aG" = (/obj/machinery/light/spot{dir = 4},/turf/simulated/floor/shuttle/red,/area/om_ships/req_console_ship)
"aH" = (/obj/machinery/door/airlock/halo_maint/innie_ship_preset,/turf/simulated/floor/shuttle/darkred,/area/om_ships/req_console_ship)
"aI" = (/obj/machinery/telecomms/relay/long_range_emergency,/turf/simulated/floor/shuttle/darkred,/area/om_ships/req_console_ship)
"aJ" = (/obj/structure/bed/chair/comfy/black{dir = 8},/turf/simulated/floor/shuttle/darkred,/area/om_ships/req_console_ship)
"aK" = (/obj/machinery/nav_computer/unsc,/turf/simulated/floor/shuttle/darkred,/area/om_ships/req_console_ship)
"aL" = (/obj/machinery/light/spot{dir = 8},/turf/simulated/floor/shuttle/darkred,/area/om_ships/req_console_ship)
"aM" = (/obj/structure/table/steel,/obj/machinery/microwave,/turf/simulated/floor/shuttle/darkred,/area/om_ships/req_console_ship)
"aN" = (/obj/structure/table/steel,/turf/simulated/floor/shuttle/darkred,/area/om_ships/req_console_ship)
"aO" = (/obj/structure/table/steel,/obj/item/weapon/paper_bin,/obj/item/weapon/pen,/turf/simulated/floor/shuttle/darkred,/area/om_ships/req_console_ship)
"aP" = (/obj/machinery/light/spot{dir = 4},/obj/machinery/photocopier/faxmachine{density = 0; department = "Deployed Vessel"; dir = 4; icon = 'code/modules/halo/icons/machinery/computer.dmi'; icon_state = "nav"; name = "URF Camp New Hope Priority Communications Line"; pixel_x = 32},/turf/simulated/floor/shuttle/darkred,/area/om_ships/req_console_ship)
"aQ" = (/obj/machinery/light/spot{dir = 8},/turf/simulated/floor/shuttle/red,/area/om_ships/req_console_ship)
"aR" = (/obj/effect/hull_segment,/turf/simulated/wall,/area/om_ships/req_console_ship)
"aS" = (/obj/machinery/light/small{dir = 4},/turf/simulated/floor/shuttle/darkred,/area/om_ships/req_console_ship)
"aT" = (/obj/structure/closet/crate,/obj/item/fusion_fuel,/obj/item/fusion_fuel,/obj/item/fusion_fuel,/obj/machinery/light/small{dir = 8},/turf/simulated/floor/shuttle/darkred,/area/om_ships/req_console_ship)
"aU" = (/obj/machinery/light/small{dir = 8},/turf/simulated/floor/shuttle/darkred,/area/om_ships/req_console_ship)
"aV" = (/obj/structure/cable/blue{icon_state = "0-8"},/turf/simulated/floor/shuttle/darkred,/area/om_ships/req_console_ship)
"aW" = (/obj/structure/table/steel,/obj/item/weapon/storage/firstaid/unsc,/obj/item/weapon/storage/firstaid/unsc,/obj/machinery/light{dir = 1},/turf/simulated/floor/shuttle/darkred,/area/om_ships/req_console_ship)
"aX" = (/obj/structure/bed/chair{dir = 1},/turf/simulated/floor/shuttle/darkred,/area/om_ships/req_console_ship)
"aY" = (/obj/effect/decal/cleanable/blood/gibs/limb{tag = "icon-gibbearcore"; icon_state = "gibbearcore"},/turf/simulated/floor/shuttle/red,/area/om_ships/req_console_ship)
"aZ" = (/obj/machinery/telecomms/relay/ship_relay,/turf/simulated/floor/shuttle/darkred,/area/om_ships/req_console_ship)
"ba" = (/obj/machinery/light,/turf/simulated/floor/shuttle/darkred,/area/om_ships/req_console_ship)
"bb" = (/obj/machinery/vending/snack,/turf/simulated/floor/shuttle/darkred,/area/om_ships/req_console_ship)
"bc" = (/obj/machinery/vending/fitness,/turf/simulated/floor/shuttle/darkred,/area/om_ships/req_console_ship)
"bd" = (/obj/machinery/vending/cigarette,/turf/simulated/floor/shuttle/darkred,/area/om_ships/req_console_ship)
"be" = (/obj/machinery/vending/coffee,/turf/simulated/floor/shuttle/darkred,/area/om_ships/req_console_ship)
"bf" = (/obj/machinery/vending/cola,/turf/simulated/floor/shuttle/darkred,/area/om_ships/req_console_ship)
"bg" = (/obj/machinery/vending/dinnerware,/turf/simulated/floor/shuttle/darkred,/area/om_ships/req_console_ship)
"bh" = (/obj/structure/closet/crate/large{icon_state = "secgearcrate"; name = "Metal Crate"; tag = "icon-secgearcrate"},/obj/item/stack/material/glass/fifty,/obj/item/stack/material/glass/reinforced/fifty,/turf/simulated/floor/shuttle/darkred,/area/om_ships/req_console_ship)
"bi" = (/obj/structure/closet/crate/trashcart,/turf/simulated/floor/shuttle/darkred,/area/om_ships/req_console_ship)
"bj" = (/obj/structure/janitorialcart,/obj/item/weapon/mop,/obj/item/weapon/reagent_containers/glass/bucket,/turf/simulated/floor/shuttle/darkred,/area/om_ships/req_console_ship)
"bk" = (/obj/structure/reagent_dispensers/watertank,/obj/machinery/light,/turf/simulated/floor/shuttle/darkred,/area/om_ships/req_console_ship)
"bl" = (/obj/structure/table/steel_reinforced,/obj/item/weapon/reagent_containers/spray/cleaner,/obj/item/weapon/reagent_containers/spray/cleaner,/turf/simulated/floor/shuttle/darkred,/area/om_ships/req_console_ship)
"bm" = (/turf/simulated/wall/r_wall,/area/space)
"cO" = (/obj/docking_umbilical/north,/turf/simulated/floor/tiled,/area/om_ships/req_console_ship)
"fJ" = (/obj/machinery/telecomms/allinone,/turf/simulated/floor/tiled/dark,/area/om_ships/req_console_ship)
"gE" = (/obj/structure/window/reinforced/projresist{dir = 8},/obj/structure/window/reinforced/projresist{dir = 4},/obj/structure/grille,/turf/simulated/floor/plating,/area/om_ships/req_console_ship)
"hd" = (/turf/simulated/floor/tiled,/area/om_ships/req_console_ship)
"hI" = (/obj/structure/window/reinforced/projresist{dir = 8},/obj/structure/window/reinforced/projresist{dir = 1},/obj/structure/grille,/turf/simulated/floor/plating,/area/om_ships/req_console_ship)
"kO" = (/obj/structure/window/reinforced/projresist,/obj/structure/window/reinforced/projresist{dir = 4},/obj/structure/grille,/turf/simulated/floor/plating,/area/om_ships/req_console_ship)
"lb" = (/obj/docking_umbilical/south,/turf/simulated/floor/tiled,/area/om_ships/req_console_ship)
"lq" = (/obj/machinery/light{dir = 1},/turf/simulated/floor/plating,/area/om_ships/req_console_ship)
"ls" = (/turf/simulated/wall/r_wall,/area/om_ships/req_console_ship)
"ny" = (/obj/vehicles/drop_pod/escape_pod/bumblebee/west,/turf/simulated/floor/plating,/area/om_ships/req_console_ship)
"oS" = (/obj/machinery/computer/helm{tag = "icon-nav (WEST)"; icon = 'code/modules/halo/icons/machinery/computer.dmi'; icon_state = "nav"; dir = 8; icon_keyboard = ""; icon_screen = "covie_console_overlay"},/obj/structure/computerframe{anchored = 1; dir = 8; icon = 'code/modules/halo/icons/machinery/computer.dmi'; icon_state = "computer"; layer = 2; level = 1; tag = "icon-computer (WEST)"},/turf/simulated/floor/tiled/dark,/area/om_ships/req_console_ship)
"qX" = (/turf/simulated/wall,/area/om_ships/req_console_ship)
"ru" = (/obj/structure/lattice,/turf/space,/area/space)
"rx" = (/obj/machinery/deck_gun{dir = 8},/turf/space,/area/space)
"rZ" = (/obj/structure/window/reinforced/projresist{dir = 8},/obj/structure/window/reinforced/projresist{dir = 4},/obj/structure/window/reinforced/projresist{dir = 1},/obj/structure/grille,/turf/simulated/floor/plating,/area/om_ships/req_console_ship)
"sh" = (/obj/machinery/fusion_thruster/fueled{dir = 8},/obj/structure/window/reinforced/projresist{dir = 8},/turf/simulated/floor/plating,/area/om_ships/req_console_ship)
"vo" = (/obj/structure/window/reinforced/projresist{dir = 4},/obj/structure/window/reinforced/projresist{dir = 1},/obj/structure/grille,/turf/simulated/floor/plating,/area/om_ships/req_console_ship)
"xx" = (/obj/machinery/overmap_weapon_console/deck_gun_control/local/missile_control{dir = 4; icon = 'code/modules/halo/icons/machinery/computer.dmi'; icon_state = "engine"},/obj/structure/computerframe{anchored = 1; dir = 4; icon = 'code/modules/halo/icons/machinery/computer.dmi'; icon_state = "computer"; layer = 2; level = 1; tag = "icon-computer (WEST)"},/turf/simulated/floor/tiled/dark,/area/om_ships/req_console_ship)
"yO" = (/obj/machinery/overmap_weapon_console/ship_scanning_console{dir = 4; icon = 'code/modules/halo/icons/machinery/computer.dmi'; icon_state = "engine"; tag = "icon-engine (NORTH)"},/obj/structure/computerframe{anchored = 1; dir = 4; icon = 'code/modules/halo/icons/machinery/computer.dmi'; icon_state = "computer"; layer = 2; level = 1; tag = "icon-computer (WEST)"},/turf/simulated/floor/tiled/dark,/area/om_ships/req_console_ship)
"zj" = (/obj/effect/hull_segment,/turf/simulated/wall/r_wall,/area/om_ships/req_console_ship)
"CY" = (/obj/machinery/power/fusion_drive_simple,/obj/structure/cable/blue{icon_state = "0-4"},/turf/simulated/floor/plating,/area/om_ships/req_console_ship)
"Di" = (/obj/structure/window/reinforced/projresist{dir = 8},/obj/structure/window/reinforced/projresist,/obj/structure/grille,/turf/simulated/floor/plating,/area/om_ships/req_console_ship)
"EB" = (/obj/machinery/deck_gun/missile_pod{dir = 1},/turf/space,/area/space)
"Fc" = (/turf/simulated/floor/plating,/area/om_ships/req_console_ship)
"Gu" = (/obj/structure/window/reinforced/projresist{dir = 8},/obj/structure/window/reinforced/projresist,/obj/structure/window/reinforced/projresist{dir = 4},/obj/structure/grille,/turf/simulated/floor/plating,/area/om_ships/req_console_ship)
"GI" = (/obj/machinery/overmap_weapon_console/npc_comms_console/unsc{dir = 8; germ_level = 110; icon = 'code/modules/halo/icons/machinery/computer.dmi'; icon_state = "nav"; tag = "icon-comm (NORTH)"},/obj/structure/computerframe{anchored = 1; dir = 8; icon = 'code/modules/halo/icons/machinery/computer.dmi'; icon_state = "computer"; layer = 2; level = 1; tag = "icon-computer (WEST)"},/turf/simulated/floor/tiled/dark,/area/om_ships/req_console_ship)
"IL" = (/obj/machinery/light,/turf/simulated/floor/plating,/area/om_ships/req_console_ship)
"NK" = (/obj/machinery/overmap_weapon_console/deck_gun_control/local{dir = 4; icon = 'code/modules/halo/icons/machinery/computer.dmi'; icon_state = "engine"},/obj/structure/computerframe{anchored = 1; dir = 4; icon = 'code/modules/halo/icons/machinery/computer.dmi'; icon_state = "computer"; layer = 2; level = 1; tag = "icon-computer (WEST)"},/turf/simulated/floor/tiled/dark,/area/om_ships/req_console_ship)
"OC" = (/obj/machinery/deck_gun/missile_pod,/turf/space,/area/space)
"OJ" = (/obj/structure/computerframe{anchored = 1; dir = 8; icon = 'code/modules/halo/icons/machinery/computer.dmi'; icon_state = "computer"; layer = 2; level = 1; tag = "icon-computer (WEST)"},/turf/simulated/floor/tiled/dark,/area/om_ships/req_console_ship)
"TC" = (/obj/machinery/light{dir = 8},/turf/simulated/floor/plating,/area/om_ships/req_console_ship)

(1,1,1) = {"
aaaaaaaaaaaaaaaaaaaaaaaaaaaaaaaaaaaaaaaaaaaaaaaaaaaaaaaaaaaaaaaaaaaaaaaaaaaaaaaaaaaaaaaaaaaaaaaaaaaaaaaaaaaaaaaaaaaaaaaaaaaaaaaaaaaaaaaaaaaaaaaaaaaaaa
aaaaaaaaaaaaaaaaaaaaaaaaaaaaaaaaaaaaaaaaaaaaaaaaaaaaaaaaaaaaaaaaaaaaaaaaaaaaaaaaaaaaaaaaaaaaaaaaaaaaaaaaaaaaaaaaaaaaaaaaaaaaaaaaaaaaaaaaaaaaaaaaaaaaaa
aaaaaaaaaaaaaaaaaaaaaaaaaaaaaaaaaaaaaaaaaaaaaaaaaaaaaaaaaaaaaaaaaaaaaaaaaaaaaaaaaaaaaaaaaaaaaaaaaaaaaaaaaaaaaaaaaaaaaaaaaaaaaaaaaaaaaaaaaaaaaaaaaaaaaa
aaaaaaaaaaaaaaaaaaaaaaaaaaaaaaaaaaaaaaaaaaaaaaaaaaaaaaaaaaaaaaaaaaaaaaaaaaaaaaaaaaaaaaaaaaaaaaaaaaaaaaaaaaaaaaaaaaaaaaaaaaaaaaaaaaaaaaaaaaaaaaaaaaaaaa
aaaaaaaaaaaaaaaaaaaaaaaaaaaaaaaaaaaaaaaaaaaaaaaaaaaaaaaaaaaaaaaaaaaaaaaaaaaaaaaaaaaaaaaaaaaaaaaaaaaaaaaaaaaaaaaaaaaaaaaaaaaaaaaaaaaaaaaaaaaaaaaaaaaaaa
aaaaaaaaaaaaaaaaaaaaaaaaaaaaaaaaaaaaaaaaaaaaaaaaaaaaaaaaaaaaaaaaaaaaaaaaaaaaaaaaaaaaaaaaaaaaaaaaaaaaaaaaaaaaaaaaaaaaaaaaaaaaaaaaaaaaaaaaaaaaaaaaaaaaaa
aaaaaaaaaaaaaaaaaaaaaaaaaaaaaaaaaaaaaaaaaaaaaaaaaaaaaaaaaaaaaaaaaaaaaaaaaaaaaaaaaaaaaaaaaaaaaaaaaaaaaaaaaaaaaaaaaaaaaaaaaaaaaaaaaaaaaaaaaaaaaaaaaaaaaa
aaaaaaaaaaaaaaaaaaaaaaaaaaaaaaaaaaaaaaaaaaaaaaaaaaaaaaaaaaaaaaaaaaaaaaaaaaaaaaaaaaaaaaaaaaaaaaaaaaaaaaaaaaaaaaaaaaaaaaaaaaaaaaaaaaaaaaaaaaaaaaaaaaaaaa
aaaaaaaaaaaaaaaaaaaaaaaaaaaaaaaaaaaaaaaaaaaaaaaaaaaaaaaaaaaaaaaaaaaaaaaaaaaaaaaaaaaaaaaaaaaaaaaaaaaaaaaaaaaaaaaaaaaaaaaaaaaaaaaaaaaaaaaaaaaaaaaaaaaaaa
aaaaaaaaaaaaaaaaaaaaaaaaaaaaaaaaaaaaaaaaaaaaaaaaaaaaaaaaaaaaaaaaaaaaaaaaaaaaaaaaaaaaaaaaaaaaaaaaaaaaaaaaaaaaaaaaaaaaaaaaaaaaaaaaaaaaaaaaaaaaaaaaaaaaaa
aaaaaaaaaaaaaaaaaaaaaaaaaaaaaaaaaaaaaaaaaaaaaaaaaaaaaaaaaaaaaaaaaaaaaaaaaaaaaaaaaaaaaaaaaaaaaaaaaaaaaaaaaaaaaaaaaaaaaaaaaaaaaaaaaaaaaaaaaaaaaaaaaaaaaa
aaaaaaaaaaaaaaaaaaaaaaaaaaaaaaaaaaaaaaaaaaaaaaaaaaaaaaaaaaaaaaaaaaaaaaaaaaaaaaaaaaaaaaaaaaaaaaaaaaaaaaaaaaaaaaaaaaaaaaaaaaaaaaaaaaaaaaaaaaaaaaaaaaaaaa
aaaaaaaaaaaaaaaaaaaaaaaaaaaaaaaaaaaaaaaaaaaaaaaaaaaaaaaaaaaaaaaaaaaaaaaaaaaaaaaaaaaaaaaaaaaaaaaaaaaaaaaaaaaaaaaaaaaaaaaaaaaaaaaaaaaaaaaaaaaaaaaaaaaaaa
aaaaaaaaaaaaaaaaaaaaaaaaaaaaaaaaaaaaaaaaaaaaaaaaaaaaaaaaaaaaaaaaaaaaaaaaaaaaaaaaaaaaaaaaaaaaaaaaaaaaaaaaaaaaaaaaaaaaaaaaaaaaaaaaaaaaaaaaaaaaaaaaaaaaaa
aaaaaaaaaaaaaaaaaaaaaaaaaaaaaaaaaaaaaaaaaaaaaaaaaaaaaaaaaaaaaaaaaaaaaaaaaaaaaaaaaaaaaaaaaaaaaaaaaaaaaaaaaaaaaaaaaaaaaaaaaaaaaaaaaaaaaaaaaaaaaaaaaaaaaa
aaaaaaaaaaaaaaaaaaaaaaaaaaaaaaaaaaaaaaaaaaaaaaaaaaaaaaaaaaaaaaaaaaaaaaaaaaaaaaaaaaaaaaaaaaaaaaaaaaaaaaaaaaaaaaaaaaaaaaaaaaaaaaaaaaaaaaaaaaaaaaaaaaaaaa
aaaaaaaaaaaaaaaaaaaaaaaaaaaaaaaaaaaaaaaaaaaaaaaaaaaaaaaaaaaaaaaaaaaaaaaaaaaaaaaaaaaaaaaaaaaaaaaarxlslslslslslslslsaaaaaaaaaaaaaaaaaaaaaaaaaaaaaaaaaaaa
aaaaaaaaaaaaaaaaaaaaaaaaaaaaaaaaaaaaaaaaaaaaaaaaaaaaaaaaaaaaaaaaaaaaaaaaaaaaaaaaaaaaaaaaaaaaaarxlslslslslslslslslslsaaaaaaaaaaaaaaaaaaaaaaaaaaaaaaaaaa
aaaaaaaaaaaaaaaaaaaaaaaaaaaaaaaaaaaaaaaaaaaaaaaaaaaaaaaaaaaaaaaaaaaaaaaaaaaaaaaaaarxlslslslslslslslslsFcFcFcFclslslslsaaaaaaaaaaaaaaaaaaaaaaaaaaaaaaaa
aaaaaaaaaaaaaaaaaaaaaaaaaaaaaaaaaaOCaaaaOCaaaaOCaaaaaaaaaaaaaaaaaaaarxlslslslslslslslslslslslslslslsqXnyFcFcFcqXqXlslsaaaaaaaaaaaaaaaaaaaaaaaaaaaaaaaa
aaaaaaaaaaaaaaaaaaaaaaaaaaaaaaaalslslslslslslslslslslslslsaaaalslslslslslslslslslslslsaaaaruaaaaaaaaqXFcFcILFcqXaaruaaaaaaaaaaaaaaaaaaaaaaaaaaaaaaaaaa
aaaaaaaaaaaaaaaaaaaaaaaaaaaaaalslslslslslslslslslslslslslslsaaaaaaruaaaaaaaaaaaaaaaaaaaaaaqXqXqXqXqXqXqXqXqXabqXqXqXqXaaaaaaaaaaaaaaaaaaaaaaaaaaaaaaaa
aaaaaaaaaaaaaaaaaaaaaaaaaaaalslslsqXqXqXqXaRqXqXqXqXqXqXlslslslszjqXqXqXqXqXqXqXqXqXqXqXqXqXaeagahaiajakalagagqXFcFcshaaaaaaaaaaaaaaaaaaaaaaaaaaaaaaaa
aaaaaaaaaaaaaaaaaaaaaaaaaaaarZagamaganagagagagagaganagamagagagagqXaoapaqarasatqXhdcOhdqXaRqXauagagagagagagagagabFcFcshaaaaaaaaaaaaaaaaaaaaaaaaaaaaaaaa
aaaaaaaaaaaaaaaaaaaaaaaaaahIkOagagalqXagagagagagagqXalagagavagaganagagagawagagagaxaxaxaxqXagagagqXqXabqXqXauagaRTCFcshaaaaaaaaaaaaaaaaaaaaaaaaaaaaaaaa
aaaaaaaaaaaaaaaaaaaaaaaaaagEGIagagqXqXayqXauazyOayqXqXagaAaBaCagqXagaDaDaDaDagaEaxaxaFaGqXaHqXaHqXagagagqXaIagqXFcFcshaaaaaaaaaaaaaaaaaaaaaaaaaaaaaaaa
aaaaaaaaaaaaaaaaaaaaaaaaaagEoSaJayqXfJagoSaJazNKagaKqXadqXqXqXanqXaLaMaNaNaOaPqXaQaxaxaxaHaSqXaTqXaUCYaVqXqXafqXqXqXqXaaaaaaaaaaaaaaaaaaaaaaaaaaaaaaaa
aaaaaaaaaaaaaaaaaaaaaaaaaagEOJagagqXqXayqXauazxxayqXqXagaAaWaCagqXagaXaXaXaXagagaxaYaxaFqXaHqXaHqXagagagqXaZagqXFcFcshaaaaaaaaaaaaaaaaaaaaaaaaaaaaaaaa
aaaaaaaaaaaaaaaaaaaaaaaaaaDivoagagalqXagagagagagagqXalagagawagagadavagagagagagaEaxaxaxaxqXagagagqXqXaHqXqXauagaRTCFcshaaaaaaaaaaaaaaaaaaaaaaaaaaaaaaaa
aaaaaaaaaaaaaaaaaaaaaaaaaaaaGuagbaagacagagagagagavanagbaagagagagqXbbbcbdbebfbgqXhdlbhdqXqXqXauavagagagagagagagabFcFcshaaaaaaaaaaaaaaaaaaaaaaaaaaaaaaaa
aaaaaaaaaaaaaaaaaaaaaaaaaaaalslslsqXqXqXqXaRqXqXqXqXqXqXlslslslszjqXqXqXqXqXqXqXqXqXqXqXaRqXbhagbibjbkblalagagqXFcFcshaaaaaaaaaaaaaaaaaaaaaaaaaaaaaaaa
aaaaaaaaaaaaaaaaaaaaaaaaaaaaaabmlslslslslslslslslslslslslslsaaaaaaruaaaaaaaaaaaaaaaaaaaaaaqXqXqXqXqXqXqXqXqXabqXqXqXqXaaaaaaaaaaaaaaaaaaaaaaaaaaaaaaaa
aaaaaaaaaaaaaaaaaaaaaaaaaaaaaaaalslslslslslslslslslslslslsaaaalslslslslslslslslslslslsaaaaruaaaaaaaaqXFcFclqFcqXaaruaaaaaaaaaaaaaaaaaaaaaaaaaaaaaaaaaa
aaaaaaaaaaaaaaaaaaaaaaaaaaaaaaaaaaaaaaaaaaaaaaaaaaaaaaaaaaaaaaaaaaaarxlslslslslslslslslslslslslslslsqXFcFcFcFcqXqXlslsaaaaaaaaaaaaaaaaaaaaaaaaaaaaaaaa
aaaaaaaaaaaaaaaaaaaaaaaaaaaaaaaaaaEBaaaaEBaaaaEBaaaaaaaaaaaaaaaaaaaaaaaaaaaaaaaaaarxlslslslslslslslslsnyFcFcFclslslslsaaaaaaaaaaaaaaaaaaaaaaaaaaaaaaaa
aaaaaaaaaaaaaaaaaaaaaaaaaaaaaaaaaaaaaaaaaaaaaaaaaaaaaaaaaaaaaaaaaaaaaaaaaaaaaaaaaaaaaaaaaaaaaarxlslslslslslslslslslsaaaaaaaaaaaaaaaaaaaaaaaaaaaaaaaaaa
aaaaaaaaaaaaaaaaaaaaaaaaaaaaaaaaaaaaaaaaaaaaaaaaaaaaaaaaaaaaaaaaaaaaaaaaaaaaaaaaaaaaaaaaaaaaaaaarxlslslslslslslslsaaaaaaaaaaaaaaaaaaaaaaaaaaaaaaaaaaaa
aaaaaaaaaaaaaaaaaaaaaaaaaaaaaaaaaaaaaaaaaaaaaaaaaaaaaaaaaaaaaaaaaaaaaaaaaaaaaaaaaaaaaaaaaaaaaaaaaaaaaaaaaaaaaaaaaaaaaaaaaaaaaaaaaaaaaaaaaaaaaaaaaaaaaa
aaaaaaaaaaaaaaaaaaaaaaaaaaaaaaaaaaaaaaaaaaaaaaaaaaaaaaaaaaaaaaaaaaaaaaaaaaaaaaaaaaaaaaaaaaaaaaaaaaaaaaaaaaaaaaaaaaaaaaaaaaaaaaaaaaaaaaaaaaaaaaaaaaaaaa
aaaaaaaaaaaaaaaaaaaaaaaaaaaaaaaaaaaaaaaaaaaaaaaaaaaaaaaaaaaaaaaaaaaaaaaaaaaaaaaaaaaaaaaaaaaaaaaaaaaaaaaaaaaaaaaaaaaaaaaaaaaaaaaaaaaaaaaaaaaaaaaaaaaaaa
aaaaaaaaaaaaaaaaaaaaaaaaaaaaaaaaaaaaaaaaaaaaaaaaaaaaaaaaaaaaaaaaaaaaaaaaaaaaaaaaaaaaaaaaaaaaaaaaaaaaaaaaaaaaaaaaaaaaaaaaaaaaaaaaaaaaaaaaaaaaaaaaaaaaaa
aaaaaaaaaaaaaaaaaaaaaaaaaaaaaaaaaaaaaaaaaaaaaaaaaaaaaaaaaaaaaaaaaaaaaaaaaaaaaaaaaaaaaaaaaaaaaaaaaaaaaaaaaaaaaaaaaaaaaaaaaaaaaaaaaaaaaaaaaaaaaaaaaaaaaa
aaaaaaaaaaaaaaaaaaaaaaaaaaaaaaaaaaaaaaaaaaaaaaaaaaaaaaaaaaaaaaaaaaaaaaaaaaaaaaaaaaaaaaaaaaaaaaaaaaaaaaaaaaaaaaaaaaaaaaaaaaaaaaaaaaaaaaaaaaaaaaaaaaaaaa
aaaaaaaaaaaaaaaaaaaaaaaaaaaaaaaaaaaaaaaaaaaaaaaaaaaaaaaaaaaaaaaaaaaaaaaaaaaaaaaaaaaaaaaaaaaaaaaaaaaaaaaaaaaaaaaaaaaaaaaaaaaaaaaaaaaaaaaaaaaaaaaaaaaaaa
aaaaaaaaaaaaaaaaaaaaaaaaaaaaaaaaaaaaaaaaaaaaaaaaaaaaaaaaaaaaaaaaaaaaaaaaaaaaaaaaaaaaaaaaaaaaaaaaaaaaaaaaaaaaaaaaaaaaaaaaaaaaaaaaaaaaaaaaaaaaaaaaaaaaaa
aaaaaaaaaaaaaaaaaaaaaaaaaaaaaaaaaaaaaaaaaaaaaaaaaaaaaaaaaaaaaaaaaaaaaaaaaaaaaaaaaaaaaaaaaaaaaaaaaaaaaaaaaaaaaaaaaaaaaaaaaaaaaaaaaaaaaaaaaaaaaaaaaaaaaa
aaaaaaaaaaaaaaaaaaaaaaaaaaaaaaaaaaaaaaaaaaaaaaaaaaaaaaaaaaaaaaaaaaaaaaaaaaaaaaaaaaaaaaaaaaaaaaaaaaaaaaaaaaaaaaaaaaaaaaaaaaaaaaaaaaaaaaaaaaaaaaaaaaaaaa
aaaaaaaaaaaaaaaaaaaaaaaaaaaaaaaaaaaaaaaaaaaaaaaaaaaaaaaaaaaaaaaaaaaaaaaaaaaaaaaaaaaaaaaaaaaaaaaaaaaaaaaaaaaaaaaaaaaaaaaaaaaaaaaaaaaaaaaaaaaaaaaaaaaaaa
aaaaaaaaaaaaaaaaaaaaaaaaaaaaaaaaaaaaaaaaaaaaaaaaaaaaaaaaaaaaaaaaaaaaaaaaaaaaaaaaaaaaaaaaaaaaaaaaaaaaaaaaaaaaaaaaaaaaaaaaaaaaaaaaaaaaaaaaaaaaaaaaaaaaaa
aaaaaaaaaaaaaaaaaaaaaaaaaaaaaaaaaaaaaaaaaaaaaaaaaaaaaaaaaaaaaaaaaaaaaaaaaaaaaaaaaaaaaaaaaaaaaaaaaaaaaaaaaaaaaaaaaaaaaaaaaaaaaaaaaaaaaaaaaaaaaaaaaaaaaa
"}
