"a" = (/turf/unsimulated/wall{desc = "This is as far as the simulated area goes out."},/area/virtual_reality/beach)
"b" = (/obj/effect/overlay/coconut,/turf/simulated/floor/holofloor/beach/sand,/area/virtual_reality/beach)
"c" = (/obj/structure/closet/athletic_mixed,/turf/simulated/floor/holofloor/beach/sand,/area/virtual_reality/beach)
"d" = (/turf/simulated/floor/holofloor/beach/sand{dir = 1; icon_state = "beach"},/area/virtual_reality/beach)
"e" = (/turf/simulated/floor/holofloor/beach/sand{dir = 8; icon_state = "beach"},/area/virtual_reality/beach)
"f" = (/obj/structure/table/standard,/obj/item/clothing/glasses/sunglasses,/obj/item/clothing/head/collectable/petehat{pixel_y = 5},/turf/simulated/floor/holofloor/beach/sand,/area/virtual_reality/beach)
"h" = (/obj/structure/bed/chair,/obj/effect/landmark{name = "vr entrance"},/turf/simulated/floor/holofloor/beach/sand,/area/virtual_reality/beach)
"i" = (/obj/structure/table/rack/holorack,/obj/item/clothing/shoes/sandal,/obj/item/clothing/shoes/sandal,/obj/item/clothing/shoes/sandal,/obj/item/clothing/shoes/sandal,/obj/item/clothing/shoes/sandal,/obj/item/clothing/shoes/sandal,/obj/item/clothing/shoes/sandal,/obj/item/clothing/shoes/sandal,/obj/item/clothing/shoes/sandal,/obj/item/clothing/shoes/sandal,/obj/item/clothing/shoes/sandal,/obj/item/clothing/shoes/sandal,/turf/simulated/floor/holofloor/beach/sand,/area/virtual_reality/beach)
"j" = (/obj/effect/overlay/palmtree_l,/turf/simulated/floor/holofloor/beach/sand,/area/virtual_reality/beach)
"k" = (/turf/simulated/floor/holofloor/beach/water,/area/virtual_reality/beach)
"l" = (/obj/structure/table/standard,/obj/item/reagent_containers/food/drinks/bottle/small/beer,/obj/item/reagent_containers/food/drinks/bottle/small/beer,/obj/item/reagent_containers/food/drinks/bottle/small/beer,/obj/item/reagent_containers/food/drinks/bottle/small/beer,/obj/item/reagent_containers/food/drinks/bottle/small/beer,/obj/item/reagent_containers/food/drinks/bottle/small/beer,/obj/item/reagent_containers/food/drinks/bottle/small/beer,/turf/simulated/floor/holofloor/beach/sand,/area/virtual_reality/beach)
"m" = (/turf/simulated/floor/holofloor/beach/sand{icon_state = "desert3"},/area/virtual_reality/beach)
"n" = (/obj/effect/overlay/palmtree_r,/turf/simulated/floor/holofloor/beach/sand,/area/virtual_reality/beach)
"p" = (/turf/simulated/floor/holofloor/beach/sand{icon_state = "desert1"},/area/virtual_reality/beach)
"s" = (/obj/item/device/boombox,/turf/simulated/floor/holofloor/beach/sand,/area/virtual_reality/beach)
"t" = (/turf/simulated/floor/holofloor/beach/sand{icon_state = "desert2"},/area/virtual_reality/beach)
"v" = (/obj/effect/overlay/palmtree_r,/obj/effect/overlay/coconut,/turf/simulated/floor/holofloor/beach/sand,/area/virtual_reality/beach)
"w" = (/obj/item/inflatable_duck,/turf/simulated/floor/holofloor/beach/sand,/area/virtual_reality/beach)
"x" = (/turf/simulated/floor/holofloor/beach/sand,/area/virtual_reality/beach)
"A" = (/obj/item/clothing/head/collectable/paper,/turf/simulated/floor/holofloor/beach/sand,/area/virtual_reality/beach)
"B" = (/turf/unsimulated/beach/sand{density = 1; opacity = 1},/area/virtual_reality/beach)
"D" = (/turf/simulated/floor/holofloor/beach/sand{icon_state = "desert4"},/area/virtual_reality/beach)
"E" = (/obj/structure/table/standard,/obj/item/reagent_containers/food/snacks/chips,/turf/simulated/floor/holofloor/beach/sand,/area/virtual_reality/beach)
"F" = (/obj/structure/table/standard,/obj/item/reagent_containers/food/drinks/cans/cola,/obj/item/reagent_containers/food/drinks/cans/cola,/obj/item/reagent_containers/food/drinks/cans/cola,/obj/item/reagent_containers/food/drinks/cans/cola,/obj/item/reagent_containers/food/drinks/cans/cola,/obj/item/reagent_containers/food/drinks/cans/cola,/turf/simulated/floor/holofloor/beach/sand,/area/virtual_reality/beach)
"G" = (/turf/simulated/floor/holofloor/beach/sand{icon_state = "desert_dug"},/area/virtual_reality/beach)
"H" = (/turf/simulated/floor/holofloor/beach/sand{dir = 6; icon_state = "beach"},/area/virtual_reality/beach)
"I" = (/turf/simulated/floor/holofloor/beach/sand{dir = 4; icon_state = "beach"},/area/virtual_reality/beach)
"K" = (/obj/effect/landmark{name = "vr entrance"},/turf/simulated/floor/holofloor/beach/sand,/area/virtual_reality/beach)
"L" = (/turf/simulated/floor/holofloor/beach/sand{dir = 9; icon_state = "beach"},/area/virtual_reality/beach)
"M" = (/obj/effect/landmark{name = "vr entrance"},/turf/simulated/floor/holofloor/beach/sand{icon_state = "desert4"},/area/virtual_reality/beach)
"O" = (/turf/simulated/floor/holofloor/beach/sand{icon_state = "beach"},/area/virtual_reality/beach)
"P" = (/turf/simulated/floor/holofloor/beach/sand{dir = 1; icon_state = "beachcorner"},/area/virtual_reality/beach)
"T" = (/obj/item/beach_ball,/turf/simulated/floor/holofloor/beach/sand,/area/virtual_reality/beach)
"V" = (/turf/simulated/floor/holofloor/beach/sand{dir = 5; icon_state = "beach"},/area/virtual_reality/beach)
"Y" = (/turf/simulated/floor/holofloor/beach/sand{icon_state = "beachcorner"},/area/virtual_reality/beach)
"Z" = (/turf/simulated/floor/holofloor/beach/sand{dir = 10; icon_state = "beach"},/area/virtual_reality/beach)

(1,1,1) = {"
aaaaaaaaaaaaaaaaaaaaaaaaa
aBBBBBBBBBBBBBBBBBBBBBBBa
aBxxxxxxxxxxxxxxxxxxxxxBa
aBxxmxxxxxxxxxxxxxxxxxxBa
aBxjxxxpxcccixxxxxxxxvxBa
aBxxxxxxxxxpmxxxbxxxxxxBa
aBxxxxxxpxxxxxxxjxxxxxxBa
aBxxxxxnbxxxxxxxxxxxpxxBa
aBxxxxxxKKxxxxxxxxxxxxxBa
aBxmxxxKlfKxpxxxxxxxxxxBa
aBxxxxGMEFKxxnxTxxxxxxxBa
aBxxxxxxKKxxxxpxxsxxxxxBa
aBxxxbxxxxxxxxxxxDxjxxxBa
aBxpxnwxxxxxxxxxxxxbxxxBa
aBxxxbxxxxhxhxhxxxxpxxxBa
aBxmxxAxxxxxxxxxxxxxxxxBa
aBxxYOOOOOOOOOOOOOPmxxxBa
aBOOHkkkkkkkkkkkkkZOOOOBa
aBkkkkkkkkkkkkkkkkkkkkkBa
aBkkkkkkkkkkkkkkkkkkkkkBa
aBkkkkkkkkkkkkkkkkkkkkkBa
aBkkkkkkkkkkLddddVkkkkkBa
aBkkkkkkkkkketxxmIkkkkkBa
aBkkkkkkkkkkZOOOOHkkkkkBa
aBkkkkkkkkkkkkkkkkkkkkkBa
aBkkkkkkkkkkkkkkkkkkkkkBa
aBkkkkkkkkkkkkkkkkkkkkkBa
aBkkkkkkkkkkkkkkkkkkkkkBa
aBBBBBBBBBBBBBBBBBBBBBBBa
aaaaaaaaaaaaaaaaaaaaaaaaa
"}
