"a" = (/turf/simulated/floor/plating,/area/admin/test_ship)
"b" = (/turf/space,/area/admin/test_ship)
"c" = (/turf/simulated/wall,/area/admin/test_ship)
"d" = (/turf/simulated/wall/r_wall,/area/admin/test_ship)
"e" = (/obj/effect/landmark/map_data{name = "HMS Sea Shanty"; opacity = 0},/turf/space,/area/admin/test_ship)
"f" = (/turf/simulated/floor/plating,/area/admin/test_ship_bridge)
"g" = (/obj/machinery/light,/turf/simulated/floor/plating,/area/admin/test_ship_bridge)
"h" = (/obj/effect/overmap/ship/dev_testing,/turf/space,/area/admin/test_ship)
"i" = (/obj/machinery/computer/helm,/turf/simulated/floor/plating,/area/admin/test_ship_bridge)
"j" = (/obj/machinery/power/apc,/turf/simulated/floor/plating,/area/admin/test_ship_bridge)

(1,1,1) = {"
bbbbbbbbbbbbbbbbbbbbbbbbbbbbbbbbbbbbbbbbbbbbbbbbbbbbbbbbbbbbbbbbbbbbbbbbbbbbbbbbbbbbbbbbbbbbbbbbbbbb
bbbbbbbbbbbbbbbbbbbbbbbbbbbbbbbbbbbbbbbbbbbbbbbbbbbbbbbbbbbbbbbbbbbbbbbbbbbbbbbbbbbbbbbbbbbbbbbbbbbb
bbbbbbbbbbbbbbbbbbbbbbbbbbbbbbbbbbbbbbbbbbbbbbbbbbbbbbbbbbbbbbbbbbbbbbbbbbbbbbbbbbbbbbbbbbbbbbbbbbbb
bbbbbbbbbbbbbbbbbbbbbbbbbbbbbbbbbbbbbbbbbbbbbbbbbbbbbbbbbbbbbbbbbbbbbbbbbbbbbbbbbbbbbbbbbbbbbbbbbbbb
bbbbbbbbbbbbbbbbbbbbbbbbbbbbbbbbbbbbbbbbbbbbbbbbbbbbbbbbbbbbbbbbbbbbbbbbbbbbbbbbbbbbbbbbbbbbbbbbbbbb
bbbbbbbbbbbbbbbbbbbbbbbbbbbbbbbbbbbbbbbbbbbbbbbbbbbbbbbbbbbbbbbbbbbbbbbbbbbbbbbbbbbbbbbbbbbbbbbbbbbb
bbbbbbbbbbbbbbbbbbbbbbbbbbbbbbbbbbbbbbbbbbbbbbbbbbbbbbbbbbbbbbbbbbbbbbbbbbbbbbbbbbbbbbbbbbbbbbbbbbbb
bbbbbbbbbbbbbbbbbbbbbbbbbbbbbbbbbbbbbbbbbbbbbbbbbbbbbbbbbbbbbbbbbbbbbbbbbbbbbbbbbbbbbbbbbbbbbbbbbbbb
bbbbbbbbbbbbbbbbbbbbbbbbbbbbbbbbbbbbbbbbbbbbbbbbbbbbbbbbbbbbbbbbbbbbbbbbbbbbbbbbbbbbbbbbbbbbbbbbbbbb
bbbbbbbbbbbbbbbbbbbbbbbbbbbbbbbbbbbbbbbbbbbbbbbbbbbbbbbbbbbbbbbbbbbbbbbbbbbbbbbbbbbbbbbbbbbbbbbbbbbb
bbbbbbbbbbbbbbbbbbbbbbbbbbbbbbbbbbbbbbbbbbbbbbbbbbbbbbbbbbbbbbbbbbbbbbbbbbbbbbbbbbbbbbbbbbbbbbbbbbbb
bbbbbbbbbbbbbbddddddddddddddddddddddddddddddddddddddddddddddddddddddddddddddddddddddddddddddbbbbbbbb
bbbbbbbbbbbbbbddddddddddddddddddddddddddddddddddddddddddddddddddddddddddddddddddddddddddddddbbbbbbbb
bbbbbbbbbbbbbbddddddddddddddddddddddddddddddddddddddddddddddddddddddddddddddddddddddddddddddbbbbbbbb
bbbbbbbbbbbbbbddddddddddddddddddddddddddddddddddddddddddddddddddddddddddddddddddddddddddddddbbbbbbbb
bbbbbbbbbbbbbbddddddddddddddddddddddddddddddddddddddddddddddddddddddddddddddddddddddddddddddbbbbbbbb
bbbbbbbbbbbbbbddddddddddddddddddddddddddddddddddddddddddddddddddddddddddddddddddddddddddddddbbbbbbbb
bbbbbbbbbbbbbbddddddddddddddddddddddddddddddddddddddddddddddddddddddddddddddddddddddddddddddbbbbbbbb
bbbbbbbbbbbbbbdddddaaaaaaaaaaaacaaaaaaaaaaaaaaaaaaacaaaaaaaaaaaaaaaaacaaaaaaaaaaaaaaaaadddddbbbbbbbb
bbbbbbbbbbbbbbdddddaaaaaaaaaaaacaaaaaaaaaaaaaaaaaaacaaaaaaaaaaaaaaaaacaaaaaaaaaaaaaaaaadddddbbbbbbbb
bbbbbbbbbbbbbbdddddaaaaaaaaaaaacaaaaaaaaaaaaaaaaaaacaaaaaaaaaaaaaaaaacaaaaaaaaaaaaaaaaadddddbbbbbbbb
bbbbbbbbbbbbbbdddddaaaaaaaaaaaacaaaaaaaaaaaaaaaaaaacaaaaaaaaaaaaaaaaacaaaaaaaaaaaaaaaaadddddbbbbbbbb
bbbbbbbbbbbbbbdddddaaaaaaaaaaaacaaaaaaaaaaaaaaaaaaacaaaaaaaaaaaaaaaaacaaaaaaaaaaaaaaaaadddddbbbbbbbb
bbbbbbbbbbbbbbdddddaaaaaaaaaaaacaaaaaaaaaaaaaaaaaaacaaaaaaaaaaaaaaaaacaaaaaaaaaaaaaaaaadddddbbbbbbbb
bbbbbbbbbbbbbbdddddaaaaaaaaaaaacaaaaaaaaaaaaaaaaaaacaaaaaaaaaaaaaaaaacaaaaaaaaaaaaaaaaadddddbbbbbbbb
bbbbbbbbbbbbbbdddddaaaaaaaaaaaacaaaaaaaaaaaaaaaaaaacaaaaaaaaaaaaaaaaacaaaaaaaaaaaaaaaaadddddbbbbbbbb
bbbbbbbbbbbbbbdddddaaaaaaaaaaaacaaaaaaaaaaaaaaaaaaacaaaaaaaaaaaaaaaaacaaaaaaaaaaaaaaaaadddddbbbbbbbb
bbbbbbbbbbbbbbdddddccccccccccccccccccccccccccccccccccccccccccccccccccccccccccccccccccccdddddbbbbbbbb
bbbbbbbbbbbbbbdddddaaaaaaaaaaaacaaaaaaaaaaaaaaaaaaacaaaaaaaaaaaaaaaaacaaaaaaaaaaaaaaaaadddddbbbbbbbb
bbbbbbbbbbbbbbdddddaaaaaaaaaaaacaaaaaaaaaaaaaaaaaaacaaaaaaaaaaaaaaaaacaaaaaaaaaaaaaaaaadddddbbbbbbbb
bbbbbbbbbbbbbbdddddaaaaaaaaaaaacaaaaaaaaaaaaaaaaaaacaaaaaaaaaaaaaaaaacaaaaaaaaaaaaaaaaadddddbbbbbbbb
bbbbbbbbbbbbbbdddddaaaaaaaaaaaacaaaaaaaaaaaaaaaaaaacaaaaaaaaaaaaaaaaacaaaaaaaaaaaaaaaaadddddbbbbbbbb
bbbbbbbbbbbbbbdddddaaaaaaaaaaaacaaaaaaaaaaaaaaaaaaacaaaaaaaaaaaaaaaaacaaaaaaaaaaaaaaaaadddddbbbbbbbb
bbbbbbbbbbbbbbdddddaaaaaaaaaaaacaaaaaaaaaaaaaaaaaaacaaaaaaaaaaaaaaaaacaaaaaaaaaaaaaaaaadddddbbbbbbbb
bbbbbbbbbbbbbbdddddaaaaaaaaaaaacaaaaaaaaaaaaaaaaaaacaaaaaaaaaaaaaaaaacaaaaaaaaaaaaaaaaadddddbbbbbbbb
bbbbbbbbbbbbbbdddddaaaaaaaaaaaacaaaaaaaaaaaaaaaaaaacaaaaaaaaaaaaaaaaacaaaaaaaaaaaaaaaaadddddbbbbbbbb
bbbbbbbbbbbbbbdddddaaaaaaaaaaaacaaaaaaaaaaaaaaaaaaacaaaaaaaaaaaaaaaaacaaaaaaaaaaaaaaaaadddddbbbbbbbb
bbbbbbbbbbbbbbdddddaaaaaaaaaaaacaaaaaaaaaaaaaaaaaaacaaaaaaaaaaaaaaaaacaaaaaaaaaaaaaaaaadddddbbbbbbbb
bbbbbbbbbbbbbbdddddaaaaaaaaaaaacaaaaaaaaaaaaaaaaaaacaaaaaaaaaaaaaaaaacaaaaaaaaaaaaaaaaadddddbbbbbbbb
bbbbbbbbbbbbbbdddddaaaaaaaaaaaacaaaaaaaaaaaaaaaaaaacaaaaaaaaaaaaaaaaacaaaaaaaaaaaaaaaaadddddbbbbbbbb
bbbbbbbbbbbbbbdddddaaaaaaaaaaaacaaaaaaaaaaaaaaaaaaaccccccccccaaaaaaaacaaaaaaaaaaaaaaaaadddddbbbbbbbb
bbbbbbbbbbbbbbdddddaaaaaaaaaaaacaaaaaaaaaaaaaaaaaaacffffgfffcaaaaaaaacaaaaaaaaaaaaaaaaadddddbbbbbbbb
bbbbbbbbbbbbbbdddddaaaaaaaaaaaacaaaaaaaaaaaaaaaaaaacffffffffcaaaaaaaacaaaaaaaaaaaaaaaaadddddbbbbbbbb
bbbbbbbbbbbbbbdddddaaaaaaaaaaaacaaaaaaaaaaaaaaaaaaacfffffjffcaaaaaaaacaaaaaaaaaaaaaaaaadddddbbbbbbbb
bbbbbbbbbbbbbbdddddaaaaaaaaaaaacaaaaaaaaaaaaaaaaaaacgffffffgcaaaaaaaacaaaaaaaaaaaaaaaaadddddbbbbbbbb
bbbbbbbbbbbbbbdddddaaaaaaaaaaaacaaaaaaaaaaaaaaaaaaacffffffffcaaaaaaaacaaaaaaaaaaaaaaaaadddddbbbbbbbb
bbbbbbbbbbbbbbdddddaaaaaaaaaaaacaaaaaaaaaaaaaaaaaaacffffffffcaaaaaaaacaaaaaaaaaaaaaaaaadddddbbbbbbbb
bbbbbbbbbbbbbbdddddaaaaaaaaaaaacaaaaaaaaaaaaaaaaaaaciffgffffcaaaaaaaacaaaaaaaaaaaaaaaaadddddbbbbbbbb
bbbbbbbbbbbbbbdddddccccccccccccccccccccccccccccccccccccccccccccccccccccccccccccccccccccdddddbbbbbbbb
bbbbbbbbbbbbbbdddddaaaaaaaaaaaacaaaaaaaaaaaaaaaaaaacaaaaaaaaaaaaaaaaacaaaaaaaaaaaaaaaaadddddbbbbbbbb
bbbbbbbbbbbbbbdddddaaaaaaaaaaaacaaaaaaaaaaaaaaaaaaacaaaaaaaaaaaaaaaaacaaaaaaaaaaaaaaaaadddddbbbbbbbb
bbbbbbbbbbbbbbdddddaaaaaaaaaaaacaaaaaaaaaaaaaaaaaaacaaaaaaaaaaaaaaaaacaaaaaaaaaaaaaaaaadddddbbbbbbbb
bbbbbbbbbbbbbbdddddaaaaaaaaaaaacaaaaaaaaaaaaaaaaaaacaaaaaaaaaaaaaaaaacaaaaaaaaaaaaaaaaadddddbbbbbbbb
bbbbbbbbbbbbbbdddddaaaaaaaaaaaacaaaaaaaaaaaaaaaaaaacaaaaaaaaaaaaaaaaacaaaaaaaaaaaaaaaaadddddbbbbbbbb
bbbbbbbbbbbbbbdddddaaaaaaaaaaaacaaaaaaaaaaaaaaaaaaacaaaaaaaaaaaaaaaaacaaaaaaaaaaaaaaaaadddddbbbbbbbb
bbbbbbbbbbbbbbdddddaaaaaaaaaaaacaaaaaaaaaaaaaaaaaaacaaaaaaaaaaaaaaaaacaaaaaaaaaaaaaaaaadddddbbbbbbbb
bbbbbbbbbbbbbbdddddaaaaaaaaaaaacaaaaaaaaaaaaaaaaaaacaaaaaaaaaaaaaaaaacaaaaaaaaaaaaaaaaadddddbbbbbbbb
bbbbbbbbbbbbbbdddddaaaaaaaaaaaacaaaaaaaaaaaaaaaaaaacaaaaaaaaaaaaaaaaacaaaaaaaaaaaaaaaaadddddbbbbbbbb
bbbbbbbbbbbbbbdddddaaaaaaaaaaaacaaaaaaaaaaaaaaaaaaacaaaaaaaaaaaaaaaaacaaaaaaaaaaaaaaaaadddddbbbbbbbb
bbbbbbbbbbbbbbdddddaaaaaaaaaaaacaaaaaaaaaaaaaaaaaaacaaaaaaaaaaaaaaaaacaaaaaaaaaaaaaaaaadddddbbbbbbbb
bbbbbbbbbbbbbbdddddaaaaaaaaaaaacaaaaaaaaaaaaaaaaaaacaaaaaaaaaaaaaaaaacaaaaaaaaaaaaaaaaadddddbbbbbbbb
bbbbbbbbbbbbbbdddddaaaaaaaaaaaacaaaaaaaaaaaaaaaaaaacaaaaaaaaaaaaaaaaacaaaaaaaaaaaaaaaaadddddbbbbbbbb
bbbbbbbbbbbbbbdddddaaaaaaaaaaaacaaaaaaaaaaaaaaaaaaacaaaaaaaaaaaaaaaaacaaaaaaaaaaaaaaaaadddddbbbbbbbb
bbbbbbbbbbbbbbdddddaaaaaaaaaaaacaaaaaaaaaaaaaaaaaaacaaaaaaaaaaaaaaaaacaaaaaaaaaaaaaaaaadddddbbbbbbbb
bbbbbbbbbbbbbbdddddaaaaaaaaaaaacaaaaaaaaaaaaaaaaaaacaaaaaaaaaaaaaaaaacaaaaaaaaaaaaaaaaadddddbbbbbbbb
bbbbbbbbbbbbbbdddddaaaaaaaaaaaacaaaaaaaaaaaaaaaaaaacaaaaaaaaaaaaaaaaacaaaaaaaaaaaaaaaaadddddbbbbbbbb
bbbbbbbbbbbbbbdddddaaaaaaaaaaaacaaaaaaaaaaaaaaaaaaacaaaaaaaaaaaaaaaaacaaaaaaaaaaaaaaaaadddddbbbbbbbb
bbbbbbbbbbbbbbdddddaaaaaaaaaaaacaaaaaaaaaaaaaaaaaaacaaaaaaaaaaaaaaaaacaaaaaaaaaaaaaaaaadddddbbbbbbbb
bbbbbbbbbbbbbbdddddaaaaaaaaaaaacaaaaaaaaaaaaaaaaaaacaaaaaaaaaaaaaaaaacaaaaaaaaaaaaaaaaadddddbbbbbbbb
bbbbbbbbbbbbbbdddddaaaaaaaaaaaacaaaaaaaaaaaaaaaaaaacaaaaaaaaaaaaaaaaacaaaaaaaaaaaaaaaaadddddbbbbbbbb
bbbbbbbbbbbbbbdddddaaaaaaaaaaaacaaaaaaaaaaaaaaaaaaacaaaaaaaaaaaaaaaaacaaaaaaaaaaaaaaaaadddddbbbbbbbb
bbbbbbbbbbbbbbdddddccccccccccccccccccccccccccccccccccccccccccccccccccccccccccccccccccccdddddbbbbbbbb
bbbbbbbbbbbbbbdddddaaaaaaaaaaaacaaaaaaaaaaaaaaaaaaacaaaaaaaaaaaaaaaaacaaaaaaaaaaaaaaaaadddddbbbbbbbb
bbbbbbbbbbbbbbdddddaaaaaaaaaaaacaaaaaaaaaaaaaaaaaaacaaaaaaaaaaaaaaaaacaaaaaaaaaaaaaaaaadddddbbbbbbbb
bbbbbbbbbbbbbbdddddaaaaaaaaaaaacaaaaaaaaaaaaaaaaaaacaaaaaaaaaaaaaaaaacaaaaaaaaaaaaaaaaadddddbbbbbbbb
bbbbbbbbbbbbbbdddddaaaaaaaaaaaacaaaaaaaaaaaaaaaaaaacaaaaaaaaaaaaaaaaacaaaaaaaaaaaaaaaaadddddbbbbbbbb
bbbbbbbbbbbbbbdddddaaaaaaaaaaaacaaaaaaaaaaaaaaaaaaacaaaaaaaaaaaaaaaaacaaaaaaaaaaaaaaaaadddddbbbbbbbb
bbbbbbbbbbbbbbdddddaaaaaaaaaaaacaaaaaaaaaaaaaaaaaaacaaaaaaaaaaaaaaaaacaaaaaaaaaaaaaaaaadddddbbbbbbbb
bbbbbbbbbbbbbbdddddaaaaaaaaaaaacaaaaaaaaaaaaaaaaaaacaaaaaaaaaaaaaaaaacaaaaaaaaaaaaaaaaadddddbbbbbbbb
bbbbbbbbbbbbbbdddddaaaaaaaaaaaacaaaaaaaaaaaaaaaaaaacaaaaaaaaaaaaaaaaacaaaaaaaaaaaaaaaaadddddbbbbbbbb
bbbbbbbbbbbbbbdddddaaaaaaaaaaaacaaaaaaaaaaaaaaaaaaacaaaaaaaaaaaaaaaaacaaaaaaaaaaaaaaaaadddddbbbbbbbb
bbbbbbbbbbbbbbdddddaaaaaaaaaaaacaaaaaaaaaaaaaaaaaaacaaaaaaaaaaaaaaaaacaaaaaaaaaaaaaaaaadddddbbbbbbbb
bbbbbbbbbbbbbbdddddaaaaaaaaaaaacaaaaaaaaaaaaaaaaaaacaaaaaaaaaaaaaaaaacaaaaaaaaaaaaaaaaadddddbbbbbbbb
bbbbbbbbbbbbbbdddddaaaaaaaaaaaacaaaaaaaaaaaaaaaaaaacaaaaaaaaaaaaaaaaacaaaaaaaaaaaaaaaaadddddbbbbbbbb
bbbbbbbbbbbbbbdddddaaaaaaaaaaaacaaaaaaaaaaaaaaaaaaacaaaaaaaaaaaaaaaaacaaaaaaaaaaaaaaaaadddddbbbbbbbb
bbbbbbbbbbbbbbdddddaaaaaaaaaaaacaaaaaaaaaaaaaaaaaaacaaaaaaaaaaaaaaaaacaaaaaaaaaaaaaaaaadddddbbbbbbbb
bbbbbbbbbbbbbbddddddddddddddddddddddddddddddddddddddddddddddddddddddddddddddddddddddddddddddbbbbbbbb
bbbbbbbbbbbbbbddddddddddddddddddddddddddddddddddddddddddddddddddddddddddddddddddddddddddddddbbbbbbbb
bbbbbbbbbbbbbbddddddddddddddddddddddddddddddddddddddddddddddddddddddddddddddddddddddddddddddbbbbbbbb
bbbbbbbbbbbbbbddddddddddddddddddddddddddddddddddddddddddddddddddddddddddddddddddddddddddddddbbbbbbbb
bbbbbbbbbbbbbbddddddddddddddddddddddddddddddddddddddddddddddddddddddddddddddddddddddddddddddbbbbbbbb
bbbbbbbbbbbbbbbbbbbbbbbbbbbbbbbbbbbbbbbbbbbbbbbbbbbbbbbbbbbbbbbbbbbbbbbbbbbbbbbbbbbbbbbbbbbbbbbbbbbb
bbbbbbbbbbbbbbbbbbbbbbbbbbbbbbbbbbbbbbbbbbbbbbbbbbbbbbbbbbbbbbbbbbbbbbbbbbbbbbbbbbbbbbbbbbbbbbbbbbbb
bbbbbbbbbbbbbbbbbbbbbbbbbbbbbbbbbbbbbbbbbbbbbbbbbbbbbbbbbbbbbbbbbbbbbbbbbbbbbbbbbbbbbbbbbbbbbbbbbbbb
bbbbbbbbbbbbbbbbbbbbbbbbbbbbbbbbbbbbbbbbbbbbbbbbbbbbbbbbbbbbbbbbbbbbbbbbbbbbbbbbbbbbbbbbbbbbbbbbbbbb
bbbbbbbbbbbbbbbbbbbbbbbbbbbbbbbbbbbbbbbbbbbbbbbbbbbbbbbbbbbbbbbbbbbbbbbbbbbbbbbbbbbbbbbbbbbbbbbbbbbb
bbbbbbbbbbbbbbbbbbbbbbbbbbbbbbbbbbbbbbbbbbbbbbbbbbbbbbbbbbbbbbbbbbbbbbbbbbbbbbbbbbbbbbbbbbbbbbbbbbbb
bbbbbbbbbbbbbbbbbbbbbbbbbbbbbbbbbbbbbbbbbbbbbbbbbbbbbbbbbbbbbbbbbbbbbbbbbbbbbbbbbbbbbbbbbbbbbbbbbbbb
bbbbbbbbbbbbbbbbbbbbbbbbbbbbbbbbbbbbbbbbbbbbbbbbbbbbbbbbbbbbbbbbbbbbbbbbbbbbbbbbbbbbbbbbbbbbbbbbbbbb
hebbbbbbbbbbbbbbbbbbbbbbbbbbbbbbbbbbbbbbbbbbbbbbbbbbbbbbbbbbbbbbbbbbbbbbbbbbbbbbbbbbbbbbbbbbbbbbbbbb
"}
