"aa" = (/turf/space,/area/space)
"ab" = (/turf/simulated/wall,/area/rnd/xenobiology/xenoflora)
"ac" = (/obj/machinery/atmospherics/unary/freezer,/turf/simulated/floor,/area/rnd/xenobiology/xenoflora)
"ad" = (/obj/machinery/portable_atmospherics/hydroponics,/obj/machinery/atmospherics/portables_connector,/obj/machinery/light{tag = "icon-tube1 (NORTH)"; icon_state = "tube1"; dir = 1},/turf/simulated/floor,/area/rnd/xenobiology/xenoflora)
"ae" = (/obj/machinery/atmospherics/unary/heater,/turf/simulated/floor,/area/rnd/xenobiology/xenoflora)
"af" = (/obj/machinery/atmospherics/pipe/manifold/visible{tag = "icon-map (WEST)"; icon_state = "map"; dir = 8},/turf/simulated/floor,/area/rnd/xenobiology/xenoflora)
"ag" = (/obj/machinery/atmospherics/pipe/manifold/visible,/obj/machinery/meter,/turf/simulated/floor,/area/rnd/xenobiology/xenoflora)
"ah" = (/obj/machinery/atmospherics/pipe/manifold/visible{tag = "icon-map (EAST)"; icon_state = "map"; dir = 4},/turf/simulated/floor,/area/rnd/xenobiology/xenoflora)
"ai" = (/obj/machinery/atmospherics/binary/passive_gate{dir = 2; icon_state = "map"; regulate_mode = 1; tag = "icon-map (NORTH)"; target_pressure = 80},/turf/simulated/floor,/area/rnd/xenobiology/xenoflora)
"aj" = (/turf/simulated/floor,/area/rnd/xenobiology/xenoflora)
"ak" = (/obj/machinery/atmospherics/binary/passive_gate{dir = 1; icon_state = "map"; regulate_mode = 1; tag = "icon-map (NORTH)"; target_pressure = 80},/turf/simulated/floor,/area/rnd/xenobiology/xenoflora)
"al" = (/obj/machinery/atmospherics/pipe/simple/visible/purple{tag = "icon-intact (NORTHEAST)"; icon_state = "intact"; dir = 5},/turf/simulated/floor,/area/rnd/xenobiology/xenoflora)
"am" = (/obj/machinery/atmospherics/pipe/simple/visible/purple{tag = "icon-intact (EAST)"; icon_state = "intact"; dir = 4},/turf/simulated/floor,/area/rnd/xenobiology/xenoflora)
"an" = (/obj/machinery/atmospherics/pipe/simple/visible/green,/obj/machinery/atmospherics/pipe/simple/visible/purple{tag = "icon-intact (EAST)"; icon_state = "intact"; dir = 4},/turf/simulated/floor,/area/rnd/xenobiology/xenoflora)
"ao" = (/obj/machinery/atmospherics/pipe/manifold/visible/purple,/turf/simulated/floor,/area/rnd/xenobiology/xenoflora)
"ap" = (/obj/machinery/atmospherics/pipe/simple/visible/purple{tag = "icon-intact (EAST)"; icon_state = "intact"; dir = 4},/obj/machinery/meter,/turf/simulated/floor,/area/rnd/xenobiology/xenoflora)
"aq" = (/obj/machinery/atmospherics/pipe/manifold4w/visible/purple,/turf/simulated/floor,/area/rnd/xenobiology/xenoflora)
"ar" = (/obj/machinery/atmospherics/pipe/manifold/visible/purple{tag = "icon-map (NORTH)"; icon_state = "map"; dir = 1},/turf/simulated/floor,/area/rnd/xenobiology/xenoflora)
"as" = (/obj/machinery/atmospherics/pipe/simple/visible/purple{tag = "icon-intact (NORTHWEST)"; icon_state = "intact"; dir = 9},/turf/simulated/floor,/area/rnd/xenobiology/xenoflora)
"at" = (/obj/machinery/atmospherics/pipe/simple/visible/green,/turf/simulated/floor,/area/rnd/xenobiology/xenoflora)
"au" = (/obj/machinery/atmospherics/pipe/simple/visible/green{tag = "icon-intact (SOUTHEAST)"; icon_state = "intact"; dir = 6},/turf/simulated/floor,/area/rnd/xenobiology/xenoflora)
"av" = (/obj/machinery/atmospherics/pipe/manifold/visible/green,/turf/simulated/floor,/area/rnd/xenobiology/xenoflora)
"aw" = (/obj/machinery/atmospherics/pipe/simple/visible/green{tag = "icon-intact (EAST)"; icon_state = "intact"; dir = 4},/turf/simulated/floor,/area/rnd/xenobiology/xenoflora)
"ax" = (/obj/machinery/atmospherics/pipe/simple/visible/green{tag = "icon-intact (EAST)"; icon_state = "intact"; dir = 4},/obj/machinery/meter,/turf/simulated/floor,/area/rnd/xenobiology/xenoflora)
"ay" = (/obj/machinery/atmospherics/pipe/manifold/visible/green{tag = "icon-map (EAST)"; icon_state = "map"; dir = 4},/turf/simulated/floor,/area/rnd/xenobiology/xenoflora)
"az" = (/obj/machinery/atmospherics/binary/pump/high_power/on,/turf/simulated/floor,/area/rnd/xenobiology/xenoflora)
"aA" = (/obj/machinery/atmospherics/pipe/manifold/visible/green{tag = "icon-map (WEST)"; icon_state = "map"; dir = 8},/turf/simulated/floor,/area/rnd/xenobiology/xenoflora)
"aB" = (/obj/machinery/atmospherics/pipe/manifold/visible/green{tag = "icon-map (NORTH)"; icon_state = "map"; dir = 1},/turf/simulated/floor,/area/rnd/xenobiology/xenoflora)
"aC" = (/obj/machinery/atmospherics/pipe/simple/visible/green{tag = "icon-intact (NORTHWEST)"; icon_state = "intact"; dir = 9},/turf/simulated/floor,/area/rnd/xenobiology/xenoflora)
"aD" = (/obj/machinery/atmospherics/portables_connector{tag = "icon-map_connector (EAST)"; icon_state = "map_connector"; dir = 4},/obj/machinery/portable_atmospherics/canister/air,/turf/simulated/floor,/area/rnd/xenobiology/xenoflora)
"aE" = (/obj/machinery/atmospherics/pipe/simple/visible/green{tag = "icon-intact (NORTHEAST)"; icon_state = "intact"; dir = 5},/turf/simulated/floor,/area/rnd/xenobiology/xenoflora)
"aF" = (/obj/machinery/atmospherics/portables_connector{tag = "icon-map_connector (WEST)"; icon_state = "map_connector"; dir = 8},/obj/machinery/portable_atmospherics/canister/air,/turf/simulated/floor,/area/rnd/xenobiology/xenoflora)
"aG" = (/obj/machinery/atmospherics/portables_connector{tag = "icon-map_connector (EAST)"; icon_state = "map_connector"; dir = 4},/obj/machinery/portable_atmospherics/canister/air,/obj/machinery/light{tag = "icon-tube1 (WEST)"; icon_state = "tube1"; dir = 8},/turf/simulated/floor,/area/rnd/xenobiology/xenoflora)
"aH" = (/obj/machinery/atmospherics/portables_connector{tag = "icon-map_connector (WEST)"; icon_state = "map_connector"; dir = 8},/obj/machinery/portable_atmospherics/canister/air,/obj/machinery/light{tag = "icon-tube1 (EAST)"; icon_state = "tube1"; dir = 4},/turf/simulated/floor,/area/rnd/xenobiology/xenoflora)
"aI" = (/obj/machinery/atmospherics/portables_connector,/turf/simulated/floor,/area/rnd/xenobiology/xenoflora)
"aJ" = (/obj/machinery/atmospherics/unary/freezer{tag = "icon-freezer_0 (EAST)"; icon_state = "freezer_0"; dir = 4},/turf/simulated/floor,/area/rnd/xenobiology/xenoflora)
"aK" = (/obj/machinery/atmospherics/pipe/manifold/visible{tag = "icon-map (NORTH)"; icon_state = "map"; dir = 1},/turf/simulated/floor,/area/rnd/xenobiology/xenoflora)
"aL" = (/obj/machinery/atmospherics/unary/heater{tag = "icon-heater_0 (WEST)"; icon_state = "heater_0"; dir = 8},/turf/simulated/floor,/area/rnd/xenobiology/xenoflora)
"aM" = (/obj/machinery/power/apc{dir = 8},/obj/structure/cable{tag = "icon-0-2"; icon_state = "0-2"},/turf/simulated/floor,/area/rnd/xenobiology/xenoflora)
"aN" = (/obj/machinery/atmospherics/valve,/turf/simulated/floor,/area/rnd/xenobiology/xenoflora)
"aO" = (/obj/machinery/atmospherics/pipe/simple/visible{tag = "icon-intact (SOUTHEAST)"; icon_state = "intact"; dir = 6},/turf/simulated/floor,/area/rnd/xenobiology/xenoflora)
"aP" = (/obj/machinery/atmospherics/binary/passive_gate{tag = "icon-map (WEST)"; icon_state = "map"; dir = 8},/turf/simulated/floor,/area/rnd/xenobiology/xenoflora)
"aQ" = (/obj/machinery/atmospherics/pipe/manifold/visible,/turf/simulated/floor,/area/rnd/xenobiology/xenoflora)
"aR" = (/obj/machinery/atmospherics/binary/pump{tag = "icon-map_off (WEST)"; icon_state = "map_off"; dir = 8},/turf/simulated/floor,/area/rnd/xenobiology/xenoflora)
"aS" = (/obj/machinery/power/fractal_reactor,/obj/structure/cable,/obj/machinery/light{tag = "icon-tube1 (WEST)"; icon_state = "tube1"; dir = 8},/turf/simulated/floor,/area/rnd/xenobiology/xenoflora)
"aT" = (/obj/machinery/atmospherics/pipe/simple/visible{tag = "icon-intact (NORTHEAST)"; icon_state = "intact"; dir = 5},/turf/simulated/floor,/area/rnd/xenobiology/xenoflora)
"aU" = (/obj/machinery/atmospherics/binary/passive_gate{tag = "icon-map (EAST)"; icon_state = "map"; dir = 4},/turf/simulated/floor,/area/rnd/xenobiology/xenoflora)
"aV" = (/obj/machinery/atmospherics/pipe/simple/visible{tag = "icon-intact (EAST)"; icon_state = "intact"; dir = 4},/turf/simulated/floor,/area/rnd/xenobiology/xenoflora)
"aW" = (/obj/machinery/atmospherics/binary/pump{tag = "icon-map_off (EAST)"; icon_state = "map_off"; dir = 4},/turf/simulated/floor,/area/rnd/xenobiology/xenoflora)
"aX" = (/obj/machinery/atmospherics/pipe/simple/visible{tag = "icon-intact (NORTHWEST)"; icon_state = "intact"; dir = 9},/turf/simulated/floor,/area/rnd/xenobiology/xenoflora)
"aY" = (/obj/machinery/atmospherics/mains_pipe/simple/visible,/turf/simulated/floor,/area/rnd/xenobiology/xenoflora)
"aZ" = (/obj/machinery/atmospherics/mains_pipe/split3/visible{tag = "icon-split-t (NORTH)"; icon_state = "split-t"; dir = 1},/turf/simulated/floor,/area/rnd/xenobiology/xenoflora)
"ba" = (/obj/machinery/atmospherics/pipe/simple/visible{tag = "icon-intact (SOUTHWEST)"; icon_state = "intact"; dir = 10},/turf/simulated/floor,/area/rnd/xenobiology/xenoflora)
"bb" = (/obj/machinery/atmospherics/pipe/simple/visible/universal,/turf/simulated/floor,/area/rnd/xenobiology/xenoflora)
"bc" = (/obj/machinery/atmospherics/pipe/simple/visible/yellow,/turf/simulated/floor,/area/rnd/xenobiology/xenoflora)
"bd" = (/obj/machinery/atmospherics/portables_connector,/obj/machinery/portable_atmospherics/canister/phoron,/turf/simulated/floor,/area/rnd/xenobiology/xenoflora)
"be" = (/obj/machinery/atmospherics/portables_connector,/obj/machinery/portable_atmospherics/canister/oxygen,/turf/simulated/floor,/area/rnd/xenobiology/xenoflora)
"bf" = (/obj/machinery/atmospherics/pipe/simple/visible/scrubbers{tag = "icon-intact-scrubbers (NORTHEAST)"; icon_state = "intact-scrubbers"; dir = 5},/turf/simulated/floor,/area/rnd/xenobiology/xenoflora)
"bg" = (/obj/machinery/atmospherics/pipe/simple/visible/yellow,/obj/machinery/atmospherics/pipe/simple/visible/scrubbers{tag = "icon-intact-scrubbers (SOUTHWEST)"; icon_state = "intact-scrubbers"; dir = 10},/obj/machinery/atmospherics/pipe/simple/visible/supply{tag = "icon-intact-supply (SOUTHEAST)"; icon_state = "intact-supply"; dir = 6},/turf/simulated/floor,/area/rnd/xenobiology/xenoflora)
"bh" = (/obj/machinery/atmospherics/pipe/simple/visible/supply{tag = "icon-intact-supply (NORTHWEST)"; icon_state = "intact-supply"; dir = 9},/turf/simulated/floor,/area/rnd/xenobiology/xenoflora)
"bi" = (/obj/machinery/atmospherics/pipe/simple/visible/yellow,/obj/machinery/atmospherics/pipe/simple/visible/scrubbers,/obj/machinery/atmospherics/pipe/simple/visible/supply,/turf/simulated/floor,/area/rnd/xenobiology/xenoflora)
"bj" = (/obj/machinery/atmospherics/pipe/manifold4w/visible,/turf/simulated/floor,/area/rnd/xenobiology/xenoflora)
"bk" = (/obj/effect/landmark/start,/turf/simulated/floor,/area/rnd/xenobiology/xenoflora)
"bl" = (/obj/machinery/atmospherics/pipe/manifold4w/visible,/obj/machinery/meter,/turf/simulated/floor,/area/rnd/xenobiology/xenoflora)
"bm" = (/obj/machinery/atmospherics/binary/pump/high_power,/turf/simulated/floor,/area/rnd/xenobiology/xenoflora)
"bn" = (/obj/machinery/atmospherics/portables_connector{tag = "icon-map_connector (NORTH)"; icon_state = "map_connector"; dir = 1},/turf/simulated/floor,/area/rnd/xenobiology/xenoflora)

(1,1,1) = {"
aaaaaaaaaaaaaaaaaaaaaaaaaaaaaaaaaaaaaaaaaaaaaaaaaaaaaaaaaaaaaaaaaaaaaaaaaaaaaaaaaaaaaaaaaaaaaaaaaaaaaaaaaaaaaaaaaaaaaaaaaaaaaaaa
aaaaaaaaaaaaaaaaaaaaaaaaaaaaaaaaaaaaaaaaaaaaaaaaaaaaaaaaaaaaaaaaaaaaaaaaaaaaaaaaaaaaaaaaaaaaaaaaaaaaaaaaaaaaaaaaaaaaaaaaaaaaaaaa
aaaaaaaaaaaaaaaaaaaaaaaaaaaaaaaaaaaaaaaaaaaaaaaaaaaaaaaaaaaaaaaaaaaaaaaaaaaaaaaaaaaaaaaaaaaaaaaaaaaaaaaaaaaaaaaaaaaaaaaaaaaaaaaa
aaaaaaaaaaaaaaaaaaaaaaaaaaaaaaaaaaaaaaaaaaaaaaaaaaaaaaaaaaaaaaaaaaaaaaaaaaaaaaaaaaaaaaaaaaaaaaaaaaaaaaaaaaaaaaaaaaaaaaaaaaaaaaaa
aaaaaaaaaaaaaaaaaaaaaaaaaaaaaaaaaaaaaaaaaaaaaaaaaaaaaaaaaaaaaaaaaaaaaaaaaaaaaaaaaaaaaaaaaaaaaaaaaaaaaaaaaaaaaaaaaaaaaaaaaaaaaaaa
aaaaaaaaaaaaaaaaaaaaaaaaaaaaaaaaaaaaaaaaaaaaaaaaaaaaaaaaaaaaaaaaaaaaaaaaaaaaaaaaaaaaaaaaaaaaaaaaaaaaaaaaaaaaaaaaaaaaaaaaaaaaaaaa
aaaaaaaaaaaaaaaaaaaaaaaaaaaaaaaaaaaaaaaaaaaaaaaaaaaaaaaaaaaaaaaaaaaaaaaaaaaaaaaaaaaaaaaaaaaaaaaaaaaaaaaaaaaaaaaaaaaaaaaaaaaaaaaa
aaaaaaaaaaaaaaaaaaaaaaaaaaaaaaaaaaaaaaaaaaaaaaaaaaaaaaaaaaaaaaaaaaaaaaaaaaaaaaaaaaaaaaaaaaaaaaaaaaaaaaaaaaaaaaaaaaaaaaaaaaaaaaaa
aaaaaaaaaaaaaaaaaaaaaaaaaaaaaaaaaaaaaaaaaaaaaaaaaaaaaaaaaaaaaaaaaaaaaaaaaaaaaaaaaaaaaaaaaaaaaaaaaaaaaaaaaaaaaaaaaaaaaaaaaaaaaaaa
aaaaaaaaaaaaaaaaaaaaaaaaaaaaaaaaaaaaaaaaaaaaaaaaaaaaaaaaaaaaaaaaaaaaaaaaaaaaaaaaaaaaaaaaaaaaaaaaaaaaaaaaaaaaaaaaaaaaaaaaaaaaaaaa
aaaaaaaaaaaaaaaaaaaaaaaaaaaaaaaaaaaaaaaaaaaaaaaaaaaaaaaaaaaaaaaaaaaaaaaaaaaaaaaaaaaaaaaaaaaaaaaaaaaaaaaaaaaaaaaaaaaaaaaaaaaaaaaa
aaaaaaaaaaaaaaaaaaaaaaaaaaaaaaaaaaaaaaaaaaaaaaaaaaaaaaaaaaaaaaaaaaaaaaaaaaaaaaaaaaaaaaaaaaaaaaaaaaaaaaaaaaaaaaaaaaaaaaaaaaaaaaaa
aaaaaaaaaaaaaaaaaaaaaaaaaaaaaaaaaaaaaaaaaaaaaaaaaaaaaaaaaaaaaaaaaaaaaaaaaaaaaaaaaaaaaaaaaaaaaaaaaaaaaaaaaaaaaaaaaaaaaaaaaaaaaaaa
aaaaaaaaaaaaaaaaaaaaaaaaaaaaaaaaaaaaaaaaaaaaaaaaaaaaaaaaaaaaaaaaaaaaaaaaaaaaaaaaaaaaaaaaaaaaaaaaaaaaaaaaaaaaaaaaaaaaaaaaaaaaaaaa
aaaaaaaaaaaaaaaaaaaaaaaaaaaaaaaaaaaaaaaaaaaaaaaaaaaaaaaaaaaaaaaaaaaaaaaaaaaaaaaaaaaaaaaaaaaaaaaaaaaaaaaaaaaaaaaaaaaaaaaaaaaaaaaa
aaaaaaaaaaaaaaaaaaaaaaaaaaaaabababababababababababababababababababababababababababababababababababaaaaaaaaaaaaaaaaaaaaaaaaaaaaaa
aaaaaaaaaaaaaaaaaaaaaaaaaaaaabacadaeacadaeacadaeacadaeacadaeacadaeacadaeacadaeacadaeacadaeacadaeabaaaaaaaaaaaaaaaaaaaaaaaaaaaaaa
aaaaaaaaaaaaaaaaaaaaaaaaaaaaabafagahafagahafagahafagahafagahafagahafagahafagahafagahafagahafagahabaaaaaaaaaaaaaaaaaaaaaaaaaaaaaa
aaaaaaaaaaaaaaaaaaaaaaaaaaaaabaiajakaiajakaiajakaiajakaiajakaiajakaiajakaiajakaiajakaiajakaiajakabaaaaaaaaaaaaaaaaaaaaaaaaaaaaaa
aaaaaaaaaaaaaaaaaaaaaaaaaaaaabalamanaoapanaoamanaoapanaqaranaqaranaoapanaoamanaoapanaoamanasajatabaaaaaaaaaaaaaaaaaaaaaaaaaaaaaa
aaaaaaaaaaaaaaaaaaaaaaaaaaaaabajauavawaxavawawavawaxayazazatazazaAawaxavawawavawaxavawawavawaBaCabaaaaaaaaaaaaaaaaaaaaaaaaaaaaaa
aaaaaaaaaaaaaaaaaaaaaaaaaaaaabaDayajajajajajajajajajaEavavavavavaCajajajajajajajajajajajajajaAaFabaaaaaaaaaaaaaaaaaaaaaaaaaaaaaa
aaaaaaaaaaaaaaaaaaaaaaaaaaaaabaGayajajajajajajajajajajajajajajajajajajajajajajajajajajajajajaAaHabaaaaaaaaaaaaaaaaaaaaaaaaaaaaaa
aaaaaaaaaaaaaaaaaaaaaaaaaaaaabaDaCajajajajajajajajajajajajajajajajajajajajajajajajajajajajajaEaFabaaaaaaaaaaaaaaaaaaaaaaaaaaaaaa
aaaaaaaaaaaaaaaaaaaaaaaaaaaaabajajajajajajajajajajajajajajajajajajajajajajajajajajajajajajajajajabaaaaaaaaaaaaaaaaaaaaaaaaaaaaaa
aaaaaaaaaaaaaaaaaaaaaaaaaaaaabajajajaIaIaIaIajaJaKaLaIajajajajajajajajajajajajajajajajajajajajajabaaaaaaaaaaaaaaaaaaaaaaaaaaaaaa
aaaaaaaaaaaaaaaaaaaaaaaaaaaaabaMajajaNaNaNaNaOaPaQaRahajajajajajajajajajajajajajajajajajajajajajabaaaaaaaaaaaaaaaaaaaaaaaaaaaaaa
aaaaaaaaaaaaaaaaaaaaaaaaaaaaabaSajajaTaQaQaQaQaUaVaWaXajajajajajaYajajajajajajajajajajajajajajajabaaaaaaaaaaaaaaaaaaaaaaaaaaaaaa
aaaaaaaaaaaaaaaaaaaaaaaaaaaaabajajajajajajajajajajajajajajajajaOaZbaajajajajajajajajajajajajajajabaaaaaaaaaaaaaaaaaaaaaaaaaaaaaa
aaaaaaaaaaaaaaaaaaaaaaaaaaaaabajajajajajajajajaOaLajajajajajajbbbcbbajajajajajajajajajajajajajajabaaaaaaaaaaaaaaaaaaaaaaaaaaaaaa
aaaaaaaaaaaaaaaaaaaaaaaaaaaaabajajajajajbdbdbeafaLajajajajajajbfbgbhajajajajajajajajajajajajajajabaaaaaaaaaaaaaaaaaaaaaaaaaaaaaa
aaaaaaaaaaaaaaaaaaaaaaaaaaaaabajajajajajazazazafaLajajajajajajajbiajajajajajajajajajajajajajajajabaaaaaaaaaaaaaaaaaaaaaaaaaaaaaa
aaaaaaaaaaaaaaaaaaaaaaaaaaaaabajajajajajaTaQaQbjaLajajajajajajajajajajajajajajajajajajajajajajajabaaaaaaaaaaaaaaaaaaaaaaaaaaaaaa
aaaaaaaaaaaaaaaaaaaaaaaaaaaaabajajajajbkaOaKaKblaLajajajajajajajajajajajajajajajajajajajajajajajabaaaaaaaaaaaaaaaaaaaaaaaaaaaaaa
aaaaaaaaaaaaaaaaaaaaaaaaaaaaabajajajajajbmbmbmafaLajajajajajajajajajajajajajajajajajajajajajajajabaaaaaaaaaaaaaaaaaaaaaaaaaaaaaa
aaaaaaaaaaaaaaaaaaaaaaaaaaaaabajajajajajbnbnbnafaLajajajajajajajajajajajajajajajajajajajajajajajabaaaaaaaaaaaaaaaaaaaaaaaaaaaaaa
aaaaaaaaaaaaaaaaaaaaaaaaaaaaabajajajajajajajajaTaLajajajajajajajajajajajajajajajajajajajajajajajabaaaaaaaaaaaaaaaaaaaaaaaaaaaaaa
aaaaaaaaaaaaaaaaaaaaaaaaaaaaabajajajajajajajajajajajajajajajajajajajajajajajajajajajajajajajajajabaaaaaaaaaaaaaaaaaaaaaaaaaaaaaa
aaaaaaaaaaaaaaaaaaaaaaaaaaaaabajajajajajajajajajajajajajajajajajajajajajajajajajajajajajajajajajabaaaaaaaaaaaaaaaaaaaaaaaaaaaaaa
aaaaaaaaaaaaaaaaaaaaaaaaaaaaabajajajajajajajajajajajajajajajajajajajajajajajajajajajajajajajajajabaaaaaaaaaaaaaaaaaaaaaaaaaaaaaa
aaaaaaaaaaaaaaaaaaaaaaaaaaaaabajajajajajajajajajajajajajajajajajajajajajajajajajajajajajajajajajabaaaaaaaaaaaaaaaaaaaaaaaaaaaaaa
aaaaaaaaaaaaaaaaaaaaaaaaaaaaabajajajajajajajajajajajajajajajajajajajajajajajajajajajajajajajajajabaaaaaaaaaaaaaaaaaaaaaaaaaaaaaa
aaaaaaaaaaaaaaaaaaaaaaaaaaaaabajajajajajajajajajajajajajajajajajajajajajajajajajajajajajajajajajabaaaaaaaaaaaaaaaaaaaaaaaaaaaaaa
aaaaaaaaaaaaaaaaaaaaaaaaaaaaabajajajajajajajajajajajajajajajajajajajajajajajajajajajajajajajajajabaaaaaaaaaaaaaaaaaaaaaaaaaaaaaa
aaaaaaaaaaaaaaaaaaaaaaaaaaaaabajajajajajajajajajajajajajajajajajajajajajajajajajajajajajajajajajabaaaaaaaaaaaaaaaaaaaaaaaaaaaaaa
aaaaaaaaaaaaaaaaaaaaaaaaaaaaabajajajajajajajajajajajajajajajajajajajajajajajajajajajajajajajajajabaaaaaaaaaaaaaaaaaaaaaaaaaaaaaa
aaaaaaaaaaaaaaaaaaaaaaaaaaaaabajajajajajajajajajajajajajajajajajajajajajajajajajajajajajajajajajabaaaaaaaaaaaaaaaaaaaaaaaaaaaaaa
aaaaaaaaaaaaaaaaaaaaaaaaaaaaabajajajajajajajajajajajajajajajajajajajajajajajajajajajajajajajajajabaaaaaaaaaaaaaaaaaaaaaaaaaaaaaa
aaaaaaaaaaaaaaaaaaaaaaaaaaaaabajajajajajajajajajajajajajajajajajajajajajajajajajajajajajajajajajabaaaaaaaaaaaaaaaaaaaaaaaaaaaaaa
aaaaaaaaaaaaaaaaaaaaaaaaaaaaabababababababababababababababababababababababababababababababababababaaaaaaaaaaaaaaaaaaaaaaaaaaaaaa
aaaaaaaaaaaaaaaaaaaaaaaaaaaaaaaaaaaaaaaaaaaaaaaaaaaaaaaaaaaaaaaaaaaaaaaaaaaaaaaaaaaaaaaaaaaaaaaaaaaaaaaaaaaaaaaaaaaaaaaaaaaaaaaa
aaaaaaaaaaaaaaaaaaaaaaaaaaaaaaaaaaaaaaaaaaaaaaaaaaaaaaaaaaaaaaaaaaaaaaaaaaaaaaaaaaaaaaaaaaaaaaaaaaaaaaaaaaaaaaaaaaaaaaaaaaaaaaaa
aaaaaaaaaaaaaaaaaaaaaaaaaaaaaaaaaaaaaaaaaaaaaaaaaaaaaaaaaaaaaaaaaaaaaaaaaaaaaaaaaaaaaaaaaaaaaaaaaaaaaaaaaaaaaaaaaaaaaaaaaaaaaaaa
aaaaaaaaaaaaaaaaaaaaaaaaaaaaaaaaaaaaaaaaaaaaaaaaaaaaaaaaaaaaaaaaaaaaaaaaaaaaaaaaaaaaaaaaaaaaaaaaaaaaaaaaaaaaaaaaaaaaaaaaaaaaaaaa
aaaaaaaaaaaaaaaaaaaaaaaaaaaaaaaaaaaaaaaaaaaaaaaaaaaaaaaaaaaaaaaaaaaaaaaaaaaaaaaaaaaaaaaaaaaaaaaaaaaaaaaaaaaaaaaaaaaaaaaaaaaaaaaa
aaaaaaaaaaaaaaaaaaaaaaaaaaaaaaaaaaaaaaaaaaaaaaaaaaaaaaaaaaaaaaaaaaaaaaaaaaaaaaaaaaaaaaaaaaaaaaaaaaaaaaaaaaaaaaaaaaaaaaaaaaaaaaaa
aaaaaaaaaaaaaaaaaaaaaaaaaaaaaaaaaaaaaaaaaaaaaaaaaaaaaaaaaaaaaaaaaaaaaaaaaaaaaaaaaaaaaaaaaaaaaaaaaaaaaaaaaaaaaaaaaaaaaaaaaaaaaaaa
aaaaaaaaaaaaaaaaaaaaaaaaaaaaaaaaaaaaaaaaaaaaaaaaaaaaaaaaaaaaaaaaaaaaaaaaaaaaaaaaaaaaaaaaaaaaaaaaaaaaaaaaaaaaaaaaaaaaaaaaaaaaaaaa
aaaaaaaaaaaaaaaaaaaaaaaaaaaaaaaaaaaaaaaaaaaaaaaaaaaaaaaaaaaaaaaaaaaaaaaaaaaaaaaaaaaaaaaaaaaaaaaaaaaaaaaaaaaaaaaaaaaaaaaaaaaaaaaa
aaaaaaaaaaaaaaaaaaaaaaaaaaaaaaaaaaaaaaaaaaaaaaaaaaaaaaaaaaaaaaaaaaaaaaaaaaaaaaaaaaaaaaaaaaaaaaaaaaaaaaaaaaaaaaaaaaaaaaaaaaaaaaaa
aaaaaaaaaaaaaaaaaaaaaaaaaaaaaaaaaaaaaaaaaaaaaaaaaaaaaaaaaaaaaaaaaaaaaaaaaaaaaaaaaaaaaaaaaaaaaaaaaaaaaaaaaaaaaaaaaaaaaaaaaaaaaaaa
aaaaaaaaaaaaaaaaaaaaaaaaaaaaaaaaaaaaaaaaaaaaaaaaaaaaaaaaaaaaaaaaaaaaaaaaaaaaaaaaaaaaaaaaaaaaaaaaaaaaaaaaaaaaaaaaaaaaaaaaaaaaaaaa
aaaaaaaaaaaaaaaaaaaaaaaaaaaaaaaaaaaaaaaaaaaaaaaaaaaaaaaaaaaaaaaaaaaaaaaaaaaaaaaaaaaaaaaaaaaaaaaaaaaaaaaaaaaaaaaaaaaaaaaaaaaaaaaa
aaaaaaaaaaaaaaaaaaaaaaaaaaaaaaaaaaaaaaaaaaaaaaaaaaaaaaaaaaaaaaaaaaaaaaaaaaaaaaaaaaaaaaaaaaaaaaaaaaaaaaaaaaaaaaaaaaaaaaaaaaaaaaaa
"}
