"aa" = (/turf/unsimulated/wall,/area/space)
"ab" = (/turf/unsimulated/wall{tag = "icon-rock-dark"; icon_state = "rock-dark"},/area/asteroid_base/armoury_2)
"ac" = (/turf/unsimulated/wall{tag = "icon-rock-dark"; icon_state = "rock-dark"},/area/asteroid_base/storage_eng)
"ad" = (/turf/space,/area/space)
"ae" = (/obj/effect/landmark/test/space_turf,/turf/space,/area/space)
"af" = (/turf/unsimulated/wall,/area/asteroid_base/armoury_2)
"ag" = (/obj/structure/sign/deck/fourth,/turf/unsimulated/wall,/area/asteroid_base/armoury_2)
"ah" = (/turf/unsimulated/wall,/area/asteroid_base/storage_eng)
"ai" = (/obj/effect/decal/cleanable/cobweb,/turf/simulated/open,/area/asteroid_base/armoury_2)
"aj" = (/turf/simulated/open,/area/asteroid_base/armoury_2)
"ak" = (/obj/machinery/light/spot{dir = 1},/turf/simulated/open,/area/asteroid_base/armoury_2)
"al" = (/obj/structure/lattice,/turf/simulated/open,/area/asteroid_base/armoury_2)
"am" = (/turf/simulated/open,/area/asteroid_base/storage_eng)
"an" = (/turf/simulated/wall,/area/asteroid_base/storage_eng)
"ao" = (/obj/effect/decal/cleanable/dirt,/turf/simulated/floor/plating,/area/asteroid_base/armoury_2)
"ap" = (/obj/machinery/light/small{dir = 1},/turf/simulated/floor/plating,/area/asteroid_base/armoury_2)
"aq" = (/turf/simulated/floor/plating,/area/asteroid_base/armoury_2)
"ar" = (/obj/structure/table/standard,/obj/item/weapon/storage/firstaid/toxin,/turf/simulated/floor/tiled/white,/area/asteroid_base/storage_eng)
"as" = (/obj/structure/table/standard,/obj/effect/decal/cleanable/dirt,/obj/item/weapon/storage/firstaid/erk,/turf/simulated/floor/tiled/white,/area/asteroid_base/storage_eng)
"at" = (/obj/structure/table/standard,/obj/item/weapon/storage/firstaid/regular,/obj/machinery/light{dir = 1},/turf/simulated/floor/tiled/white,/area/asteroid_base/storage_eng)
"au" = (/obj/structure/table/standard,/obj/item/roller,/obj/item/roller,/turf/simulated/floor/tiled/white,/area/asteroid_base/storage_eng)
"av" = (/obj/effect/decal/cleanable/dirt,/turf/simulated/floor/plating,/area/asteroid_base/storage_eng)
"aw" = (/turf/simulated/floor/plating,/area/asteroid_base/storage_eng)
"ax" = (/obj/effect/decal/cleanable/cobweb2,/turf/simulated/floor/plating,/area/asteroid_base/storage_eng)
"ay" = (/obj/structure/ladder,/turf/simulated/floor/plating,/area/asteroid_base/armoury_2)
"az" = (/obj/effect/landmark/ghost_spawn,/turf/simulated/open,/area/asteroid_base/armoury_2)
"aA" = (/obj/structure/lattice,/turf/simulated/open,/area/asteroid_base/storage_eng)
"aB" = (/obj/structure/closet/secure_closet/paramedic,/turf/simulated/floor/tiled/white,/area/asteroid_base/storage_eng)
"aC" = (/obj/effect/decal/cleanable/dirt,/turf/simulated/floor/tiled/white,/area/asteroid_base/storage_eng)
"aD" = (/turf/simulated/floor/tiled/white,/area/asteroid_base/storage_eng)
"aE" = (/obj/structure/closet/medical_wall/filled,/turf/unsimulated/wall,/area/asteroid_base/storage_eng)
"aF" = (/obj/structure/sign/halo_floorsign/maint{tag = "icon-maint (EAST)"; icon_state = "maint"; dir = 4},/turf/simulated/floor/plating,/area/asteroid_base/storage_eng)
"aG" = (/obj/structure/ladder,/turf/simulated/floor/plating,/area/asteroid_base/storage_eng)
"aH" = (/obj/effect/decal/cleanable/dirt,/obj/machinery/light/small{dir = 4},/turf/simulated/floor/plating,/area/asteroid_base/storage_eng)
"aI" = (/obj/structure/sign/halo_floorsign/maint{tag = "icon-maint (NORTH)"; icon_state = "maint"; dir = 1},/turf/simulated/floor/plating,/area/asteroid_base/armoury_2)
"aJ" = (/obj/machinery/light/spot{dir = 8},/turf/simulated/open,/area/asteroid_base/armoury_2)
"aK" = (/obj/machinery/light/spot{dir = 4},/turf/simulated/open,/area/asteroid_base/storage_eng)
"aL" = (/obj/effect/decal/cleanable/dirt,/obj/machinery/vending/medical,/turf/simulated/floor/tiled/white,/area/asteroid_base/storage_eng)
"aM" = (/obj/machinery/vending/wallmed1,/turf/unsimulated/wall,/area/asteroid_base/storage_eng)
"aN" = (/obj/effect/decal/cleanable/dirt,/obj/structure/closet/secure_closet/medical3,/obj/machinery/light{dir = 8},/turf/simulated/floor/tiled/white,/area/asteroid_base/storage_eng)
"aO" = (/obj/machinery/space_heater,/turf/simulated/floor/tiled/white,/area/asteroid_base/storage_eng)
"aP" = (/obj/machinery/vending/wallmed1,/turf/unsimulated/wall,/area/asteroid_base/armoury_2)
"aQ" = (/obj/machinery/door/airlock/halo_maint,/turf/simulated/floor/plating,/area/asteroid_base/armoury_2)
"aR" = (/obj/structure/sign/warning/moving_parts,/turf/simulated/wall/r_wall,/area/asteroid_base/armoury_2)
"aS" = (/obj/effect/floor_decal/corner/yellow{tag = "icon-corner_white (NORTHWEST)"; icon_state = "corner_white"; dir = 9},/obj/effect/floor_decal/industrial/warning/dust{tag = "icon-warning_dust (NORTH)"; icon_state = "warning_dust"; dir = 1},/obj/effect/decal/cleanable/dirt,/turf/simulated/floor/tiled/dark,/area/asteroid_base/armoury_2)
"aT" = (/obj/effect/floor_decal/industrial/warning/dust{tag = "icon-warning_dust (NORTH)"; icon_state = "warning_dust"; dir = 1},/obj/effect/decal/cleanable/dirt,/turf/simulated/floor/tiled/dark,/area/asteroid_base/armoury_2)
"aU" = (/obj/effect/floor_decal/corner/yellow{tag = "icon-corner_white (SOUTHEAST)"; icon_state = "corner_white"; dir = 6},/obj/effect/floor_decal/industrial/warning/dust{tag = "icon-warning_dust (NORTH)"; icon_state = "warning_dust"; dir = 1},/turf/simulated/floor/tiled/dark,/area/asteroid_base/armoury_2)
"aV" = (/obj/structure/sign/warning/fall,/turf/unsimulated/wall,/area/asteroid_base/storage_eng)
"aW" = (/obj/structure/grille,/obj/structure/window/reinforced/full,/turf/simulated/floor/plating,/area/asteroid_base/storage_eng)
"aX" = (/obj/machinery/door/airlock/halo_lifepod{name = "Airlock"},/turf/simulated/floor/tiled/dark,/area/asteroid_base/storage_eng)
"aY" = (/obj/structure/sign/bluecross_2,/turf/simulated/wall/r_wall,/area/asteroid_base/storage_eng)
"aZ" = (/turf/simulated/floor/tiled/dark,/area/asteroid_base/armoury_2)
"ba" = (/obj/effect/decal/cleanable/dirt,/turf/simulated/floor/tiled/dark,/area/asteroid_base/armoury_2)
"bb" = (/obj/effect/floor_decal/industrial/warning/dust{tag = "icon-warning_dust (EAST)"; icon_state = "warning_dust"; dir = 4},/turf/simulated/floor/tiled/dark,/area/asteroid_base/armoury_2)
"bc" = (/obj/effect/floor_decal/corner/yellow{tag = "icon-corner_white (NORTHWEST)"; icon_state = "corner_white"; dir = 9},/obj/effect/decal/cleanable/dirt,/turf/simulated/floor/tiled/dark,/area/asteroid_base/armoury_2)
"bd" = (/obj/effect/floor_decal/corner/yellow{tag = "icon-corner_white (SOUTHEAST)"; icon_state = "corner_white"; dir = 6},/obj/effect/decal/cleanable/dirt,/turf/simulated/floor/tiled/dark,/area/asteroid_base/armoury_2)
"be" = (/obj/effect/floor_decal/industrial/warning/dust{tag = "icon-warning_dust (WEST)"; icon_state = "warning_dust"; dir = 8},/turf/simulated/floor/tiled/dark,/area/asteroid_base/armoury_2)
"bf" = (/turf/simulated/floor/tiled/dark,/area/asteroid_base/storage_eng)
"bg" = (/obj/effect/decal/cleanable/dirt,/turf/simulated/floor/tiled/dark,/area/asteroid_base/storage_eng)
"bh" = (/obj/effect/floor_decal/sign/m,/turf/simulated/floor/tiled/dark,/area/asteroid_base/storage_eng)
"bi" = (/obj/machinery/door/airlock/halo_maint,/turf/simulated/floor/plating,/area/asteroid_base/storage_eng)
"bj" = (/obj/effect/floor_decal/sign/m,/turf/simulated/floor/tiled/dark,/area/asteroid_base/armoury_2)
"bk" = (/obj/machinery/light,/turf/simulated/floor/tiled/dark,/area/asteroid_base/armoury_2)
"bl" = (/obj/effect/decal/cleanable/dirt,/obj/machinery/light,/turf/simulated/floor/tiled/dark,/area/asteroid_base/armoury_2)
"bm" = (/obj/effect/floor_decal/corner/yellow{tag = "icon-corner_white (NORTHWEST)"; icon_state = "corner_white"; dir = 9},/turf/simulated/floor/tiled/dark,/area/asteroid_base/armoury_2)
"bn" = (/obj/effect/floor_decal/corner/yellow{tag = "icon-corner_white (SOUTHEAST)"; icon_state = "corner_white"; dir = 6},/turf/simulated/floor/tiled/dark,/area/asteroid_base/armoury_2)
"bo" = (/obj/machinery/light,/turf/simulated/floor/tiled/dark,/area/asteroid_base/storage_eng)
"bp" = (/obj/machinery/light/small/red{tag = "icon-bulb1 (NORTH)"; icon_state = "bulb1"; dir = 1},/turf/simulated/floor/plating,/area/asteroid_base/storage_eng)
"bq" = (/turf/simulated/wall,/area/asteroid_base/armoury_2)
"br" = (/obj/structure/extinguisher_cabinet,/turf/unsimulated/wall,/area/asteroid_base/armoury_2)
"bs" = (/obj/structure/sign/halo_floorsign/cargobay{tag = "icon-cargobay (NORTH)"; icon_state = "cargobay"; dir = 1},/obj/effect/floor_decal/corner/yellow{tag = "icon-corner_white (NORTH)"; icon_state = "corner_white"; dir = 1},/turf/simulated/floor/tiled/dark,/area/asteroid_base/armoury_2)
"bt" = (/obj/structure/sign/halo_floorsign/cargobay{tag = "icon-cargobay (NORTH)"; icon_state = "cargobay"; dir = 1},/obj/effect/floor_decal/corner/yellow{tag = "icon-corner_white (EAST)"; icon_state = "corner_white"; dir = 4},/turf/simulated/floor/tiled/dark,/area/asteroid_base/armoury_2)
"bu" = (/obj/structure/extinguisher_cabinet,/turf/unsimulated/wall,/area/asteroid_base/storage_eng)
"bv" = (/obj/structure/mopbucket,/obj/effect/decal/cleanable/cobweb,/obj/item/weapon/mop,/turf/simulated/floor/tiled/dark,/area/asteroid_base/armoury_2)
"bw" = (/obj/structure/toilet,/turf/simulated/floor/tiled/dark,/area/asteroid_base/armoury_2)
"bx" = (/obj/machinery/light{dir = 8},/turf/simulated/floor/tiled/dark,/area/asteroid_base/armoury_2)
"by" = (/obj/machinery/telecomms/receiver,/turf/simulated/floor/plating,/area/asteroid_base/storage_eng)
"bz" = (/obj/machinery/telecomms/bus,/turf/simulated/floor/plating,/area/asteroid_base/storage_eng)
"bA" = (/obj/machinery/telecomms/relay/long_range_emergency,/turf/simulated/floor/plating,/area/asteroid_base/storage_eng)
"bB" = (/obj/structure/sign/halo_floorsign/maint{tag = "icon-maint (NORTH)"; icon_state = "maint"; dir = 1},/turf/simulated/floor/plating,/area/asteroid_base/storage_eng)
"bC" = (/obj/effect/decal/cleanable/generic,/obj/machinery/light/small{dir = 8},/turf/simulated/floor/tiled/dark,/area/asteroid_base/armoury_2)
"bD" = (/obj/structure/sink{dir = 4; icon_state = "sink"; pixel_x = 10; tag = "icon-sink (EAST)"},/turf/simulated/floor/tiled/dark,/area/asteroid_base/armoury_2)
"bE" = (/obj/structure/mirror,/turf/unsimulated/wall,/area/asteroid_base/armoury_2)
"bF" = (/obj/structure/sign/directions/supply{tag = "icon-direction_supply (NORTH)"; icon_state = "direction_supply"; dir = 1},/turf/unsimulated/wall,/area/asteroid_base/armoury_2)
"bG" = (/obj/effect/decal/cleanable/blood/oil,/turf/simulated/floor/tiled/dark,/area/asteroid_base/armoury_2)
"bH" = (/obj/structure/sign/directions/infirmary{tag = "icon-direction_infirm (EAST)"; icon_state = "direction_infirm"; dir = 4},/turf/unsimulated/wall,/area/asteroid_base/armoury_2)
"bI" = (/obj/structure/sign/warning/vent_port,/turf/simulated/wall,/area/asteroid_base/storage_eng)
"bJ" = (/obj/effect/decal/cleanable/cobweb,/turf/simulated/floor/plating,/area/asteroid_base/armoury_2)
"bK" = (/obj/structure/table/rack,/obj/item/weapon/gun/projectile/m6d_magnum,/obj/effect/decal/cleanable/cobweb,/turf/simulated/floor/tiled/dark,/area/asteroid_base/armoury_2)
"bL" = (/obj/structure/table/rack,/obj/item/weapon/gun/projectile/m6d_magnum,/turf/simulated/floor/tiled/dark,/area/asteroid_base/armoury_2)
"bM" = (/obj/structure/table/rack,/obj/item/weapon/gun/projectile/ma5b_ar/MA37,/obj/effect/decal/cleanable/dirt,/turf/simulated/floor/tiled/dark,/area/asteroid_base/armoury_2)
"bN" = (/obj/machinery/door/airlock/halo,/turf/simulated/floor/plating,/area/asteroid_base/armoury_2)
"bO" = (/obj/machinery/telecomms/broadcaster,/turf/simulated/floor/plating,/area/asteroid_base/storage_eng)
"bP" = (/obj/machinery/telecomms/hub,/turf/simulated/floor/plating,/area/asteroid_base/storage_eng)
"bQ" = (/obj/machinery/telecomms/processor,/turf/simulated/floor/plating,/area/asteroid_base/storage_eng)
"bR" = (/obj/structure/sign/halo_floorsign/maint{tag = "icon-maint (EAST)"; icon_state = "maint"; dir = 4},/turf/simulated/floor/plating,/area/asteroid_base/armoury_2)
"bS" = (/obj/machinery/light/small{dir = 4},/turf/simulated/floor/plating,/area/asteroid_base/armoury_2)
"bT" = (/obj/machinery/door/airlock/halo_lifepod{name = "Airlock"},/turf/simulated/floor/plating,/area/asteroid_base/armoury_2)
"bU" = (/turf/simulated/floor/tiled,/area/asteroid_base/armoury_2)
"bV" = (/obj/machinery/light{dir = 4; icon_state = "tube1"},/turf/simulated/floor/tiled/dark,/area/asteroid_base/armoury_2)
"bW" = (/obj/effect/decal/cleanable/cobweb,/turf/simulated/floor/plating,/area/asteroid_base/storage_eng)
"bX" = (/obj/structure/table/rack,/obj/item/ammo_magazine/m127_saphe,/obj/item/ammo_magazine/m127_saphe,/turf/simulated/floor/tiled/dark,/area/asteroid_base/armoury_2)
"bY" = (/obj/structure/table/rack,/obj/item/ammo_magazine/m762_ap/MA37,/obj/item/ammo_magazine/m762_ap/MA37,/turf/simulated/floor/tiled/dark,/area/asteroid_base/armoury_2)
"bZ" = (/obj/structure/filingcabinet/chestdrawer,/turf/simulated/floor/tiled,/area/asteroid_base/armoury_2)
"ca" = (/obj/effect/decal/cleanable/dirt,/turf/simulated/floor/tiled,/area/asteroid_base/armoury_2)
"cb" = (/mob/living/simple_animal/npc/colonist/weapon_smuggler,/turf/simulated/floor/tiled,/area/asteroid_base/armoury_2)
"cc" = (/obj/structure/grille,/obj/structure/window/reinforced/full,/turf/simulated/floor/plating,/area/asteroid_base/armoury_2)
"cd" = (/obj/machinery/vending/security,/turf/simulated/floor/tiled,/area/asteroid_base/armoury_2)
"ce" = (/obj/structure/filingcabinet/security,/obj/machinery/light{dir = 4; icon_state = "tube1"},/turf/simulated/floor/tiled,/area/asteroid_base/armoury_2)
"cf" = (/obj/machinery/door/blast/regular/triple{id = 2},/turf/simulated/floor/tiled/dark,/area/asteroid_base/armoury_2)
"cg" = (/obj/machinery/space_heater,/obj/machinery/light{dir = 8},/turf/simulated/floor/tiled,/area/asteroid_base/armoury_2)
"ch" = (/obj/structure/bed/chair{tag = "icon-chair_preview (EAST)"; icon_state = "chair_preview"; dir = 4},/turf/simulated/floor/tiled,/area/asteroid_base/armoury_2)
"ci" = (/obj/machinery/door/window/eastleft,/obj/structure/table/steel,/obj/item/weapon/paper_bin,/obj/item/weapon/pen/red,/turf/simulated/floor/tiled,/area/asteroid_base/armoury_2)
"cj" = (/obj/structure/sign/warning/vent_port,/turf/simulated/wall,/area/asteroid_base/armoury_2)
"ck" = (/obj/machinery/vending/cigarette,/turf/simulated/floor/tiled,/area/asteroid_base/armoury_2)
"cl" = (/obj/machinery/door/window/eastright,/obj/structure/table/steel,/obj/effect/decal/cleanable/generic,/obj/item/weapon/reagent_containers/spray/pepper,/turf/simulated/floor/tiled,/area/asteroid_base/armoury_2)
"cm" = (/obj/machinery/light/small/red{tag = "icon-bulb1 (EAST)"; icon_state = "bulb1"; dir = 4},/turf/simulated/floor/plating,/area/asteroid_base/armoury_2)
"cn" = (/obj/structure/reagent_dispensers/peppertank,/turf/unsimulated/wall,/area/asteroid_base/armoury_2)
"co" = (/obj/machinery/recharger/wallcharger,/turf/unsimulated/wall,/area/asteroid_base/armoury_2)
"cp" = (/obj/machinery/button/remote/blast_door{id = 2},/turf/unsimulated/wall,/area/asteroid_base/armoury_2)
"cq" = (/obj/machinery/door/blast/regular/triple,/obj/effect/decal/cleanable/dirt,/turf/simulated/floor/plating,/area/asteroid_base/armoury_2)
"cr" = (/obj/structure/sign/warning/detailed{name = "\improper AUTHORIZED PERSONNEL ONLY"},/turf/unsimulated/wall,/area/asteroid_base/armoury_2)
"cs" = (/obj/machinery/light/small/red{tag = "icon-bulb1 (WEST)"; icon_state = "bulb1"; dir = 8},/turf/simulated/floor/plating,/area/asteroid_base/armoury_2)
"ct" = (/obj/machinery/button/remote/blast_door{id = 1},/turf/unsimulated/wall,/area/asteroid_base/armoury_2)
"cu" = (/turf/unsimulated/wall{tag = "icon-rock-dark"; icon_state = "rock-dark"},/area/asteroid_base/armoury_1)
"cv" = (/turf/simulated/floor/plating,/area/asteroid_base/armoury_1)
"cw" = (/obj/effect/decal/cleanable/dirt,/turf/simulated/floor/plating,/area/asteroid_base/armoury_1)
"cx" = (/obj/effect/decal/cleanable/cobweb2,/obj/effect/decal/cleanable/dirt,/turf/simulated/floor/plating,/area/asteroid_base/armoury_1)
"cy" = (/turf/unsimulated/wall{tag = "icon-rock-dark"; icon_state = "rock-dark"},/area/asteroid_base/storage_medbay)
"cz" = (/turf/simulated/floor/plating,/area/asteroid_base/storage_medbay)
"cA" = (/obj/structure/sign/warning/hot_exhaust,/turf/unsimulated/wall{tag = "icon-rock-dark"; icon_state = "rock-dark"},/area/asteroid_base/storage_medbay)
"cB" = (/obj/structure/sign/warning/hot_exhaust,/turf/unsimulated/wall{tag = "icon-rock-dark"; icon_state = "rock-dark"},/area/asteroid_base/armoury_1)
"cC" = (/obj/effect/decal/cleanable/dirt,/turf/simulated/floor/plating,/area/asteroid_base/storage_medbay)
"cD" = (/obj/effect/decal/cleanable/cobweb2,/turf/simulated/floor/plating,/area/asteroid_base/storage_medbay)
"cE" = (/obj/effect/floor_decal/snow,/turf/simulated/floor/plating,/area/asteroid_base/armoury_1)
"cF" = (/obj/structure/grille,/turf/simulated/floor/plating,/area/asteroid_base/armoury_1)
"cG" = (/turf/unsimulated/floor{tag = "icon-snow"; icon_state = "snow"},/area/asteroid_base/armoury_1)
"cH" = (/turf/unsimulated/floor{tag = "icon-snow"; icon_state = "snow"},/area/asteroid_base/storage_medbay)
"cI" = (/obj/structure/grille,/obj/effect/decal/cleanable/dirt,/turf/simulated/floor/plating,/area/asteroid_base/storage_medbay)
"cJ" = (/obj/effect/landmark/drop_pod_landing,/turf/unsimulated/floor{tag = "icon-snow"; icon_state = "snow"},/area/asteroid_base/armoury_1)
"cK" = (/obj/structure/hangar_door,/turf/simulated/open,/area/asteroid_base/storage_medbay)
"cL" = (/obj/effect/landmark/dropship_land_point{name = "Frozen Plains"},/turf/unsimulated/floor{tag = "icon-snow"; icon_state = "snow"},/area/asteroid_base/armoury_1)
"cM" = (/obj/machinery/telecomms/relay/long_range_planetary,/turf/unsimulated/floor{tag = "icon-snow"; icon_state = "snow"},/area/asteroid_base/storage_medbay)
"cN" = (/turf/unsimulated/wall{tag = "icon-rock-dark"; icon_state = "rock-dark"},/area/asteroid_base/mac_gun)
"cO" = (/turf/unsimulated/wall{tag = "icon-rock-dark"; icon_state = "rock-dark"},/area/asteroid_base/vault)
"cP" = (/obj/effect/landmark/test/safe_turf,/turf/unsimulated/floor{tag = "icon-snow"; icon_state = "snow"},/area/asteroid_base/armoury_1)
"cQ" = (/turf/unsimulated/wall{tag = "icon-rock-dark"; icon_state = "rock-dark"},/area/asteroid_base/west_dorms)
"cR" = (/obj/effect/landmark/map_data{height = 4},/turf/unsimulated/wall{tag = "icon-rock-dark"; icon_state = "rock-dark"},/area/asteroid_base/engine/generator/control)
"cS" = (/obj/effect/overmap/sector/innie_base,/turf/unsimulated/wall{tag = "icon-rock-dark"; icon_state = "rock-dark"},/area/asteroid_base/engine/smes)
"cT" = (/turf/unsimulated/wall{tag = "icon-rock-dark"; icon_state = "rock-dark"},/area/asteroid_base/engine/canisters)
"cU" = (/turf/unsimulated/wall{tag = "icon-rock-dark"; icon_state = "rock-dark"},/area/asteroid_base/atmos)

(1,1,1) = {"
aaaaaaaaaaabababababababababababababababababababacacacacacacacacacacacacacacacacacacacacacacacacacac
aaadadadaaabababababababababababababababababababacacacacacacacacacacacacacacacacacacacacacacacacacac
aaadaeadaaabababababababababababafafafafafagafafahahahacacacacacacacacacacacacacacacacacacacacacacac
aaadadadaaabababababababababababafaiajajakalakajamamahacacacacacacacacacacacacacacacacacacacacacacac
aaaaaaaaaaabababababababafafagafafajajajajalajajamamahahahahahahacacacacacanananananacacacacacacacac
ababababababababababababafaoapaqafajajalalalalalamamaharasatauahananananananavawaxanacacacacacacacac
ababababababababababababafaoayaoafalalalajazajalaAaAahaBaCaDaDaEanawawavavawaFaGaHanacacacacacacacac
ababababababababababababafaqaIaoafaJajalajajajalamaKahaLaCaCaCaManavananananawawavanacacacacacacacac
ababababababababababababafafaqafafajajalajajajalamamahaNaDaDaOahanavanacacanananananacacacacacacacac
abababababafafaPafafafafafafaQafafafaRafaSaTaUafaVahahaWaWaXaYahahavanacacacacacacacacacacacacacacac
abababababafaZbabaaZaZbaaZaZaZbaaZbababbbcbabdbebfbfbfbgbgbgbfbhbiawanacacacacacacacacanananananacac
abababababafaZbjbkaZbabaaZblbababababkbbbmbabnbebfbobfbgbfbfbobfahananacacacacacacacacanawbpaxanacac
ababababbqafafaQafafafbrafafafafafafafafbsaZbtafahahahahaXaMahbuahacacacacacacacacacacanavaGavanacac
ababababbqaoaqaqbqababababababafbvbwafafbxaZaZafacahahahbfbybzbAahacacacacacacacacacacanawbBavanacac
ababababbqaobqbqbqbqafafafafafafbCbDbEbFaZbabGbHacahahahbfawawawahacacacacacacacacacacananawbIanacac
ababababbqaobqbJaoaoafbKbLbMafafbNafbrafaZbabaafacahahahbfbObPbQahacacacacacacacacacacacacavacacacac
ababababbqaqaqbRaybSafbxbababTbUbUbUbUbNaZbabVafacahahahahahahahahacacacacacacbWavavawawavavacacacac
ababababbqbqbqaoaoaqafbXbXbYafbZbUcacbccbabaaZafacacacacacacacacacacacacacacacawacacacacacacacacacac
ababababababbqbqbqbqafafafafafcdbUcaceafcfbabaafacacacacacacacacacacacacacacacavacacacacacacacacacac
abababababbqbqbqbqbqababababafcgcabUchciaZbabVafacacacacacacacacacacacacacacacavacacacacacacacacacac
abababababcjaoaoaobqababababafckbUbUchclbababaaPacacacacacacacacacacacacacacacawacacacacacacacacacac
ababaoaqaqaqbRaycmbqababababafafcncocpafbxbabaafacacacacacacacacacacacacacacacavavaxacacacacacacacac
ababaoababbqaqaoaqbqabababababababababafcqaqaoafacacacacacacacacacacacacacacacacacawacacacacacacacac
ababaoababbqbqbqbqbqabababababababababcrcsaoaqctacacacacacacacacacacacacacacacacacavacacacacacacacac
ababaqabababababababababababababababababaqaoaoabacacacacacacacacacacacacacacacacacavawavavavacacacac
cucucvcucucucucucucucucucucucucucucucucucwcwcwcuacacacacacacacacacacacacacacacacacacacacacawacacacac
cucucwcwcxcucucucucucucucucucucucucucucucwcvcwcucycycycycycycycycycycycycycycycycycycycycyczcAcycycy
cucucucucvcucBcucucucucucucucucucucucucucvcvcvcucycycycycycycycycycycycycycycycycycycycycycCcDcycycy
cucucucucwcwcxcucucucucucucucucucucucucucEcEcEcucycycycycycycycycycycycycycycycycycycycycycyczcycycy
cucucucucucucwcucucucucucucucucucucucucucEcEcEcucycycycycycycycycycycycycycycycycycycycycycycCcycycy
cucucucucucucFcucucucucucucucucucucGcGcGcGcGcGcucHcycHcHcycycycycycycycycycycycycycycycycycycCcycycy
cucucucucucucGcGcGcucucucucucucGcGcGcGcGcGcGcGcGcHcHcHcHcHcycycycycycycycycHcHcycycycycycycycIcycycy
cucucucGcGcGcGcGcGcGcGcGcGcGcGcGcGcGcGcGcGcGcGcGcHcHcHcHcHcHcycycycycycycHcHcHcHcycycycycHcHcHcHcycy
cucucGcGcGcGcGcGcGcGcGcGcGcGcGcGcGcGcGcGcGcGcGcGcHcHcHcHcHcHcHcHcHcHcHcHcHcHcHcHcHcHcHcHcHcHcHcHcHcy
cucGcGcGcGcGcGcGcGcGcGcGcGcGcGcGcGcGcGcGcGcGcGcGcHcHcHcHcHcHcHcHcHcHcHcHcHcHcHcHcHcHcHcHcHcHcHcHcHcy
cucucGcGcGcGcGcGcGcGcGcGcGcGcGcGcGcGcGcGcGcGcGcGcHcHcHcHcHcHcHcHcHcHcHcHcHcHcHcHcHcHcHcHcHcHcHcHcHcy
cucucGcGcGcGcGcGcGcGcGcGcGcGcJcGcGcGcGcGcGcGcGcGcHcHcHcHcHcHcHcHcHcHcHcHcHcHcHcHcHcHcHcHcHcHcHcHcHcy
cucGcGcGcGcJcGcGcGcGcGcGcGcGcGcGcGcGcGcGcJcGcGcGcHcHcKcKcKcKcKcKcKcHcHcHcHcHcKcKcKcKcKcKcKcHcHcHcycy
cucGcGcGcGcGcGcGcGcGcGcGcGcGcGcGcGcGcGcGcGcGcGcGcHcHcKcKcKcKcKcKcKcHcHcHcHcHcKcKcKcKcKcKcKcHcHcHcycy
cucGcGcGcGcGcGcGcGcGcGcGcGcGcGcGcGcGcGcGcGcGcGcGcHcHcKcKcKcKcKcKcKcHcHcHcHcHcKcKcKcKcKcKcKcHcHcHcycy
cucucucGcGcGcGcGcGcLcGcGcGcGcGcGcGcGcGcGcGcGcGcGcHcHcKcKcKcKcKcKcKcHcHcHcHcHcKcKcKcKcKcKcKcHcHcHcHcy
cucGcGcGcGcGcGcGcGcGcGcGcGcGcGcGcGcGcGcGcGcGcGcGcHcHcKcKcKcKcKcKcKcHcHcHcHcHcKcKcKcKcKcKcKcHcHcHcHcy
cucGcGcGcGcGcGcGcGcGcGcGcGcGcGcGcGcGcGcGcGcGcGcGcHcHcKcKcKcKcKcKcKcHcHcHcHcHcKcKcKcKcKcKcKcHcHcHcHcy
cucGcGcGcGcGcGcGcGcGcGcGcGcGcJcGcGcGcGcGcJcGcGcGcHcHcKcKcKcKcKcKcKcHcHcHcHcHcKcKcKcKcKcKcKcHcHcHcHcy
cucucGcGcGcJcGcGcGcGcGcGcGcGcGcGcGcGcGcGcGcGcGcGcHcHcHcHcHcHcHcHcHcHcHcHcHcHcHcHcHcHcHcHcHcMcHcHcycy
cucucGcGcGcGcGcGcGcGcGcGcGcGcGcGcGcGcGcGcGcGcGcGcHcHcHcHcHcHcHcHcHcHcHcHcHcHcHcHcHcHcHcHcHcHcHcHcycy
cNcucGcGcGcGcGcGcGcGcGcGcGcGcGcGcGcGcGcGcGcGcGcGcHcHcHcHcHcHcHcHcHcHcHcHcHcHcHcHcHcHcHcHcHcHcHcycycy
cOcOcucucPcGcGcGcGcGcGcGcGcGcGcGcGcGcGcGcGcGcGcucHcHcHcHcHcHcHcHcHcHcHcycHcHcHcHcHcHcHcHcHcHcycycycy
cQcucucucucGcGcGcGcGcGcucucGcJcGcGcucGcGcGcGcGcucycycHcHcHcHcHcHcHcHcycycycycHcHcHcHcHcycycycycycycy
cRcScTcUcucucucucucucucucucucucucucucucucucucucucycycycycycycycycycycycycycycycycycycycycycycycycycy
"}
