"aa" = (/turf/unsimulated/wall,/area/space)
"ab" = (/turf/unsimulated/wall{tag = "icon-rock-dark"; icon_state = "rock-dark"},/area/asteroid_base/armoury_2)
"ac" = (/turf/unsimulated/wall{tag = "icon-rock-dark"; icon_state = "rock-dark"},/area/asteroid_base/storage_eng)
"ad" = (/turf/space,/area/space)
"ae" = (/obj/effect/landmark/test/space_turf,/turf/space,/area/space)
"af" = (/turf/unsimulated/wall,/area/asteroid_base/armoury_2)
"ag" = (/obj/structure/sign/deck/fourth,/turf/unsimulated/wall,/area/asteroid_base/armoury_2)
"ah" = (/turf/unsimulated/wall,/area/asteroid_base/storage_eng)
"ai" = (/obj/effect/decal/cleanable/cobweb,/turf/simulated/open,/area/asteroid_base/armoury_2)
"aj" = (/turf/simulated/open,/area/asteroid_base/armoury_2)
"ak" = (/obj/machinery/light/spot{dir = 1},/turf/simulated/open,/area/asteroid_base/armoury_2)
"al" = (/obj/structure/lattice,/turf/simulated/open,/area/asteroid_base/armoury_2)
"am" = (/turf/simulated/open,/area/asteroid_base/storage_eng)
"an" = (/turf/unsimulated/mask,/area/asteroid_base/armoury_2)
"ao" = (/obj/structure/lattice,/turf/unsimulated/mask,/area/asteroid_base/armoury_2)
"ap" = (/turf/unsimulated/wall{tag = "icon-0"; icon_state = "0"},/area/asteroid_base/storage_eng)
"aq" = (/obj/effect/decal/cleanable/dirt,/turf/unsimulated/floor{tag = "icon-plating"; icon_state = "plating"},/area/asteroid_base/armoury_2)
"ar" = (/obj/machinery/light/small{dir = 1},/turf/unsimulated/floor{tag = "icon-plating"; icon_state = "plating"},/area/asteroid_base/armoury_2)
"as" = (/turf/unsimulated/floor{tag = "icon-plating"; icon_state = "plating"},/area/asteroid_base/armoury_2)
"at" = (/obj/structure/table/standard,/obj/item/weapon/storage/firstaid/toxin,/turf/unsimulated/floor{tag = "icon-white"; icon_state = "white"},/area/asteroid_base/storage_eng)
"au" = (/obj/structure/table/standard,/obj/effect/decal/cleanable/dirt,/obj/item/weapon/storage/firstaid/erk,/turf/unsimulated/floor{tag = "icon-white"; icon_state = "white"},/area/asteroid_base/storage_eng)
"av" = (/obj/structure/table/standard,/obj/item/weapon/storage/firstaid/regular,/obj/machinery/light{dir = 1},/turf/unsimulated/floor{tag = "icon-white"; icon_state = "white"},/area/asteroid_base/storage_eng)
"aw" = (/obj/structure/table/standard,/obj/item/roller,/obj/item/roller,/turf/unsimulated/floor{tag = "icon-white"; icon_state = "white"},/area/asteroid_base/storage_eng)
"ax" = (/obj/effect/decal/cleanable/dirt,/turf/unsimulated/floor{tag = "icon-plating"; icon_state = "plating"},/area/asteroid_base/storage_eng)
"ay" = (/turf/unsimulated/floor{tag = "icon-plating"; icon_state = "plating"},/area/asteroid_base/storage_eng)
"az" = (/obj/effect/decal/cleanable/cobweb2,/turf/unsimulated/floor{tag = "icon-plating"; icon_state = "plating"},/area/asteroid_base/storage_eng)
"aA" = (/obj/structure/ladder,/turf/unsimulated/floor{tag = "icon-plating"; icon_state = "plating"},/area/asteroid_base/armoury_2)
"aB" = (/obj/structure/lattice,/turf/simulated/open,/area/asteroid_base/storage_eng)
"aC" = (/obj/structure/closet/secure_closet/paramedic,/turf/unsimulated/floor{tag = "icon-white"; icon_state = "white"},/area/asteroid_base/storage_eng)
"aD" = (/obj/effect/decal/cleanable/dirt,/turf/unsimulated/floor{tag = "icon-white"; icon_state = "white"},/area/asteroid_base/storage_eng)
"aE" = (/turf/unsimulated/floor{tag = "icon-white"; icon_state = "white"},/area/asteroid_base/storage_eng)
"aF" = (/obj/structure/closet/medical_wall/filled,/turf/unsimulated/wall,/area/asteroid_base/storage_eng)
"aG" = (/obj/structure/sign/halo_floorsign/maint{tag = "icon-maint (EAST)"; icon_state = "maint"; dir = 4},/turf/unsimulated/floor{tag = "icon-plating"; icon_state = "plating"},/area/asteroid_base/storage_eng)
"aH" = (/obj/structure/ladder,/turf/unsimulated/floor{tag = "icon-plating"; icon_state = "plating"},/area/asteroid_base/storage_eng)
"aI" = (/obj/effect/decal/cleanable/dirt,/obj/machinery/light/small{dir = 4},/turf/unsimulated/floor{tag = "icon-plating"; icon_state = "plating"},/area/asteroid_base/storage_eng)
"aJ" = (/obj/structure/sign/halo_floorsign/maint{tag = "icon-maint (NORTH)"; icon_state = "maint"; dir = 1},/turf/unsimulated/floor{tag = "icon-plating"; icon_state = "plating"},/area/asteroid_base/armoury_2)
"aK" = (/obj/machinery/light/spot{dir = 8},/turf/simulated/open,/area/asteroid_base/armoury_2)
"aL" = (/obj/machinery/light/spot{dir = 4},/turf/simulated/open,/area/asteroid_base/storage_eng)
"aM" = (/obj/effect/decal/cleanable/dirt,/obj/machinery/vending/medical,/turf/unsimulated/floor{tag = "icon-white"; icon_state = "white"},/area/asteroid_base/storage_eng)
"aN" = (/obj/machinery/vending/wallmed1,/turf/unsimulated/wall,/area/asteroid_base/storage_eng)
"aO" = (/obj/effect/decal/cleanable/dirt,/obj/structure/closet/secure_closet/medical3,/obj/machinery/light{dir = 8},/turf/unsimulated/floor{tag = "icon-white"; icon_state = "white"},/area/asteroid_base/storage_eng)
"aP" = (/obj/machinery/space_heater,/turf/unsimulated/floor{tag = "icon-white"; icon_state = "white"},/area/asteroid_base/storage_eng)
"aQ" = (/obj/machinery/vending/wallmed1,/turf/unsimulated/wall,/area/asteroid_base/armoury_2)
"aR" = (/obj/machinery/door/airlock/halo_maint,/turf/unsimulated/floor{tag = "icon-plating"; icon_state = "plating"},/area/asteroid_base/armoury_2)
"aS" = (/obj/structure/sign/warning/moving_parts,/turf/simulated/wall/r_wall,/area/asteroid_base/armoury_2)
"aT" = (/obj/effect/floor_decal/corner/yellow{tag = "icon-corner_white (NORTHWEST)"; icon_state = "corner_white"; dir = 9},/obj/effect/floor_decal/industrial/warning/dust{tag = "icon-warning_dust (NORTH)"; icon_state = "warning_dust"; dir = 1},/obj/effect/decal/cleanable/dirt,/turf/unsimulated/floor{tag = "icon-dark"; icon_state = "dark"},/area/asteroid_base/armoury_2)
"aU" = (/obj/effect/floor_decal/industrial/warning/dust{tag = "icon-warning_dust (NORTH)"; icon_state = "warning_dust"; dir = 1},/obj/effect/decal/cleanable/dirt,/turf/unsimulated/floor{tag = "icon-dark"; icon_state = "dark"},/area/asteroid_base/armoury_2)
"aV" = (/obj/effect/floor_decal/corner/yellow{tag = "icon-corner_white (SOUTHEAST)"; icon_state = "corner_white"; dir = 6},/obj/effect/floor_decal/industrial/warning/dust{tag = "icon-warning_dust (NORTH)"; icon_state = "warning_dust"; dir = 1},/turf/unsimulated/floor{tag = "icon-dark"; icon_state = "dark"},/area/asteroid_base/armoury_2)
"aW" = (/obj/structure/sign/warning/fall,/turf/unsimulated/wall,/area/asteroid_base/storage_eng)
"aX" = (/obj/structure/grille,/obj/structure/window/reinforced/full,/turf/simulated/floor/plating,/area/asteroid_base/storage_eng)
"aY" = (/obj/machinery/door/airlock/halo_lifepod{name = "Airlock"},/turf/unsimulated/floor{tag = "icon-plating"; icon_state = "plating"},/area/asteroid_base/storage_eng)
"aZ" = (/obj/structure/sign/bluecross_2,/turf/simulated/wall/r_wall,/area/asteroid_base/storage_eng)
"ba" = (/turf/unsimulated/floor{tag = "icon-dark"; icon_state = "dark"},/area/asteroid_base/armoury_2)
"bb" = (/obj/effect/decal/cleanable/dirt,/turf/unsimulated/floor{tag = "icon-dark"; icon_state = "dark"},/area/asteroid_base/armoury_2)
"bc" = (/obj/effect/floor_decal/industrial/warning/dust{tag = "icon-warning_dust (EAST)"; icon_state = "warning_dust"; dir = 4},/turf/unsimulated/floor{tag = "icon-dark"; icon_state = "dark"},/area/asteroid_base/armoury_2)
"bd" = (/obj/effect/floor_decal/corner/yellow{tag = "icon-corner_white (NORTHWEST)"; icon_state = "corner_white"; dir = 9},/obj/effect/decal/cleanable/dirt,/turf/unsimulated/floor{tag = "icon-dark"; icon_state = "dark"},/area/asteroid_base/armoury_2)
"be" = (/obj/effect/floor_decal/corner/yellow{tag = "icon-corner_white (SOUTHEAST)"; icon_state = "corner_white"; dir = 6},/obj/effect/decal/cleanable/dirt,/turf/unsimulated/floor{tag = "icon-dark"; icon_state = "dark"},/area/asteroid_base/armoury_2)
"bf" = (/obj/effect/floor_decal/industrial/warning/dust{tag = "icon-warning_dust (WEST)"; icon_state = "warning_dust"; dir = 8},/turf/unsimulated/floor{tag = "icon-dark"; icon_state = "dark"},/area/asteroid_base/armoury_2)
"bg" = (/turf/unsimulated/floor{tag = "icon-dark"; icon_state = "dark"},/area/asteroid_base/storage_eng)
"bh" = (/obj/effect/decal/cleanable/dirt,/turf/unsimulated/floor{tag = "icon-dark"; icon_state = "dark"},/area/asteroid_base/storage_eng)
"bi" = (/obj/effect/floor_decal/sign/m,/turf/unsimulated/floor{tag = "icon-dark"; icon_state = "dark"},/area/asteroid_base/storage_eng)
"bj" = (/obj/machinery/door/airlock/halo_maint,/turf/unsimulated/floor{tag = "icon-plating"; icon_state = "plating"},/area/asteroid_base/storage_eng)
"bk" = (/obj/effect/floor_decal/sign/m,/turf/unsimulated/floor{tag = "icon-dark"; icon_state = "dark"},/area/asteroid_base/armoury_2)
"bl" = (/obj/machinery/light,/turf/unsimulated/floor{tag = "icon-dark"; icon_state = "dark"},/area/asteroid_base/armoury_2)
"bm" = (/obj/effect/decal/cleanable/dirt,/obj/machinery/light,/turf/unsimulated/floor{tag = "icon-dark"; icon_state = "dark"},/area/asteroid_base/armoury_2)
"bn" = (/obj/effect/floor_decal/corner/yellow{tag = "icon-corner_white (NORTHWEST)"; icon_state = "corner_white"; dir = 9},/turf/unsimulated/floor{tag = "icon-dark"; icon_state = "dark"},/area/asteroid_base/armoury_2)
"bo" = (/obj/effect/floor_decal/corner/yellow{tag = "icon-corner_white (SOUTHEAST)"; icon_state = "corner_white"; dir = 6},/turf/unsimulated/floor{tag = "icon-dark"; icon_state = "dark"},/area/asteroid_base/armoury_2)
"bp" = (/obj/machinery/light,/turf/unsimulated/floor{tag = "icon-dark"; icon_state = "dark"},/area/asteroid_base/storage_eng)
"bq" = (/obj/machinery/light/small/red{tag = "icon-bulb1 (NORTH)"; icon_state = "bulb1"; dir = 1},/turf/unsimulated/floor{tag = "icon-plating"; icon_state = "plating"},/area/asteroid_base/storage_eng)
"br" = (/turf/unsimulated/wall{tag = "icon-0"; icon_state = "0"},/area/asteroid_base/armoury_2)
"bs" = (/obj/structure/extinguisher_cabinet,/turf/unsimulated/wall,/area/asteroid_base/armoury_2)
"bt" = (/obj/structure/sign/halo_floorsign/cargobay{tag = "icon-cargobay (NORTH)"; icon_state = "cargobay"; dir = 1},/obj/effect/floor_decal/corner/yellow{tag = "icon-corner_white (NORTH)"; icon_state = "corner_white"; dir = 1},/turf/unsimulated/floor{tag = "icon-dark"; icon_state = "dark"},/area/asteroid_base/armoury_2)
"bu" = (/obj/structure/sign/halo_floorsign/cargobay{tag = "icon-cargobay (NORTH)"; icon_state = "cargobay"; dir = 1},/obj/effect/floor_decal/corner/yellow{tag = "icon-corner_white (EAST)"; icon_state = "corner_white"; dir = 4},/turf/unsimulated/floor{tag = "icon-dark"; icon_state = "dark"},/area/asteroid_base/armoury_2)
"bv" = (/obj/structure/extinguisher_cabinet,/turf/unsimulated/wall,/area/asteroid_base/storage_eng)
"bw" = (/obj/structure/mopbucket,/obj/effect/decal/cleanable/cobweb,/obj/item/weapon/mop,/turf/unsimulated/floor{tag = "icon-dark"; icon_state = "dark"},/area/asteroid_base/armoury_2)
"bx" = (/obj/structure/toilet,/turf/unsimulated/floor{tag = "icon-dark"; icon_state = "dark"},/area/asteroid_base/armoury_2)
"by" = (/obj/machinery/light{dir = 8},/turf/unsimulated/floor{tag = "icon-dark"; icon_state = "dark"},/area/asteroid_base/armoury_2)
"bz" = (/obj/structure/sign/halo_floorsign/maint{tag = "icon-maint (NORTH)"; icon_state = "maint"; dir = 1},/turf/unsimulated/floor{tag = "icon-plating"; icon_state = "plating"},/area/asteroid_base/storage_eng)
"bA" = (/obj/effect/decal/cleanable/generic,/obj/machinery/light/small{dir = 8},/turf/unsimulated/floor{tag = "icon-dark"; icon_state = "dark"},/area/asteroid_base/armoury_2)
"bB" = (/obj/structure/sink{dir = 4; icon_state = "sink"; pixel_x = 10; tag = "icon-sink (EAST)"},/turf/unsimulated/floor{tag = "icon-dark"; icon_state = "dark"},/area/asteroid_base/armoury_2)
"bC" = (/obj/structure/mirror,/turf/unsimulated/wall,/area/asteroid_base/armoury_2)
"bD" = (/obj/structure/sign/directions/supply{tag = "icon-direction_supply (NORTH)"; icon_state = "direction_supply"; dir = 1},/turf/unsimulated/wall,/area/asteroid_base/armoury_2)
"bE" = (/obj/effect/decal/cleanable/blood/oil,/turf/unsimulated/floor{tag = "icon-dark"; icon_state = "dark"},/area/asteroid_base/armoury_2)
"bF" = (/obj/structure/sign/directions/infirmary{tag = "icon-direction_infirm (EAST)"; icon_state = "direction_infirm"; dir = 4},/turf/unsimulated/wall,/area/asteroid_base/armoury_2)
"bG" = (/obj/structure/sign/warning/vent_port,/turf/unsimulated/wall{tag = "icon-0"; icon_state = "0"},/area/asteroid_base/storage_eng)
"bH" = (/obj/effect/decal/cleanable/cobweb,/turf/unsimulated/floor{tag = "icon-plating"; icon_state = "plating"},/area/asteroid_base/armoury_2)
"bI" = (/obj/structure/table/rack,/obj/item/weapon/gun/projectile/m6d_magnum,/obj/effect/decal/cleanable/cobweb,/turf/unsimulated/floor{tag = "icon-dark"; icon_state = "dark"},/area/asteroid_base/armoury_2)
"bJ" = (/obj/structure/table/rack,/obj/item/weapon/gun/projectile/m6d_magnum,/turf/unsimulated/floor{tag = "icon-dark"; icon_state = "dark"},/area/asteroid_base/armoury_2)
"bK" = (/obj/structure/table/rack,/obj/item/weapon/gun/projectile/ma5b_ar/MA37,/obj/effect/decal/cleanable/dirt,/turf/unsimulated/floor{tag = "icon-dark"; icon_state = "dark"},/area/asteroid_base/armoury_2)
"bL" = (/obj/machinery/door/airlock/halo,/turf/unsimulated/floor{tag = "icon-plating"; icon_state = "plating"},/area/asteroid_base/armoury_2)
"bM" = (/obj/structure/sign/halo_floorsign/maint{tag = "icon-maint (EAST)"; icon_state = "maint"; dir = 4},/turf/unsimulated/floor{tag = "icon-plating"; icon_state = "plating"},/area/asteroid_base/armoury_2)
"bN" = (/obj/machinery/light/small{dir = 4},/turf/unsimulated/floor{tag = "icon-plating"; icon_state = "plating"},/area/asteroid_base/armoury_2)
"bO" = (/obj/machinery/door/airlock/halo_lifepod{name = "Airlock"},/turf/unsimulated/floor{tag = "icon-plating"; icon_state = "plating"},/area/asteroid_base/armoury_2)
"bP" = (/turf/unsimulated/floor{tag = "icon-steel"; icon_state = "steel"},/area/asteroid_base/armoury_2)
"bQ" = (/obj/machinery/light{dir = 4; icon_state = "tube1"},/turf/unsimulated/floor{tag = "icon-dark"; icon_state = "dark"},/area/asteroid_base/armoury_2)
"bR" = (/obj/effect/decal/cleanable/cobweb,/turf/unsimulated/floor{tag = "icon-plating"; icon_state = "plating"},/area/asteroid_base/storage_eng)
"bS" = (/obj/structure/table/rack,/obj/item/ammo_magazine/m127_saphe,/obj/item/ammo_magazine/m127_saphe,/turf/unsimulated/floor{tag = "icon-dark"; icon_state = "dark"},/area/asteroid_base/armoury_2)
"bT" = (/obj/structure/table/rack,/obj/item/ammo_magazine/m762_ap/MA37,/obj/item/ammo_magazine/m762_ap/MA37,/turf/unsimulated/floor{tag = "icon-dark"; icon_state = "dark"},/area/asteroid_base/armoury_2)
"bU" = (/obj/structure/filingcabinet/chestdrawer,/turf/unsimulated/floor{tag = "icon-steel"; icon_state = "steel"},/area/asteroid_base/armoury_2)
"bV" = (/obj/effect/decal/cleanable/dirt,/turf/unsimulated/floor{tag = "icon-steel"; icon_state = "steel"},/area/asteroid_base/armoury_2)
"bW" = (/obj/structure/grille,/obj/structure/window/reinforced/full,/turf/simulated/floor/plating,/area/asteroid_base/armoury_2)
"bX" = (/obj/machinery/vending/security,/turf/unsimulated/floor{tag = "icon-steel"; icon_state = "steel"},/area/asteroid_base/armoury_2)
"bY" = (/obj/structure/filingcabinet/security,/obj/machinery/light{dir = 4; icon_state = "tube1"},/turf/unsimulated/floor{tag = "icon-steel"; icon_state = "steel"},/area/asteroid_base/armoury_2)
"bZ" = (/obj/machinery/door/blast/regular/triple{id = 2},/turf/unsimulated/floor{tag = "icon-dark"; icon_state = "dark"},/area/asteroid_base/armoury_2)
"ca" = (/obj/machinery/space_heater,/obj/machinery/light{dir = 8},/turf/unsimulated/floor{tag = "icon-steel"; icon_state = "steel"},/area/asteroid_base/armoury_2)
"cb" = (/obj/structure/bed/chair{tag = "icon-chair_preview (EAST)"; icon_state = "chair_preview"; dir = 4},/turf/unsimulated/floor{tag = "icon-steel"; icon_state = "steel"},/area/asteroid_base/armoury_2)
"cc" = (/obj/machinery/door/window/eastleft,/obj/structure/table/steel,/obj/item/weapon/paper_bin,/obj/item/weapon/pen/red,/turf/simulated/floor/plating,/area/asteroid_base/armoury_2)
"cd" = (/obj/structure/sign/warning/vent_port,/turf/unsimulated/wall{tag = "icon-0"; icon_state = "0"},/area/asteroid_base/armoury_2)
"ce" = (/obj/machinery/vending/cigarette,/turf/unsimulated/floor{tag = "icon-steel"; icon_state = "steel"},/area/asteroid_base/armoury_2)
"cf" = (/obj/machinery/door/window/eastright,/obj/structure/table/steel,/obj/effect/decal/cleanable/generic,/obj/item/weapon/reagent_containers/spray/pepper,/turf/simulated/floor/plating,/area/asteroid_base/armoury_2)
"cg" = (/obj/machinery/light/small/red{tag = "icon-bulb1 (EAST)"; icon_state = "bulb1"; dir = 4},/turf/unsimulated/floor{tag = "icon-plating"; icon_state = "plating"},/area/asteroid_base/armoury_2)
"ch" = (/obj/structure/reagent_dispensers/peppertank,/turf/unsimulated/wall,/area/asteroid_base/armoury_2)
"ci" = (/obj/machinery/recharger/wallcharger,/turf/unsimulated/wall,/area/asteroid_base/armoury_2)
"cj" = (/obj/machinery/button/remote/blast_door{id = 2},/turf/unsimulated/wall,/area/asteroid_base/armoury_2)
"ck" = (/obj/machinery/door/blast/regular/triple,/obj/effect/decal/cleanable/dirt,/turf/unsimulated/floor{tag = "icon-plating"; icon_state = "plating"},/area/asteroid_base/armoury_2)
"cl" = (/obj/structure/sign/warning/detailed{name = "\improper AUTHORIZED PERSONNEL ONLY"},/turf/unsimulated/wall,/area/asteroid_base/armoury_2)
"cm" = (/obj/machinery/light/small/red{tag = "icon-bulb1 (WEST)"; icon_state = "bulb1"; dir = 8},/turf/unsimulated/floor{tag = "icon-plating"; icon_state = "plating"},/area/asteroid_base/armoury_2)
"cn" = (/obj/machinery/button/remote/blast_door{id = 1},/turf/unsimulated/wall,/area/asteroid_base/armoury_2)
"co" = (/turf/unsimulated/wall{tag = "icon-rock-dark"; icon_state = "rock-dark"},/area/asteroid_base/armoury_1)
"cp" = (/turf/unsimulated/floor{tag = "icon-plating"; icon_state = "plating"},/area/asteroid_base/armoury_1)
"cq" = (/obj/effect/decal/cleanable/dirt,/turf/unsimulated/floor{tag = "icon-plating"; icon_state = "plating"},/area/asteroid_base/armoury_1)
"cr" = (/obj/effect/decal/cleanable/cobweb2,/obj/effect/decal/cleanable/dirt,/turf/unsimulated/floor{tag = "icon-plating"; icon_state = "plating"},/area/asteroid_base/armoury_1)
"cs" = (/turf/unsimulated/wall{tag = "icon-rock-dark"; icon_state = "rock-dark"},/area/asteroid_base/storage_medbay)
"ct" = (/turf/unsimulated/floor{tag = "icon-plating"; icon_state = "plating"},/area/asteroid_base/storage_medbay)
"cu" = (/obj/structure/sign/warning/hot_exhaust,/turf/unsimulated/wall{tag = "icon-rock-dark"; icon_state = "rock-dark"},/area/asteroid_base/storage_medbay)
"cv" = (/obj/structure/sign/warning/hot_exhaust,/turf/unsimulated/wall{tag = "icon-rock-dark"; icon_state = "rock-dark"},/area/asteroid_base/armoury_1)
"cw" = (/obj/effect/decal/cleanable/dirt,/turf/unsimulated/floor{tag = "icon-plating"; icon_state = "plating"},/area/asteroid_base/storage_medbay)
"cx" = (/obj/effect/decal/cleanable/cobweb2,/turf/unsimulated/floor{tag = "icon-plating"; icon_state = "plating"},/area/asteroid_base/storage_medbay)
"cy" = (/obj/effect/floor_decal/snow,/turf/unsimulated/floor{tag = "icon-plating"; icon_state = "plating"},/area/asteroid_base/armoury_1)
"cz" = (/obj/structure/grille,/turf/unsimulated/floor{tag = "icon-plating"; icon_state = "plating"},/area/asteroid_base/armoury_1)
"cA" = (/turf/unsimulated/floor{tag = "icon-snow"; icon_state = "snow"},/area/asteroid_base/armoury_1)
"cB" = (/turf/unsimulated/floor{tag = "icon-snow"; icon_state = "snow"},/area/asteroid_base/storage_medbay)
"cC" = (/obj/structure/grille,/obj/effect/decal/cleanable/dirt,/turf/unsimulated/floor{tag = "icon-plating"; icon_state = "plating"},/area/asteroid_base/storage_medbay)
"cD" = (/obj/effect/landmark/drop_pod_landing,/turf/unsimulated/floor{tag = "icon-snow"; icon_state = "snow"},/area/asteroid_base/armoury_1)
"cE" = (/turf/simulated/open,/area/asteroid_base/storage_medbay)
"cF" = (/turf/unsimulated/wall{tag = "icon-rock-dark"; icon_state = "rock-dark"},/area/asteroid_base/mac_gun)
"cG" = (/turf/unsimulated/wall{tag = "icon-rock-dark"; icon_state = "rock-dark"},/area/asteroid_base/central_hallway_1)
"cH" = (/turf/unsimulated/floor{tag = "icon-snow"; icon_state = "snow"},/area/asteroid_base/central_hallway_2)
"cI" = (/turf/unsimulated/wall{tag = "icon-rock-dark"; icon_state = "rock-dark"},/area/asteroid_base/medbay)
"cJ" = (/turf/unsimulated/wall{tag = "icon-rock-dark"; icon_state = "rock-dark"},/area/asteroid_base/vault)
"cK" = (/turf/unsimulated/wall{tag = "icon-rock-dark"; icon_state = "rock-dark"},/area/asteroid_base/main_hangar)
"cL" = (/turf/unsimulated/wall{tag = "icon-rock-dark"; icon_state = "rock-dark"},/area/asteroid_base/north_airlock_1)
"cM" = (/obj/effect/landmark/test/safe_turf,/turf/unsimulated/floor{tag = "icon-snow"; icon_state = "snow"},/area/asteroid_base/armoury_1)
"cN" = (/turf/unsimulated/wall{tag = "icon-rock-dark"; icon_state = "rock-dark"},/area/asteroid_base/west_dorms)
"cO" = (/obj/effect/landmark/map_data{height = 4},/turf/unsimulated/floor{tag = "icon-snow"; icon_state = "snow"},/area/asteroid_base/east_dorms)
"cP" = (/turf/unsimulated/wall{tag = "icon-rock-dark"; icon_state = "rock-dark"},/area/asteroid_base/mess_hall)
"cQ" = (/turf/unsimulated/wall{tag = "icon-rock-dark"; icon_state = "rock-dark"},/area/asteroid_base/kitchen)
"cR" = (/turf/unsimulated/wall{tag = "icon-rock-dark"; icon_state = "rock-dark"},/area/asteroid_base/engine/generator/control)
"cS" = (/turf/unsimulated/wall{tag = "icon-rock-dark"; icon_state = "rock-dark"},/area/asteroid_base/engine/smes)
"cT" = (/turf/unsimulated/wall{tag = "icon-rock-dark"; icon_state = "rock-dark"},/area/asteroid_base/engine/canisters)
"cU" = (/turf/unsimulated/wall{tag = "icon-rock-dark"; icon_state = "rock-dark"},/area/asteroid_base/atmos)

(1,1,1) = {"
aaaaaaaaaaabababababababababababababababababababacacacacacacacacacacacacacacacacacacacacacacacacacac
aaadadadaaabababababababababababababababababababacacacacacacacacacacacacacacacacacacacacacacacacacac
aaadaeadaaabababababababababababafafafafafagafafahahahacacacacacacacacacacacacacacacacacacacacacacac
aaadadadaaabababababababababababafaiajajakalakajamamahacacacacacacacacacacacacacacacacacacacacacacac
aaaaaaaaaaabababababababafafagafafajajananaoananamamahahahahahahacacacacacapapapapapacacacacacacacac
ababababababababababababafaqarasafajajanananananamamahatauavawahapapapapapapaxayazapacacacacacacacac
ababababababababababababafaqaAaqafalalaoanananaoaBaBahaCaDaEaEaFapayayaxaxayaGaHaIapacacacacacacacac
ababababababababababababafasaJaqafaKajanananananamaLahaMaDaDaDaNapaxapapapapayayaxapacacacacacacacac
ababababababababababababafafasafafajajanananananamamahaOaEaEaPahapaxapacacapapapapapacacacacacacacac
abababababafafaQafafafafafafaRafafafaSafaTaUaVafaWahahaXaXaYaZahahaxapacacacacacacacacacacacacacacac
abababababafbabbbbbababbbabababbbabbbbbcbdbbbebfbgbgbgbhbhbhbgbibjayapacacacacacacacacapapapapapacac
abababababafbabkblbabbbbbabmbbbbbbbbblbcbnbbbobfbgbpbgbhbgbgbpbgahapapacacacacacacacacapaybqazapacac
ababababbrafafaRafafafbsafafafafafafafafbtbabuafahahahahahaNahbvahacacacacacacacacacacapaxaHaxapacac
ababababbraqasasbrababababababafbwbxafafbybabaafacacacacacacacacacacacacacacacacacacacapaybzaxapacac
ababababbraqbrbrbrbrafafafafafafbAbBbCbDbabbbEbFacacacacacacacacacacacacacacacacacacacapapaybGapacac
ababababbraqbrbHaqaqafbIbJbKafafbLafbsafbabbbbafacacacacacacacacacacacacacacacacacacacacacaxacacacac
ababababbrasasbMaAbNafbybbbbbObPbPbPbPbLbabbbQafacacacacacacacacacacacacacacacbRaxaxayayaxaxacacacac
ababababbrbrbraqaqasafbSbSbTafbUbPbVbPbWbbbbbaafacacacacacacacacacacacacacacacayacacacacacacacacacac
ababababababbrbrbrbrafafafafafbXbPbVbYafbZbbbbafacacacacacacacacacacacacacacacaxacacacacacacacacacac
abababababbrbrbrbrbrababababafcabVbPcbccbabbbQafacacacacacacacacacacacacacacacaxacacacacacacacacacac
abababababcdaqaqaqbrababababafcebPbPcbcfbbbbbbaQacacacacacacacacacacacacacacacayacacacacacacacacacac
ababaqasasasbMaAcgbrababababafafchcicjafbybbbbafacacacacacacacacacacacacacacacaxaxazacacacacacacacac
ababaqababbrasaqasbrabababababababababafckasaqafacacacacacacacacacacacacacacacacacayacacacacacacacac
ababaqababbrbrbrbrbrabababababababababclcmaqascnacacacacacacacacacacacacacacacacacaxacacacacacacacac
ababasabababababababababababababababababasaqaqabacacacacacacacacacacacacacacacacacaxayaxaxaxacacacac
cococpcocococococococococococococococococqcqcqcoacacacacacacacacacacacacacacacacacacacacacayacacacac
cococqcqcrcocococococococococococococococqcpcqcocscscscscscscscscscscscscscscscscscscscscsctcucscscs
cococococpcocvcocococococococococococococpcpcpcocscscscscscscscscscscscscscscscscscscscscscwcxcscscs
cococococqcqcrcocococococococococococococycycycocscscscscscscscscscscscscscscscscscscscscscsctcscscs
cococococococqcocococococococococococococycycycocscscscscscscscscscscscscscscscscscscscscscscwcscscs
cococococococzcococococococococococAcAcAcAcAcAcocBcscBcBcscscscscscscscscscscscscscscscscscscwcscscs
cococococococAcAcAcococococococAcAcAcAcAcAcAcAcAcBcBcBcBcBcscscscscscscscscBcBcscscscscscscscCcscscs
cocococAcAcAcAcAcAcAcAcAcAcAcAcAcAcAcAcAcAcAcAcAcBcBcBcBcBcBcscscscscscscBcBcBcBcscscscscBcBcBcBcscs
cococAcAcAcAcAcAcAcAcAcAcAcAcAcAcAcAcAcAcAcAcAcAcBcBcBcBcBcBcBcBcBcBcBcBcBcBcBcBcBcBcBcBcBcBcBcBcBcs
cocAcAcAcAcAcAcAcAcAcAcAcAcAcAcAcAcAcAcAcAcAcAcAcBcBcBcBcBcBcBcBcBcBcBcBcBcBcBcBcBcBcBcBcBcBcBcBcBcs
cococAcAcAcAcAcAcAcAcAcAcAcAcAcAcAcAcAcAcAcAcAcAcBcBcBcBcBcBcBcBcBcBcBcBcBcBcBcBcBcBcBcBcBcBcBcBcBcs
cococAcAcAcAcAcAcAcAcAcAcAcAcDcAcAcAcAcAcAcAcAcAcBcBcBcBcBcBcBcBcBcBcBcBcBcBcBcBcBcBcBcBcBcBcBcBcBcs
cocAcAcAcAcDcAcAcAcAcAcAcAcAcAcAcAcAcAcAcDcAcAcAcBcBcEcEcEcEcEcEcEcBcBcBcBcBcEcEcEcEcEcEcEcBcBcBcscs
cocAcAcAcAcAcAcAcAcAcAcAcAcAcAcAcAcAcAcAcAcAcAcAcBcBcEcEcEcEcEcEcEcBcBcBcBcBcEcEcEcEcEcEcEcBcBcBcscs
cocAcAcAcAcAcAcAcAcAcAcAcAcAcAcAcAcAcAcAcAcAcAcAcBcBcEcEcEcEcEcEcEcBcBcBcBcBcEcEcEcEcEcEcEcBcBcBcscs
cocococAcAcAcAcAcAcAcAcAcAcAcAcAcAcAcAcAcAcAcAcAcBcBcEcEcEcEcEcEcEcBcBcBcBcBcEcEcEcEcEcEcEcBcBcBcBcs
cocAcAcAcAcAcAcAcAcAcAcAcAcAcAcAcAcAcAcAcAcAcAcAcBcBcEcEcEcEcEcEcEcBcBcBcBcBcEcEcEcEcEcEcEcBcBcBcBcs
cocAcAcAcAcAcAcAcAcAcAcAcAcAcAcAcAcAcAcAcAcAcAcAcBcBcEcEcEcEcEcEcEcBcBcBcBcBcEcEcEcEcEcEcEcBcBcBcBcs
cocAcAcAcAcAcAcAcAcAcAcAcAcAcDcAcAcAcAcAcDcAcAcAcBcBcEcEcEcEcEcEcEcBcBcBcBcBcEcEcEcEcEcEcEcBcBcBcBcs
cococAcAcAcDcAcAcAcAcAcAcAcAcAcAcAcAcAcAcAcAcAcAcBcBcBcBcBcBcBcBcBcBcBcBcBcBcBcBcBcBcBcBcBcBcBcBcscs
cococAcAcAcAcAcAcAcAcAcAcAcAcAcAcAcAcAcAcAcAcAcAcBcBcBcBcBcBcBcBcBcBcBcBcBcBcBcBcBcBcBcBcBcBcBcBcscs
cFcGcHcAcAcAcAcAcAcAcAcAcAcAcAcAcAcAcAcAcAcAcAcAcBcBcBcBcBcBcBcBcBcBcBcBcBcBcBcBcBcBcBcBcBcBcBcscscs
cIcJcKcLcMcAcAcAcAcAcAcAcAcAcAcAcAcAcAcAcAcAcAcocBcBcBcBcBcBcBcBcBcBcBcscBcBcBcBcBcBcBcBcBcBcscscscs
cNcOcPcQcocAcAcAcAcAcAcococAcDcAcAcocAcAcAcAcAcocscscBcBcBcBcBcBcBcBcscscscscBcBcBcBcBcscscscscscscs
cRcScTcUcococococococococococococococococococococscscscscscscscscscscscscscscscscscscscscscscscscscs
"}
