"aa" = (/turf/unsimulated/wall,/area/space)
"ab" = (/turf/unsimulated/wall{tag = "icon-rock-dark"; icon_state = "rock-dark"},/area/asteroid_base/armoury_2)
"ac" = (/turf/unsimulated/wall{tag = "icon-rock-dark"; icon_state = "rock-dark"},/area/asteroid_base/storage_eng)
"ad" = (/turf/space,/area/space)
"ae" = (/obj/effect/landmark/test/space_turf,/turf/space,/area/space)
"af" = (/turf/unsimulated/wall,/area/asteroid_base/armoury_2)
"ag" = (/obj/structure/sign/deck/fourth,/turf/unsimulated/wall,/area/asteroid_base/armoury_2)
"ah" = (/turf/unsimulated/wall,/area/asteroid_base/storage_eng)
"ai" = (/obj/effect/decal/cleanable/cobweb,/turf/simulated/open,/area/asteroid_base/armoury_2)
"aj" = (/turf/simulated/open,/area/asteroid_base/armoury_2)
"ak" = (/obj/machinery/light/spot{dir = 1},/turf/simulated/open,/area/asteroid_base/armoury_2)
"al" = (/obj/structure/lattice,/turf/simulated/open,/area/asteroid_base/armoury_2)
"am" = (/turf/simulated/open,/area/asteroid_base/storage_eng)
"an" = (/turf/unsimulated/mask,/area/asteroid_base/armoury_2)
"ao" = (/obj/structure/lattice,/turf/unsimulated/mask,/area/asteroid_base/armoury_2)
"ap" = (/turf/simulated/wall,/area/asteroid_base/storage_eng)
"aq" = (/obj/effect/decal/cleanable/dirt,/turf/simulated/floor/plating,/area/asteroid_base/armoury_2)
"ar" = (/obj/machinery/light/small{dir = 1},/turf/simulated/floor/plating,/area/asteroid_base/armoury_2)
"as" = (/turf/simulated/floor/plating,/area/asteroid_base/armoury_2)
"at" = (/obj/structure/table/standard,/obj/item/weapon/storage/firstaid/toxin,/turf/simulated/floor/tiled/white,/area/asteroid_base/storage_eng)
"au" = (/obj/structure/table/standard,/obj/effect/decal/cleanable/dirt,/obj/item/weapon/storage/firstaid/erk,/turf/simulated/floor/tiled/white,/area/asteroid_base/storage_eng)
"av" = (/obj/structure/table/standard,/obj/item/weapon/storage/firstaid/regular,/obj/machinery/light{dir = 1},/turf/simulated/floor/tiled/white,/area/asteroid_base/storage_eng)
"aw" = (/obj/structure/table/standard,/obj/item/roller,/obj/item/roller,/turf/simulated/floor/tiled/white,/area/asteroid_base/storage_eng)
"ax" = (/obj/effect/decal/cleanable/dirt,/turf/simulated/floor/plating,/area/asteroid_base/storage_eng)
"ay" = (/turf/simulated/floor/plating,/area/asteroid_base/storage_eng)
"az" = (/obj/effect/decal/cleanable/cobweb2,/turf/simulated/floor/plating,/area/asteroid_base/storage_eng)
"aA" = (/obj/structure/ladder,/turf/simulated/floor/plating,/area/asteroid_base/armoury_2)
"aB" = (/obj/effect/landmark/ghost_spawn,/turf/unsimulated/mask,/area/asteroid_base/armoury_2)
"aC" = (/obj/structure/lattice,/turf/simulated/open,/area/asteroid_base/storage_eng)
"aD" = (/obj/structure/closet/secure_closet/paramedic,/turf/simulated/floor/tiled/white,/area/asteroid_base/storage_eng)
"aE" = (/obj/effect/decal/cleanable/dirt,/turf/simulated/floor/tiled/white,/area/asteroid_base/storage_eng)
"aF" = (/turf/simulated/floor/tiled/white,/area/asteroid_base/storage_eng)
"aG" = (/obj/structure/closet/medical_wall/filled,/turf/unsimulated/wall,/area/asteroid_base/storage_eng)
"aH" = (/obj/structure/sign/halo_floorsign/maint{tag = "icon-maint (EAST)"; icon_state = "maint"; dir = 4},/turf/simulated/floor/plating,/area/asteroid_base/storage_eng)
"aI" = (/obj/structure/ladder,/turf/simulated/floor/plating,/area/asteroid_base/storage_eng)
"aJ" = (/obj/effect/decal/cleanable/dirt,/obj/machinery/light/small{dir = 4},/turf/simulated/floor/plating,/area/asteroid_base/storage_eng)
"aK" = (/obj/structure/sign/halo_floorsign/maint{tag = "icon-maint (NORTH)"; icon_state = "maint"; dir = 1},/turf/simulated/floor/plating,/area/asteroid_base/armoury_2)
"aL" = (/obj/machinery/light/spot{dir = 8},/turf/simulated/open,/area/asteroid_base/armoury_2)
"aM" = (/obj/machinery/light/spot{dir = 4},/turf/simulated/open,/area/asteroid_base/storage_eng)
"aN" = (/obj/effect/decal/cleanable/dirt,/obj/machinery/vending/medical,/turf/simulated/floor/tiled/white,/area/asteroid_base/storage_eng)
"aO" = (/obj/machinery/vending/wallmed1,/turf/unsimulated/wall,/area/asteroid_base/storage_eng)
"aP" = (/obj/effect/decal/cleanable/dirt,/obj/structure/closet/secure_closet/medical3,/obj/machinery/light{dir = 8},/turf/simulated/floor/tiled/white,/area/asteroid_base/storage_eng)
"aQ" = (/obj/machinery/space_heater,/turf/simulated/floor/tiled/white,/area/asteroid_base/storage_eng)
"aR" = (/obj/machinery/vending/wallmed1,/turf/unsimulated/wall,/area/asteroid_base/armoury_2)
"aS" = (/obj/machinery/door/airlock/halo_maint,/turf/simulated/floor/plating,/area/asteroid_base/armoury_2)
"aT" = (/obj/structure/sign/warning/moving_parts,/turf/simulated/wall/r_wall,/area/asteroid_base/armoury_2)
"aU" = (/obj/effect/floor_decal/corner/yellow{tag = "icon-corner_white (NORTHWEST)"; icon_state = "corner_white"; dir = 9},/obj/effect/floor_decal/industrial/warning/dust{tag = "icon-warning_dust (NORTH)"; icon_state = "warning_dust"; dir = 1},/obj/effect/decal/cleanable/dirt,/turf/simulated/floor/tiled/dark,/area/asteroid_base/armoury_2)
"aV" = (/obj/effect/floor_decal/industrial/warning/dust{tag = "icon-warning_dust (NORTH)"; icon_state = "warning_dust"; dir = 1},/obj/effect/decal/cleanable/dirt,/turf/simulated/floor/tiled/dark,/area/asteroid_base/armoury_2)
"aW" = (/obj/effect/floor_decal/corner/yellow{tag = "icon-corner_white (SOUTHEAST)"; icon_state = "corner_white"; dir = 6},/obj/effect/floor_decal/industrial/warning/dust{tag = "icon-warning_dust (NORTH)"; icon_state = "warning_dust"; dir = 1},/turf/simulated/floor/tiled/dark,/area/asteroid_base/armoury_2)
"aX" = (/obj/structure/sign/warning/fall,/turf/unsimulated/wall,/area/asteroid_base/storage_eng)
"aY" = (/obj/structure/grille,/obj/structure/window/reinforced/full,/turf/simulated/floor/plating,/area/asteroid_base/storage_eng)
"aZ" = (/obj/machinery/door/airlock/halo_lifepod{name = "Airlock"},/turf/simulated/floor/tiled/dark,/area/asteroid_base/storage_eng)
"ba" = (/obj/structure/sign/bluecross_2,/turf/simulated/wall/r_wall,/area/asteroid_base/storage_eng)
"bb" = (/turf/simulated/floor/tiled/dark,/area/asteroid_base/armoury_2)
"bc" = (/obj/effect/decal/cleanable/dirt,/turf/simulated/floor/tiled/dark,/area/asteroid_base/armoury_2)
"bd" = (/obj/effect/floor_decal/industrial/warning/dust{tag = "icon-warning_dust (EAST)"; icon_state = "warning_dust"; dir = 4},/turf/simulated/floor/tiled/dark,/area/asteroid_base/armoury_2)
"be" = (/obj/effect/floor_decal/corner/yellow{tag = "icon-corner_white (NORTHWEST)"; icon_state = "corner_white"; dir = 9},/obj/effect/decal/cleanable/dirt,/turf/simulated/floor/tiled/dark,/area/asteroid_base/armoury_2)
"bf" = (/obj/effect/floor_decal/corner/yellow{tag = "icon-corner_white (SOUTHEAST)"; icon_state = "corner_white"; dir = 6},/obj/effect/decal/cleanable/dirt,/turf/simulated/floor/tiled/dark,/area/asteroid_base/armoury_2)
"bg" = (/obj/effect/floor_decal/industrial/warning/dust{tag = "icon-warning_dust (WEST)"; icon_state = "warning_dust"; dir = 8},/turf/simulated/floor/tiled/dark,/area/asteroid_base/armoury_2)
"bh" = (/turf/simulated/floor/tiled/dark,/area/asteroid_base/storage_eng)
"bi" = (/obj/effect/decal/cleanable/dirt,/turf/simulated/floor/tiled/dark,/area/asteroid_base/storage_eng)
"bj" = (/obj/effect/floor_decal/sign/m,/turf/simulated/floor/tiled/dark,/area/asteroid_base/storage_eng)
"bk" = (/obj/machinery/door/airlock/halo_maint,/turf/simulated/floor/plating,/area/asteroid_base/storage_eng)
"bl" = (/obj/effect/floor_decal/sign/m,/turf/simulated/floor/tiled/dark,/area/asteroid_base/armoury_2)
"bm" = (/obj/machinery/light,/turf/simulated/floor/tiled/dark,/area/asteroid_base/armoury_2)
"bn" = (/obj/effect/decal/cleanable/dirt,/obj/machinery/light,/turf/simulated/floor/tiled/dark,/area/asteroid_base/armoury_2)
"bo" = (/obj/effect/floor_decal/corner/yellow{tag = "icon-corner_white (NORTHWEST)"; icon_state = "corner_white"; dir = 9},/turf/simulated/floor/tiled/dark,/area/asteroid_base/armoury_2)
"bp" = (/obj/effect/floor_decal/corner/yellow{tag = "icon-corner_white (SOUTHEAST)"; icon_state = "corner_white"; dir = 6},/turf/simulated/floor/tiled/dark,/area/asteroid_base/armoury_2)
"bq" = (/obj/machinery/light,/turf/simulated/floor/tiled/dark,/area/asteroid_base/storage_eng)
"br" = (/obj/machinery/light/small/red{tag = "icon-bulb1 (NORTH)"; icon_state = "bulb1"; dir = 1},/turf/simulated/floor/plating,/area/asteroid_base/storage_eng)
"bs" = (/turf/simulated/wall,/area/asteroid_base/armoury_2)
"bt" = (/obj/structure/extinguisher_cabinet,/turf/unsimulated/wall,/area/asteroid_base/armoury_2)
"bu" = (/obj/structure/sign/halo_floorsign/cargobay{tag = "icon-cargobay (NORTH)"; icon_state = "cargobay"; dir = 1},/obj/effect/floor_decal/corner/yellow{tag = "icon-corner_white (NORTH)"; icon_state = "corner_white"; dir = 1},/turf/simulated/floor/tiled/dark,/area/asteroid_base/armoury_2)
"bv" = (/obj/structure/sign/halo_floorsign/cargobay{tag = "icon-cargobay (NORTH)"; icon_state = "cargobay"; dir = 1},/obj/effect/floor_decal/corner/yellow{tag = "icon-corner_white (EAST)"; icon_state = "corner_white"; dir = 4},/turf/simulated/floor/tiled/dark,/area/asteroid_base/armoury_2)
"bw" = (/obj/structure/extinguisher_cabinet,/turf/unsimulated/wall,/area/asteroid_base/storage_eng)
"bx" = (/obj/structure/mopbucket,/obj/effect/decal/cleanable/cobweb,/obj/item/weapon/mop,/turf/simulated/floor/tiled/dark,/area/asteroid_base/armoury_2)
"by" = (/obj/structure/toilet,/turf/simulated/floor/tiled/dark,/area/asteroid_base/armoury_2)
"bz" = (/obj/machinery/light{dir = 8},/turf/simulated/floor/tiled/dark,/area/asteroid_base/armoury_2)
"bA" = (/obj/structure/sign/halo_floorsign/maint{tag = "icon-maint (NORTH)"; icon_state = "maint"; dir = 1},/turf/simulated/floor/plating,/area/asteroid_base/storage_eng)
"bB" = (/obj/effect/decal/cleanable/generic,/obj/machinery/light/small{dir = 8},/turf/simulated/floor/tiled/dark,/area/asteroid_base/armoury_2)
"bC" = (/obj/structure/sink{dir = 4; icon_state = "sink"; pixel_x = 10; tag = "icon-sink (EAST)"},/turf/simulated/floor/tiled/dark,/area/asteroid_base/armoury_2)
"bD" = (/obj/structure/mirror,/turf/unsimulated/wall,/area/asteroid_base/armoury_2)
"bE" = (/obj/structure/sign/directions/supply{tag = "icon-direction_supply (NORTH)"; icon_state = "direction_supply"; dir = 1},/turf/unsimulated/wall,/area/asteroid_base/armoury_2)
"bF" = (/obj/effect/decal/cleanable/blood/oil,/turf/simulated/floor/tiled/dark,/area/asteroid_base/armoury_2)
"bG" = (/obj/structure/sign/directions/infirmary{tag = "icon-direction_infirm (EAST)"; icon_state = "direction_infirm"; dir = 4},/turf/unsimulated/wall,/area/asteroid_base/armoury_2)
"bH" = (/obj/structure/sign/warning/vent_port,/turf/simulated/wall,/area/asteroid_base/storage_eng)
"bI" = (/obj/effect/decal/cleanable/cobweb,/turf/simulated/floor/plating,/area/asteroid_base/armoury_2)
"bJ" = (/obj/structure/table/rack,/obj/item/weapon/gun/projectile/m6d_magnum,/obj/effect/decal/cleanable/cobweb,/turf/simulated/floor/tiled/dark,/area/asteroid_base/armoury_2)
"bK" = (/obj/structure/table/rack,/obj/item/weapon/gun/projectile/m6d_magnum,/turf/simulated/floor/tiled/dark,/area/asteroid_base/armoury_2)
"bL" = (/obj/structure/table/rack,/obj/item/weapon/gun/projectile/ma5b_ar/MA37,/obj/effect/decal/cleanable/dirt,/turf/simulated/floor/tiled/dark,/area/asteroid_base/armoury_2)
"bM" = (/obj/machinery/door/airlock/halo,/turf/simulated/floor/plating,/area/asteroid_base/armoury_2)
"bN" = (/obj/structure/sign/halo_floorsign/maint{tag = "icon-maint (EAST)"; icon_state = "maint"; dir = 4},/turf/simulated/floor/plating,/area/asteroid_base/armoury_2)
"bO" = (/obj/machinery/light/small{dir = 4},/turf/simulated/floor/plating,/area/asteroid_base/armoury_2)
"bP" = (/obj/machinery/door/airlock/halo_lifepod{name = "Airlock"},/turf/simulated/floor/plating,/area/asteroid_base/armoury_2)
"bQ" = (/turf/simulated/floor/tiled,/area/asteroid_base/armoury_2)
"bR" = (/obj/machinery/light{dir = 4; icon_state = "tube1"},/turf/simulated/floor/tiled/dark,/area/asteroid_base/armoury_2)
"bS" = (/obj/effect/decal/cleanable/cobweb,/turf/simulated/floor/plating,/area/asteroid_base/storage_eng)
"bT" = (/obj/structure/table/rack,/obj/item/ammo_magazine/m127_saphe,/obj/item/ammo_magazine/m127_saphe,/turf/simulated/floor/tiled/dark,/area/asteroid_base/armoury_2)
"bU" = (/obj/structure/table/rack,/obj/item/ammo_magazine/m762_ap/MA37,/obj/item/ammo_magazine/m762_ap/MA37,/turf/simulated/floor/tiled/dark,/area/asteroid_base/armoury_2)
"bV" = (/obj/structure/filingcabinet/chestdrawer,/turf/simulated/floor/tiled,/area/asteroid_base/armoury_2)
"bW" = (/obj/effect/decal/cleanable/dirt,/turf/simulated/floor/tiled,/area/asteroid_base/armoury_2)
"bX" = (/obj/structure/grille,/obj/structure/window/reinforced/full,/turf/simulated/floor/plating,/area/asteroid_base/armoury_2)
"bY" = (/obj/machinery/vending/security,/turf/simulated/floor/tiled,/area/asteroid_base/armoury_2)
"bZ" = (/obj/structure/filingcabinet/security,/obj/machinery/light{dir = 4; icon_state = "tube1"},/turf/simulated/floor/tiled,/area/asteroid_base/armoury_2)
"ca" = (/obj/machinery/door/blast/regular/triple{id = 2},/turf/simulated/floor/tiled/dark,/area/asteroid_base/armoury_2)
"cb" = (/obj/machinery/space_heater,/obj/machinery/light{dir = 8},/turf/simulated/floor/tiled,/area/asteroid_base/armoury_2)
"cc" = (/obj/structure/bed/chair{tag = "icon-chair_preview (EAST)"; icon_state = "chair_preview"; dir = 4},/turf/simulated/floor/tiled,/area/asteroid_base/armoury_2)
"cd" = (/obj/machinery/door/window/eastleft,/obj/structure/table/steel,/obj/item/weapon/paper_bin,/obj/item/weapon/pen/red,/turf/simulated/floor/tiled,/area/asteroid_base/armoury_2)
"ce" = (/obj/structure/sign/warning/vent_port,/turf/simulated/wall,/area/asteroid_base/armoury_2)
"cf" = (/obj/machinery/vending/cigarette,/turf/simulated/floor/tiled,/area/asteroid_base/armoury_2)
"cg" = (/obj/machinery/door/window/eastright,/obj/structure/table/steel,/obj/effect/decal/cleanable/generic,/obj/item/weapon/reagent_containers/spray/pepper,/turf/simulated/floor/tiled,/area/asteroid_base/armoury_2)
"ch" = (/obj/machinery/light/small/red{tag = "icon-bulb1 (EAST)"; icon_state = "bulb1"; dir = 4},/turf/simulated/floor/plating,/area/asteroid_base/armoury_2)
"ci" = (/obj/structure/reagent_dispensers/peppertank,/turf/unsimulated/wall,/area/asteroid_base/armoury_2)
"cj" = (/obj/machinery/recharger/wallcharger,/turf/unsimulated/wall,/area/asteroid_base/armoury_2)
"ck" = (/obj/machinery/button/remote/blast_door{id = 2},/turf/unsimulated/wall,/area/asteroid_base/armoury_2)
"cl" = (/obj/machinery/door/blast/regular/triple,/obj/effect/decal/cleanable/dirt,/turf/simulated/floor/plating,/area/asteroid_base/armoury_2)
"cm" = (/obj/structure/sign/warning/detailed{name = "\improper AUTHORIZED PERSONNEL ONLY"},/turf/unsimulated/wall,/area/asteroid_base/armoury_2)
"cn" = (/obj/machinery/light/small/red{tag = "icon-bulb1 (WEST)"; icon_state = "bulb1"; dir = 8},/turf/simulated/floor/plating,/area/asteroid_base/armoury_2)
"co" = (/obj/machinery/button/remote/blast_door{id = 1},/turf/unsimulated/wall,/area/asteroid_base/armoury_2)
"cp" = (/turf/unsimulated/wall{tag = "icon-rock-dark"; icon_state = "rock-dark"},/area/asteroid_base/armoury_1)
"cq" = (/turf/simulated/floor/plating,/area/asteroid_base/armoury_1)
"cr" = (/obj/effect/decal/cleanable/dirt,/turf/simulated/floor/plating,/area/asteroid_base/armoury_1)
"cs" = (/obj/effect/decal/cleanable/cobweb2,/obj/effect/decal/cleanable/dirt,/turf/simulated/floor/plating,/area/asteroid_base/armoury_1)
"ct" = (/turf/unsimulated/wall{tag = "icon-rock-dark"; icon_state = "rock-dark"},/area/asteroid_base/storage_medbay)
"cu" = (/turf/simulated/floor/plating,/area/asteroid_base/storage_medbay)
"cv" = (/obj/structure/sign/warning/hot_exhaust,/turf/unsimulated/wall{tag = "icon-rock-dark"; icon_state = "rock-dark"},/area/asteroid_base/storage_medbay)
"cw" = (/obj/structure/sign/warning/hot_exhaust,/turf/unsimulated/wall{tag = "icon-rock-dark"; icon_state = "rock-dark"},/area/asteroid_base/armoury_1)
"cx" = (/obj/effect/decal/cleanable/dirt,/turf/simulated/floor/plating,/area/asteroid_base/storage_medbay)
"cy" = (/obj/effect/decal/cleanable/cobweb2,/turf/simulated/floor/plating,/area/asteroid_base/storage_medbay)
"cz" = (/obj/effect/floor_decal/snow,/turf/simulated/floor/plating,/area/asteroid_base/armoury_1)
"cA" = (/obj/structure/grille,/turf/simulated/floor/plating,/area/asteroid_base/armoury_1)
"cB" = (/turf/unsimulated/floor{tag = "icon-snow"; icon_state = "snow"},/area/asteroid_base/armoury_1)
"cC" = (/turf/unsimulated/floor{tag = "icon-snow"; icon_state = "snow"},/area/asteroid_base/storage_medbay)
"cD" = (/obj/structure/grille,/obj/effect/decal/cleanable/dirt,/turf/simulated/floor/plating,/area/asteroid_base/storage_medbay)
"cE" = (/obj/effect/landmark/drop_pod_landing,/turf/unsimulated/floor{tag = "icon-snow"; icon_state = "snow"},/area/asteroid_base/armoury_1)
"cG" = (/turf/unsimulated/wall{tag = "icon-rock-dark"; icon_state = "rock-dark"},/area/asteroid_base/mac_gun)
"cH" = (/turf/unsimulated/wall{tag = "icon-rock-dark"; icon_state = "rock-dark"},/area/asteroid_base/central_hallway_1)
"cI" = (/turf/unsimulated/floor{tag = "icon-snow"; icon_state = "snow"},/area/asteroid_base/central_hallway_2)
"cJ" = (/turf/unsimulated/wall{tag = "icon-rock-dark"; icon_state = "rock-dark"},/area/asteroid_base/medbay)
"cK" = (/turf/unsimulated/wall{tag = "icon-rock-dark"; icon_state = "rock-dark"},/area/asteroid_base/vault)
"cL" = (/turf/unsimulated/wall{tag = "icon-rock-dark"; icon_state = "rock-dark"},/area/asteroid_base/main_hangar)
"cM" = (/turf/unsimulated/wall{tag = "icon-rock-dark"; icon_state = "rock-dark"},/area/asteroid_base/north_airlock_1)
"cN" = (/obj/effect/landmark/test/safe_turf,/turf/unsimulated/floor{tag = "icon-snow"; icon_state = "snow"},/area/asteroid_base/armoury_1)
"cO" = (/turf/unsimulated/wall{tag = "icon-rock-dark"; icon_state = "rock-dark"},/area/asteroid_base/west_dorms)
"cP" = (/turf/unsimulated/wall{tag = "icon-rock-dark"; icon_state = "rock-dark"},/area/asteroid_base/east_dorms)
"cQ" = (/turf/unsimulated/wall{tag = "icon-rock-dark"; icon_state = "rock-dark"},/area/asteroid_base/mess_hall)
"cR" = (/turf/unsimulated/wall{tag = "icon-rock-dark"; icon_state = "rock-dark"},/area/asteroid_base/kitchen)
"cS" = (/obj/effect/landmark/map_data{height = 4},/turf/unsimulated/wall{tag = "icon-rock-dark"; icon_state = "rock-dark"},/area/asteroid_base/engine/generator/control)
"cU" = (/turf/unsimulated/wall{tag = "icon-rock-dark"; icon_state = "rock-dark"},/area/asteroid_base/engine/canisters)
"cV" = (/turf/unsimulated/wall{tag = "icon-rock-dark"; icon_state = "rock-dark"},/area/asteroid_base/atmos)
"lr" = (/obj/effect/overmap/sector/innie_base,/turf/unsimulated/wall{tag = "icon-rock-dark"; icon_state = "rock-dark"},/area/asteroid_base/engine/smes)
"MI" = (/obj/structure/hangar_door,/turf/simulated/open,/area/asteroid_base/storage_medbay)
"Ux" = (/obj/effect/landmark/dropship_land_point{name = "Frozen Plains"},/turf/unsimulated/floor{tag = "icon-snow"; icon_state = "snow"},/area/asteroid_base/armoury_1)

(1,1,1) = {"
aaaaaaaaaaabababababababababababababababababababacacacacacacacacacacacacacacacacacacacacacacacacacac
aaadadadaaabababababababababababababababababababacacacacacacacacacacacacacacacacacacacacacacacacacac
aaadaeadaaabababababababababababafafafafafagafafahahahacacacacacacacacacacacacacacacacacacacacacacac
aaadadadaaabababababababababababafaiajajakalakajamamahacacacacacacacacacacacacacacacacacacacacacacac
aaaaaaaaaaabababababababafafagafafajajananaoananamamahahahahahahacacacacacapapapapapacacacacacacacac
ababababababababababababafaqarasafajajanananananamamahatauavawahapapapapapapaxayazapacacacacacacacac
ababababababababababababafaqaAaqafalalaoanaBanaoaCaCahaDaEaFaFaGapayayaxaxayaHaIaJapacacacacacacacac
ababababababababababababafasaKaqafaLajanananananamaMahaNaEaEaEaOapaxapapapapayayaxapacacacacacacacac
ababababababababababababafafasafafajajanananananamamahaPaFaFaQahapaxapacacapapapapapacacacacacacacac
abababababafafaRafafafafafafaSafafafaTafaUaVaWafaXahahaYaYaZbaahahaxapacacacacacacacacacacacacacacac
abababababafbbbcbcbbbbbcbbbbbbbcbbbcbcbdbebcbfbgbhbhbhbibibibhbjbkayapacacacacacacacacapapapapapacac
abababababafbbblbmbbbcbcbbbnbcbcbcbcbmbdbobcbpbgbhbqbhbibhbhbqbhahapapacacacacacacacacapaybrazapacac
ababababbsafafaSafafafbtafafafafafafafafbubbbvafahahahahahaOahbwahacacacacacacacacacacapaxaIaxapacac
ababababbsaqasasbsababababababafbxbyafafbzbbbbafacacacacacacacacacacacacacacacacacacacapaybAaxapacac
ababababbsaqbsbsbsbsafafafafafafbBbCbDbEbbbcbFbGacacacacacacacacacacacacacacacacacacacapapaybHapacac
ababababbsaqbsbIaqaqafbJbKbLafafbMafbtafbbbcbcafacacacacacacacacacacacacacacacacacacacacacaxacacacac
ababababbsasasbNaAbOafbzbcbcbPbQbQbQbQbMbbbcbRafacacacacacacacacacacacacacacacbSaxaxayayaxaxacacacac
ababababbsbsbsaqaqasafbTbTbUafbVbQbWbQbXbcbcbbafacacacacacacacacacacacacacacacayacacacacacacacacacac
ababababababbsbsbsbsafafafafafbYbQbWbZafcabcbcafacacacacacacacacacacacacacacacaxacacacacacacacacacac
abababababbsbsbsbsbsababababafcbbWbQcccdbbbcbRafacacacacacacacacacacacacacacacaxacacacacacacacacacac
abababababceaqaqaqbsababababafcfbQbQcccgbcbcbcaRacacacacacacacacacacacacacacacayacacacacacacacacacac
ababaqasasasbNaAchbsababababafafcicjckafbzbcbcafacacacacacacacacacacacacacacacaxaxazacacacacacacacac
ababaqababbsasaqasbsabababababababababafclasaqafacacacacacacacacacacacacacacacacacayacacacacacacacac
ababaqababbsbsbsbsbsabababababababababcmcnaqascoacacacacacacacacacacacacacacacacacaxacacacacacacacac
ababasabababababababababababababababababasaqaqabacacacacacacacacacacacacacacacacacaxayaxaxaxacacacac
cpcpcqcpcpcpcpcpcpcpcpcpcpcpcpcpcpcpcpcpcrcrcrcpacacacacacacacacacacacacacacacacacacacacacayacacacac
cpcpcrcrcscpcpcpcpcpcpcpcpcpcpcpcpcpcpcpcrcqcrcpctctctctctctctctctctctctctctctctctctctctctcucvctctct
cpcpcpcpcqcpcwcpcpcpcpcpcpcpcpcpcpcpcpcpcqcqcqcpctctctctctctctctctctctctctctctctctctctctctcxcyctctct
cpcpcpcpcrcrcscpcpcpcpcpcpcpcpcpcpcpcpcpczczczcpctctctctctctctctctctctctctctctctctctctctctctcuctctct
cpcpcpcpcpcpcrcpcpcpcpcpcpcpcpcpcpcpcpcpczczczcpctctctctctctctctctctctctctctctctctctctctctctcxctctct
cpcpcpcpcpcpcAcpcpcpcpcpcpcpcpcpcpcBcBcBcBcBcBcpcCctcCcCctctctctctctctctctctctctctctctctctctcxctctct
cpcpcpcpcpcpcBcBcBcpcpcpcpcpcpcBcBcBcBcBcBcBcBcBcCcCcCcCcCctctctctctctctctcCcCctctctctctctctcDctctct
cpcpcpcBcBcBcBcBcBcBcBcBcBcBcBcBcBcBcBcBcBcBcBcBcCcCcCcCcCcCctctctctctctcCcCcCcCctctctctcCcCcCcCctct
cpcpcBcBcBcBcBcBcBcBcBcBcBcBcBcBcBcBcBcBcBcBcBcBcCcCcCcCcCcCcCcCcCcCcCcCcCcCcCcCcCcCcCcCcCcCcCcCcCct
cpcBcBcBcBcBcBcBcBcBcBcBcBcBcBcBcBcBcBcBcBcBcBcBcCcCcCcCcCcCcCcCcCcCcCcCcCcCcCcCcCcCcCcCcCcCcCcCcCct
cpcpcBcBcBcBcBcBcBcBcBcBcBcBcBcBcBcBcBcBcBcBcBcBcCcCcCcCcCcCcCcCcCcCcCcCcCcCcCcCcCcCcCcCcCcCcCcCcCct
cpcpcBcBcBcBcBcBcBcBcBcBcBcBcEcBcBcBcBcBcBcBcBcBcCcCcCcCcCcCcCcCcCcCcCcCcCcCcCcCcCcCcCcCcCcCcCcCcCct
cpcBcBcBcBcEcBcBcBcBcBcBcBcBcBcBcBcBcBcBcEcBcBcBcCcCMIMIMIMIMIMIMIcCcCcCcCcCMIMIMIMIMIMIMIcCcCcCctct
cpcBcBcBcBcBcBcBcBcBcBcBcBcBcBcBcBcBcBcBcBcBcBcBcCcCMIMIMIMIMIMIMIcCcCcCcCcCMIMIMIMIMIMIMIcCcCcCctct
cpcBcBcBcBcBcBcBcBcBcBcBcBcBcBcBcBcBcBcBcBcBcBcBcCcCMIMIMIMIMIMIMIcCcCcCcCcCMIMIMIMIMIMIMIcCcCcCctct
cpcpcpcBcBcBcBcBcBUxcBcBcBcBcBcBcBcBcBcBcBcBcBcBcCcCMIMIMIMIMIMIMIcCcCcCcCcCMIMIMIMIMIMIMIcCcCcCcCct
cpcBcBcBcBcBcBcBcBcBcBcBcBcBcBcBcBcBcBcBcBcBcBcBcCcCMIMIMIMIMIMIMIcCcCcCcCcCMIMIMIMIMIMIMIcCcCcCcCct
cpcBcBcBcBcBcBcBcBcBcBcBcBcBcBcBcBcBcBcBcBcBcBcBcCcCMIMIMIMIMIMIMIcCcCcCcCcCMIMIMIMIMIMIMIcCcCcCcCct
cpcBcBcBcBcBcBcBcBcBcBcBcBcBcEcBcBcBcBcBcEcBcBcBcCcCMIMIMIMIMIMIMIcCcCcCcCcCMIMIMIMIMIMIMIcCcCcCcCct
cpcpcBcBcBcEcBcBcBcBcBcBcBcBcBcBcBcBcBcBcBcBcBcBcCcCcCcCcCcCcCcCcCcCcCcCcCcCcCcCcCcCcCcCcCcCcCcCctct
cpcpcBcBcBcBcBcBcBcBcBcBcBcBcBcBcBcBcBcBcBcBcBcBcCcCcCcCcCcCcCcCcCcCcCcCcCcCcCcCcCcCcCcCcCcCcCcCctct
cGcHcIcBcBcBcBcBcBcBcBcBcBcBcBcBcBcBcBcBcBcBcBcBcCcCcCcCcCcCcCcCcCcCcCcCcCcCcCcCcCcCcCcCcCcCcCctctct
cJcKcLcMcNcBcBcBcBcBcBcBcBcBcBcBcBcBcBcBcBcBcBcpcCcCcCcCcCcCcCcCcCcCcCctcCcCcCcCcCcCcCcCcCcCctctctct
cOcPcQcRcpcBcBcBcBcBcBcpcpcBcEcBcBcpcBcBcBcBcBcpctctcCcCcCcCcCcCcCcCctctctctcCcCcCcCcCctctctctctctct
cSlrcUcVcpcpcpcpcpcpcpcpcpcpcpcpcpcpcpcpcpcpcpcpctctctctctctctctctctctctctctctctctctctctctctctctctct
"}

