//MAP CONVERTED BY dmm2tgm.py THIS HEADER COMMENT PREVENTS RECONVERSION, DO NOT REMOVE
"a" = (
/turf/space,
/area/space)
"b" = (
/obj/effect/landmark/map_data{
	height = 2
	},
/turf/space,
/area/space)
"c" = (
/turf/simulated/wall,
/area/maintenance/fsmaint2)
"d" = (
/obj/effect/floor_decal/corner/blue/diagonal,
/turf/simulated/floor/tiled,
/area/maintenance/fsmaint2)
"e" = (
/obj/machinery/light{
	dir = 1
	},
/obj/effect/floor_decal/corner/blue/diagonal,
/turf/simulated/floor/tiled,
/area/maintenance/fsmaint2)
"f" = (
/obj/structure/lattice,
/turf/simulated/open,
/area/maintenance/fsmaint2)
"g" = (
/turf/simulated/open,
/area/maintenance/fsmaint2)
"h" = (
/obj/machinery/light_switch{
	pixel_x = 25
	},
/obj/effect/floor_decal/corner/blue/diagonal,
/turf/simulated/floor/tiled,
/area/maintenance/fsmaint2)
"i" = (
/obj/effect/shuttle_landmark/upper_level,
/turf/space,
/area/space)
"j" = (
/obj/machinery/light{
	dir = 8;
	icon_state = "tube1"
	},
/obj/effect/floor_decal/corner/blue/diagonal,
/turf/simulated/floor/tiled,
/area/maintenance/fsmaint2)
"k" = (
/obj/effect/floor_decal/corner/blue/diagonal,
/obj/structure/ladder,
/turf/simulated/floor/tiled,
/area/maintenance/fsmaint2)
"l" = (
/turf/simulated/floor,
/area/maintenance/fsmaint2)
"m" = (
/obj/machinery/embedded_controller/radio/simple_docking_controller{
	id_tag = "upper_level_dock";
	pixel_x = 8;
	pixel_y = -25
	},
/turf/simulated/floor,
/area/maintenance/fsmaint2)
"n" = (
/obj/machinery/door/airlock/external/bolted{
	frequency = 1379
	},
/turf/simulated/floor,
/area/maintenance/fsmaint2)
"o" = (
/obj/machinery/atmospherics/unary/vent_pump/on,
/obj/effect/floor_decal/corner/blue/diagonal,
/turf/simulated/floor/tiled,
/area/maintenance/fsmaint2)
"p" = (
/obj/effect/floor_decal/corner/blue/diagonal,
/obj/machinery/light{
	dir = 4;
	icon_state = "tube1"
	},
/turf/simulated/floor/tiled,
/area/maintenance/fsmaint2)
"q" = (
/obj/machinery/atmospherics/pipe/simple/visible{
	dir = 5
	},
/obj/effect/floor_decal/corner/blue/diagonal,
/turf/simulated/floor/tiled,
/area/maintenance/fsmaint2)
"r" = (
/obj/machinery/atmospherics/pipe/simple/visible{
	dir = 4
	},
/obj/effect/floor_decal/corner/blue/diagonal,
/turf/simulated/floor/tiled,
/area/maintenance/fsmaint2)
"s" = (
/obj/machinery/atmospherics/portables_connector{
	dir = 8
	},
/obj/machinery/portable_atmospherics/canister/air,
/obj/effect/floor_decal/corner/blue/diagonal,
/turf/simulated/floor/tiled,
/area/maintenance/fsmaint2)
"t" = (
/obj/machinery/atmospherics/pipe/simple/visible{
	dir = 6
	},
/obj/effect/floor_decal/corner/blue/diagonal,
/turf/simulated/floor/tiled,
/area/maintenance/fsmaint2)
"u" = (
/obj/machinery/atmospherics/portables_connector{
	dir = 8
	},
/obj/machinery/portable_atmospherics/canister/empty,
/obj/effect/floor_decal/corner/blue/diagonal,
/turf/simulated/floor/tiled,
/area/maintenance/fsmaint2)
"v" = (
/obj/machinery/light_switch{
	pixel_x = -25
	},
/obj/effect/floor_decal/corner/blue/diagonal,
/turf/simulated/floor/tiled,
/area/maintenance/fsmaint2)
"w" = (
/obj/machinery/atmospherics/unary/vent_scrubber/on{
	dir = 1
	},
/obj/effect/floor_decal/corner/blue/diagonal,
/turf/simulated/floor/tiled,
/area/maintenance/fsmaint2)
"x" = (
/obj/machinery/light{
	dir = 4;
	icon_state = "tube1"
	},
/obj/effect/floor_decal/corner/blue/diagonal,
/turf/simulated/floor/tiled,
/area/maintenance/fsmaint2)
"y" = (
/obj/structure/cable{
	d2 = 2;
	icon_state = "0-2"
	},
/obj/machinery/power/apc{
	dir = 8;
	name = "west bump";
	pixel_x = -24
	},
/obj/effect/floor_decal/corner/blue/diagonal,
/turf/simulated/floor/tiled,
/area/maintenance/fsmaint2)
"z" = (
/obj/structure/cable{
	d1 = 1;
	d2 = 2;
	icon_state = "1-2"
	},
/obj/effect/floor_decal/corner/blue/diagonal,
/turf/simulated/floor/tiled,
/area/maintenance/fsmaint2)
"A" = (
/obj/structure/cable,
/obj/machinery/power/debug_items/infinite_generator,
/obj/effect/floor_decal/corner/blue/diagonal,
/turf/simulated/floor/tiled,
/area/maintenance/fsmaint2)
"B" = (
/obj/machinery/light,
/obj/effect/floor_decal/corner/blue/diagonal,
/turf/simulated/floor/tiled,
/area/maintenance/fsmaint2)

(1,1,1) = {"
a
a
a
a
a
a
a
a
a
a
a
a
a
a
a
a
a
a
a
a
a
a
a
a
a
a
a
a
a
a
a
a
"}
(2,1,1) = {"
a
a
a
a
a
a
a
a
a
a
a
a
a
a
a
a
a
a
a
a
a
a
a
a
a
a
a
a
a
a
a
a
"}
(3,1,1) = {"
a
a
a
a
a
a
a
a
a
a
a
a
a
a
a
a
a
a
a
a
a
a
a
a
a
a
a
a
a
a
a
a
"}
(4,1,1) = {"
a
a
a
a
a
a
a
a
a
a
a
a
a
a
a
a
a
a
a
a
a
a
a
a
a
a
a
a
a
a
a
a
"}
(5,1,1) = {"
a
a
a
a
a
a
a
a
a
a
a
a
a
a
a
a
a
a
a
a
a
a
a
a
a
a
a
a
a
a
a
a
"}
(6,1,1) = {"
a
a
a
a
a
a
a
a
a
a
a
a
a
a
a
a
a
a
a
a
a
a
a
a
a
a
a
a
a
a
a
a
"}
(7,1,1) = {"
a
a
a
a
a
a
a
a
a
a
a
a
a
a
a
a
a
a
a
a
a
a
a
a
a
a
a
a
a
a
a
a
"}
(8,1,1) = {"
a
a
a
a
a
a
a
a
a
a
a
a
a
a
a
a
a
a
a
a
a
a
a
a
a
a
a
a
a
a
a
a
"}
(9,1,1) = {"
a
a
a
a
a
a
a
a
a
a
a
a
a
a
a
a
a
a
a
a
a
a
a
a
a
a
a
a
a
a
a
a
"}
(10,1,1) = {"
a
a
a
a
a
a
a
a
a
a
a
a
a
a
a
a
a
a
a
a
a
a
a
a
a
a
a
a
a
a
a
a
"}
(11,1,1) = {"
a
a
a
a
a
a
a
a
a
a
a
a
a
a
a
a
a
a
a
a
a
a
a
a
a
a
a
a
a
a
a
a
"}
(12,1,1) = {"
a
a
a
a
a
a
a
a
a
a
a
a
a
a
a
a
a
a
a
a
a
a
a
a
a
a
a
a
a
a
a
a
"}
(13,1,1) = {"
a
a
a
a
a
a
a
a
a
a
a
a
a
a
a
a
a
a
a
a
a
a
a
a
a
a
a
a
a
a
a
a
"}
(14,1,1) = {"
a
a
a
a
a
a
a
a
a
b
a
a
a
a
a
a
a
a
a
a
a
a
a
a
a
a
a
a
a
a
a
a
"}
(15,1,1) = {"
a
a
a
a
a
a
a
a
a
a
a
a
a
a
a
a
a
a
a
a
a
a
a
a
a
a
a
a
a
a
a
a
"}
(16,1,1) = {"
a
a
a
a
a
a
a
a
a
a
a
a
a
a
a
a
a
a
a
a
a
a
a
a
a
a
a
a
a
a
a
a
"}
(17,1,1) = {"
a
a
a
a
a
a
a
a
a
a
a
a
a
a
a
a
a
a
a
a
a
a
a
a
a
a
a
a
a
a
a
a
"}
(18,1,1) = {"
a
a
a
a
a
a
a
a
a
c
c
c
c
c
c
c
c
c
c
c
c
c
c
c
a
a
a
a
a
a
a
a
"}
(19,1,1) = {"
a
a
a
a
a
a
a
a
a
c
d
d
d
j
d
d
d
d
v
j
y
z
A
c
a
a
a
a
a
a
a
a
"}
(20,1,1) = {"
a
a
a
a
a
a
a
a
a
c
d
d
d
d
d
d
d
d
d
d
d
d
d
c
a
a
a
a
a
a
a
a
"}
(21,1,1) = {"
a
a
a
a
a
a
a
a
a
c
d
d
d
d
d
d
d
d
d
d
d
d
d
c
a
a
a
a
a
a
a
a
"}
(22,1,1) = {"
a
a
a
a
a
a
a
a
a
c
e
d
d
d
d
d
d
d
d
d
d
d
B
c
a
a
a
a
a
a
a
a
"}
(23,1,1) = {"
a
a
a
a
a
a
a
a
a
c
d
d
d
k
d
d
d
d
d
d
d
d
d
c
a
a
a
a
a
a
a
a
"}
(24,1,1) = {"
a
a
a
a
a
a
a
a
a
c
d
f
g
g
d
d
d
d
d
d
d
d
d
c
a
a
a
a
a
a
a
a
"}
(25,1,1) = {"
a
a
a
a
a
a
a
a
a
c
f
f
g
g
d
d
d
d
d
d
d
d
d
c
a
a
a
a
a
a
a
a
"}
(26,1,1) = {"
a
a
a
a
a
a
a
a
a
c
d
f
g
g
d
d
d
d
d
d
d
d
d
c
a
a
a
a
a
a
a
a
"}
(27,1,1) = {"
a
a
a
a
a
a
a
a
a
c
d
d
d
d
d
d
d
d
d
d
d
d
d
c
a
a
a
a
a
a
a
a
"}
(28,1,1) = {"
a
a
a
a
a
a
a
a
a
c
e
d
d
d
d
d
d
d
d
d
d
d
B
c
a
a
a
a
a
a
a
a
"}
(29,1,1) = {"
a
a
a
a
a
a
a
a
a
c
d
d
d
d
o
q
d
t
w
d
d
d
d
c
a
a
a
a
a
a
a
a
"}
(30,1,1) = {"
a
a
a
a
a
a
a
a
a
c
d
d
d
d
d
r
d
r
d
d
d
d
d
c
a
a
a
a
a
a
a
a
"}
(31,1,1) = {"
a
a
a
a
a
a
a
a
a
c
d
d
h
d
p
s
d
u
d
x
d
d
d
c
a
a
a
a
a
a
a
a
"}
(32,1,1) = {"
a
a
a
a
a
a
a
a
a
c
c
c
c
l
c
c
c
c
c
c
c
c
c
c
a
a
a
a
a
a
a
a
"}
(33,1,1) = {"
a
a
a
a
a
a
a
a
a
a
a
a
c
l
c
a
a
a
a
a
a
a
a
a
a
a
a
a
a
a
a
a
"}
(34,1,1) = {"
a
a
a
a
a
a
a
a
a
a
a
a
c
m
c
a
a
a
a
a
a
a
a
a
a
a
a
a
a
a
a
a
"}
(35,1,1) = {"
a
a
a
a
a
a
a
a
a
a
a
a
c
n
c
a
a
a
a
a
a
a
a
a
a
a
a
a
a
a
a
a
"}
(36,1,1) = {"
a
a
a
a
a
a
a
a
a
a
a
a
a
a
a
a
a
a
a
a
a
a
a
a
a
a
a
a
a
a
a
a
"}
(37,1,1) = {"
a
a
a
a
a
a
a
a
a
a
a
a
i
a
a
a
a
a
a
a
a
a
a
a
a
a
a
a
a
a
a
a
"}
(38,1,1) = {"
a
a
a
a
a
a
a
a
a
a
a
a
a
a
a
a
a
a
a
a
a
a
a
a
a
a
a
a
a
a
a
a
"}
(39,1,1) = {"
a
a
a
a
a
a
a
a
a
a
a
a
a
a
a
a
a
a
a
a
a
a
a
a
a
a
a
a
a
a
a
a
"}
(40,1,1) = {"
a
a
a
a
a
a
a
a
a
a
a
a
a
a
a
a
a
a
a
a
a
a
a
a
a
a
a
a
a
a
a
a
"}
(41,1,1) = {"
a
a
a
a
a
a
a
a
a
a
a
a
a
a
a
a
a
a
a
a
a
a
a
a
a
a
a
a
a
a
a
a
"}
(42,1,1) = {"
a
a
a
a
a
a
a
a
a
a
a
a
a
a
a
a
a
a
a
a
a
a
a
a
a
a
a
a
a
a
a
a
"}
(43,1,1) = {"
a
a
a
a
a
a
a
a
a
a
a
a
a
a
a
a
a
a
a
a
a
a
a
a
a
a
a
a
a
a
a
a
"}
(44,1,1) = {"
a
a
a
a
a
a
a
a
a
a
a
a
a
a
a
a
a
a
a
a
a
a
a
a
a
a
a
a
a
a
a
a
"}
(45,1,1) = {"
a
a
a
a
a
a
a
a
a
a
a
a
a
a
a
a
a
a
a
a
a
a
a
a
a
a
a
a
a
a
a
a
"}
(46,1,1) = {"
a
a
a
a
a
a
a
a
a
a
a
a
a
a
a
a
a
a
a
a
a
a
a
a
a
a
a
a
a
a
a
a
"}
(47,1,1) = {"
a
a
a
a
a
a
a
a
a
a
a
a
a
a
a
a
a
a
a
a
a
a
a
a
a
a
a
a
a
a
a
a
"}
(48,1,1) = {"
a
a
a
a
a
a
a
a
a
a
a
a
a
a
a
a
a
a
a
a
a
a
a
a
a
a
a
a
a
a
a
a
"}
