"a" = (/turf/space,/area/space)
"b" = (/obj/effect/landmark/map_data{height = 2},/turf/space,/area/space)
"c" = (/turf/simulated/wall,/area/medical/surgery)
"d" = (/obj/effect/floor_decal/corner/blue/diagonal,/obj/machinery/iv_drip,/obj/item/weapon/reagent_containers/blood/OMinus,/obj/item/weapon/reagent_containers/blood/OMinus,/obj/item/weapon/reagent_containers/blood/OMinus,/turf/simulated/floor/tiled/white,/area/medical/surgery)
"e" = (/obj/effect/floor_decal/corner/blue/diagonal,/obj/machinery/optable,/obj/machinery/oxygen_pump/anesthetic{pixel_y = 32},/turf/simulated/floor/tiled/white,/area/medical/surgery)
"f" = (/obj/effect/floor_decal/corner/blue/diagonal,/obj/machinery/computer/operating,/turf/simulated/floor/tiled/white,/area/medical/surgery)
"g" = (/obj/machinery/light{dir = 1},/obj/effect/floor_decal/corner/blue/diagonal,/obj/structure/table/glass,/obj/item/weapon/storage/box/syringes,/obj/item/weapon/storage/box/freezer,/turf/simulated/floor/tiled/white,/area/medical/surgery)
"h" = (/obj/effect/floor_decal/corner/blue/diagonal,/obj/structure/table/glass,/obj/item/weapon/storage/box/gloves,/obj/item/weapon/storage/box/masks,/turf/simulated/floor/tiled/white,/area/medical/surgery)
"i" = (/obj/effect/floor_decal/corner/blue/diagonal,/turf/simulated/floor/tiled/white,/area/medical/surgery)
"j" = (/obj/structure/lattice,/turf/simulated/open,/area/medical/surgery)
"k" = (/obj/machinery/light{dir = 1},/obj/effect/floor_decal/corner/blue/diagonal,/turf/simulated/floor/tiled/white,/area/medical/surgery)
"l" = (/obj/effect/floor_decal/corner/blue/diagonal,/obj/structure/table/glass,/obj/item/weapon/storage/firstaid/surgery,/turf/simulated/floor/tiled/white,/area/medical/surgery)
"m" = (/obj/effect/floor_decal/corner/blue/diagonal,/obj/structure/sink{tag = "icon-sink (EAST)"; icon_state = "sink"; dir = 4},/turf/simulated/floor/tiled/white,/area/medical/surgery)
"n" = (/turf/simulated/open,/area/medical/surgery)
"o" = (/obj/effect/floor_decal/corner/blue/diagonal,/obj/structure/table/glass,/obj/item/weapon/reagent_containers/dropper,/obj/item/weapon/reagent_containers/chem_disp_cartridge/peridaxon,/obj/item/stack/nanopaste,/obj/machinery/light{icon_state = "tube1"; dir = 8},/turf/simulated/floor/tiled/white,/area/medical/surgery)
"p" = (/obj/effect/floor_decal/corner/blue/diagonal,/obj/machinery/body_scanconsole{tag = "icon-body_scannerconsole (EAST)"; icon_state = "body_scannerconsole"; dir = 4},/turf/simulated/floor/tiled/white,/area/medical/surgery)
"q" = (/obj/effect/floor_decal/corner/blue/diagonal,/obj/machinery/bodyscanner{tag = "icon-body_scanner_0 (EAST)"; icon_state = "body_scanner_0"; dir = 4},/turf/simulated/floor/tiled/white,/area/medical/surgery)
"r" = (/obj/effect/floor_decal/corner/blue/diagonal,/obj/machinery/sleeper{tag = "icon-sleeper_0 (WEST)"; icon_state = "sleeper_0"; dir = 8},/turf/simulated/floor/tiled/white,/area/medical/surgery)
"s" = (/obj/machinery/light_switch{pixel_x = 25},/obj/effect/floor_decal/corner/blue/diagonal,/turf/simulated/floor/tiled/white,/area/medical/surgery)
"t" = (/obj/effect/floor_decal/corner/blue/diagonal,/obj/structure/table/glass,/obj/item/weapon/scalpel/laser1,/obj/item/weapon/scalpel/laser2,/obj/item/weapon/scalpel/laser3,/obj/item/device/robotanalyzer,/obj/item/device/healthanalyzer,/obj/item/weapon/storage/firstaid/adv,/turf/simulated/floor/tiled/white,/area/medical/surgery)
"u" = (/obj/effect/floor_decal/corner/blue/diagonal,/obj/structure/ladder/updown,/turf/simulated/floor/tiled/white,/area/medical/surgery)
"v" = (/obj/effect/floor_decal/corner/blue/diagonal,/obj/machinery/atmospherics/unary/freezer,/turf/simulated/floor/tiled/white,/area/medical/surgery)
"w" = (/obj/effect/floor_decal/corner/blue/diagonal,/obj/machinery/atmospherics/unary/cryo_cell,/turf/simulated/floor/tiled/white,/area/medical/surgery)
"x" = (/obj/effect/floor_decal/corner/blue/diagonal,/obj/machinery/portable_atmospherics/canister/oxygen/prechilled,/obj/machinery/atmospherics/portables_connector,/turf/simulated/floor/tiled/white,/area/medical/surgery)
"y" = (/obj/effect/floor_decal/corner/blue/diagonal,/obj/machinery/light{icon_state = "tube1"; dir = 4},/turf/simulated/floor/tiled/white,/area/medical/surgery)
"z" = (/obj/effect/floor_decal/corner/blue/diagonal,/obj/structure/closet/secure_closet/freezer/meat,/turf/simulated/floor/tiled/white,/area/medical/surgery)
"A" = (/obj/effect/floor_decal/corner/blue/diagonal,/obj/machinery/mecha_part_fabricator,/turf/simulated/floor/tiled/white,/area/medical/surgery)
"B" = (/obj/effect/floor_decal/corner/blue/diagonal,/obj/machinery/atmospherics/pipe/simple/visible/blue{tag = "icon-intact (NORTHEAST)"; icon_state = "intact"; dir = 5},/turf/simulated/floor/tiled/white,/area/medical/surgery)
"C" = (/obj/effect/floor_decal/corner/blue/diagonal,/obj/machinery/atmospherics/pipe/manifold/visible/blue,/obj/item/weapon/reagent_containers/glass/beaker/cryoxadone,/turf/simulated/floor/tiled/white,/area/medical/surgery)
"D" = (/obj/effect/floor_decal/corner/blue/diagonal,/obj/machinery/atmospherics/pipe/simple/visible/blue{tag = "icon-intact (NORTHWEST)"; icon_state = "intact"; dir = 9},/turf/simulated/floor/tiled/white,/area/medical/surgery)
"E" = (/obj/machinery/atmospherics/unary/vent_pump/on,/obj/effect/floor_decal/corner/blue/diagonal,/turf/simulated/floor/tiled/white,/area/medical/surgery)
"F" = (/obj/effect/floor_decal/corner/blue/diagonal,/obj/machinery/organ_printer/flesh/mapped,/turf/simulated/floor/tiled/white,/area/medical/surgery)
"G" = (/obj/machinery/atmospherics/pipe/simple/visible{tag = "icon-intact (NORTHEAST)"; icon_state = "intact"; dir = 5},/obj/effect/floor_decal/corner/blue/diagonal,/turf/simulated/floor/tiled/white,/area/medical/surgery)
"H" = (/obj/machinery/atmospherics/pipe/simple/visible{tag = "icon-intact (EAST)"; icon_state = "intact"; dir = 4},/obj/effect/floor_decal/corner/blue/diagonal,/turf/simulated/floor/tiled/white,/area/medical/surgery)
"I" = (/obj/machinery/atmospherics/portables_connector{tag = "icon-map_connector (WEST)"; icon_state = "map_connector"; dir = 8},/obj/machinery/portable_atmospherics/canister/air,/obj/effect/floor_decal/corner/blue/diagonal,/turf/simulated/floor/tiled/white,/area/medical/surgery)
"J" = (/obj/effect/floor_decal/corner/blue/diagonal,/obj/machinery/organ_printer/robot/mapped,/turf/simulated/floor/tiled/white,/area/medical/surgery)
"K" = (/obj/effect/floor_decal/corner/blue/diagonal,/obj/structure/table/rack,/obj/item/stack/material/plasteel/fifty,/obj/item/stack/material/steel/fifty,/obj/item/stack/material/glass/fifty,/obj/item/stack/material/gold/ten,/obj/item/stack/material/mhydrogen/ten,/obj/item/stack/material/silver/ten,/obj/item/stack/material/uranium/ten,/obj/item/stack/material/diamond/ten,/obj/item/stack/material/phoron/fifty,/obj/item/weapon/storage/belt/utility/full,/obj/item/stack/material/steel/fifty,/turf/simulated/floor/tiled/white,/area/medical/surgery)
"L" = (/obj/machinery/atmospherics/pipe/simple/visible{tag = "icon-intact (SOUTHEAST)"; icon_state = "intact"; dir = 6},/obj/effect/floor_decal/corner/blue/diagonal,/turf/simulated/floor/tiled/white,/area/medical/surgery)
"M" = (/obj/machinery/atmospherics/portables_connector{tag = "icon-map_connector (WEST)"; icon_state = "map_connector"; dir = 8},/obj/machinery/portable_atmospherics/canister/empty,/obj/effect/floor_decal/corner/blue/diagonal,/turf/simulated/floor/tiled/white,/area/medical/surgery)
"N" = (/obj/machinery/light_switch{pixel_x = -25},/obj/effect/floor_decal/corner/blue/diagonal,/turf/simulated/floor/tiled/white,/area/medical/surgery)
"O" = (/obj/machinery/atmospherics/unary/vent_scrubber/on{tag = "icon-map_scrubber_on (NORTH)"; icon_state = "map_scrubber_on"; dir = 1},/obj/effect/floor_decal/corner/blue/diagonal,/turf/simulated/floor/tiled/white,/area/medical/surgery)
"P" = (/obj/machinery/light{icon_state = "tube1"; dir = 8},/obj/effect/floor_decal/corner/blue/diagonal,/turf/simulated/floor/tiled/white,/area/medical/surgery)
"Q" = (/obj/machinery/light{icon_state = "tube1"; dir = 4},/obj/effect/floor_decal/corner/blue/diagonal,/turf/simulated/floor/tiled/white,/area/medical/surgery)
"R" = (/obj/structure/cable{d2 = 2; icon_state = "0-2"; pixel_y = 0},/obj/machinery/power/apc{dir = 8; name = "west bump"; pixel_x = -24},/obj/effect/floor_decal/corner/blue/diagonal,/turf/simulated/floor/tiled/white,/area/medical/surgery)
"S" = (/obj/structure/cable{d1 = 1; d2 = 2; icon_state = "1-2"; pixel_y = 0},/obj/effect/floor_decal/corner/blue/diagonal,/turf/simulated/floor/tiled/white,/area/medical/surgery)
"T" = (/obj/structure/cable,/obj/machinery/power/debug_items/infinite_generator,/obj/effect/floor_decal/corner/blue/diagonal,/turf/simulated/floor/tiled/white,/area/medical/surgery)
"U" = (/obj/machinery/light,/obj/effect/floor_decal/corner/blue/diagonal,/turf/simulated/floor/tiled/white,/area/medical/surgery)

(1,1,1) = {"
aaaaaaaaaaaaaaaaaaaaaaaaaaaaaaaaaaaaaaaaaaaaaaaa
aaaaaaaaaaaaaaaaaaaaaaaaaaaaaaaaaaaaaaaaaaaaaaaa
aaaaaaaaaaaaaaaaaaaaaaaaaaaaaaaaaaaaaaaaaaaaaaaa
aaaaaaaaaaaaaaaaaaaaaaaaaaaaaaaaaaaaaaaaaaaaaaaa
aaaaaaaaaaaaaaaaaaaaaaaaaaaaaaaaaaaaaaaaaaaaaaaa
aaaaaaaaaaaaaaaaaaaaaaaaaaaaaaaaaaaaaaaaaaaaaaaa
aaaaaaaaaaaaaaaaaaaaaaaaaaaaaaaaaaaaaaaaaaaaaaaa
aaaaaaaaaaaaaaaaaaaaaaaaaaaaaaaaaaaaaaaaaaaaaaaa
aaaaaaaaaaaaaaaaaaaaaaaaaaaaaaaaaaaaaaaaaaaaaaaa
aaaaaaaaaaaaabaaacccccccccccccccaaaaaaaaaaaaaaaa
aaaaaaaaaaaaaaaaacdefghijiikiiicaaaaaaaaaaaaaaaa
aaaaaaaaaaaaaaaaacliiimjjniiiiicaaaaaaaaaaaaaaaa
aaaaaaaaaaaaaaaaacopqirnnniiiiscaaaaaaaaaaaaaaaa
aaaaaaaaaaaaaaaaactiiiuvwxiiiiycaaaaaaaaaaaaaaaa
aaaaaaaaaaaaaaaaacziAiiBCDiiEiicaaaaaaaaaaaaaaaa
aaaaaaaaaaaaaaaaacFiiiiiiiiiGHIcaaaaaaaaaaaaaaaa
aaaaaaaaaaaaaaaaacJiKiiiiiiiiiicaaaaaaaaaaaaaaaa
aaaaaaaaaaaaaaaaaciiiiiiiiiiLHMcaaaaaaaaaaaaaaaa
aaaaaaaaaaaaaaaaacNiiiiiiiiiOiicaaaaaaaaaaaaaaaa
aaaaaaaaaaaaaaaaacPiiiiiiiiiiiQcaaaaaaaaaaaaaaaa
aaaaaaaaaaaaaaaaacRiiiiiiiiiiiicaaaaaaaaaaaaaaaa
aaaaaaaaaaaaaaaaacSiiiiiiiiiiiicaaaaaaaaaaaaaaaa
aaaaaaaaaaaaaaaaacTiiUiiiiiUiiicaaaaaaaaaaaaaaaa
aaaaaaaaaaaaaaaaacccccccccccccccaaaaaaaaaaaaaaaa
aaaaaaaaaaaaaaaaaaaaaaaaaaaaaaaaaaaaaaaaaaaaaaaa
aaaaaaaaaaaaaaaaaaaaaaaaaaaaaaaaaaaaaaaaaaaaaaaa
aaaaaaaaaaaaaaaaaaaaaaaaaaaaaaaaaaaaaaaaaaaaaaaa
aaaaaaaaaaaaaaaaaaaaaaaaaaaaaaaaaaaaaaaaaaaaaaaa
aaaaaaaaaaaaaaaaaaaaaaaaaaaaaaaaaaaaaaaaaaaaaaaa
aaaaaaaaaaaaaaaaaaaaaaaaaaaaaaaaaaaaaaaaaaaaaaaa
aaaaaaaaaaaaaaaaaaaaaaaaaaaaaaaaaaaaaaaaaaaaaaaa
aaaaaaaaaaaaaaaaaaaaaaaaaaaaaaaaaaaaaaaaaaaaaaaa
"}
