//MAP CONVERTED BY dmm2tgm.py THIS HEADER COMMENT PREVENTS RECONVERSION, DO NOT REMOVE
"a" = (
/turf/simulated/shuttle/wall/corner/dark{
	dir = 9
	},
/area/map_template/crashed_pod)
"b" = (
/obj/structure/shuttle/engine/propulsion{
	dir = 1
	},
/turf/simulated/floor/plating,
/area/map_template/crashed_pod)
"c" = (
/turf/simulated/shuttle/wall{
	icon_state = "wall3"
	},
/area/map_template/crashed_pod)
"d" = (
/obj/effect/wallframe_spawn/reinforced/hull,
/turf/simulated/floor/plating,
/area/map_template/crashed_pod)
"e" = (
/obj/machinery/door/firedoor/border_only,
/obj/effect/wallframe_spawn/reinforced/hull,
/turf/simulated/floor/plating,
/area/map_template/crashed_pod)
"f" = (
/turf/simulated/shuttle/wall/corner/dark{
	dir = 5
	},
/area/map_template/crashed_pod)
"g" = (
/obj/structure/shuttle/engine/heater{
	icon_state = "heater";
	dir = 1
	},
/obj/effect/wallframe_spawn/reinforced/hull,
/obj/effect/submap_landmark/joinable_submap/crashed_pod,
/turf/simulated/floor/plating,
/area/map_template/crashed_pod)
"h" = (
/obj/effect/floor_decal/industrial/outline/yellow,
/obj/machinery/portable_atmospherics/canister/air/airlock,
/obj/machinery/atmospherics/portables_connector{
	dir = 4
	},
/obj/structure/window/reinforced{
	dir = 8
	},
/turf/simulated/floor/plating,
/area/map_template/crashed_pod)
"i" = (
/obj/machinery/atmospherics/pipe/simple/hidden/supply{
	dir = 10
	},
/turf/simulated/floor/tiled/monotile,
/area/map_template/crashed_pod)
"j" = (
/obj/machinery/atmospherics/pipe/simple/hidden/scrubbers{
	dir = 6
	},
/turf/simulated/floor/tiled/monotile,
/area/map_template/crashed_pod)
"k" = (
/obj/effect/floor_decal/industrial/outline/yellow,
/obj/machinery/portable_atmospherics/canister/empty,
/obj/structure/window/reinforced{
	dir = 4
	},
/obj/machinery/atmospherics/portables_connector{
	dir = 8
	},
/turf/simulated/floor/plating,
/area/map_template/crashed_pod)
"l" = (
/obj/structure/shuttle/engine/heater{
	icon_state = "heater";
	dir = 1
	},
/obj/effect/wallframe_spawn/reinforced/hull,
/turf/simulated/floor/plating,
/area/map_template/crashed_pod)
"m" = (
/obj/machinery/alarm{
	dir = 4;
	pixel_x = -25;
	pixel_y = 0
	},
/turf/simulated/floor/tiled/monotile,
/area/map_template/crashed_pod)
"n" = (
/obj/structure/bed/chair/shuttle{
	tag = "icon-shuttle_chair_preview (WEST)";
	icon_state = "shuttle_chair_preview";
	dir = 8
	},
/obj/structure/window/reinforced{
	dir = 4
	},
/obj/effect/submap_landmark/spawnpoint/crashed_pod_survivor,
/turf/simulated/floor/tiled/monotile,
/area/map_template/crashed_pod)
"o" = (
/obj/structure/bed/chair/shuttle{
	tag = "icon-shuttle_chair_preview (NORTH)";
	icon_state = "shuttle_chair_preview";
	dir = 4
	},
/obj/structure/window/reinforced{
	dir = 8
	},
/obj/effect/submap_landmark/spawnpoint/crashed_pod_survivor,
/turf/simulated/floor/tiled/monotile,
/area/map_template/crashed_pod)
"p" = (
/obj/machinery/atmospherics/pipe/simple/hidden/supply,
/turf/simulated/floor/tiled/monotile,
/area/map_template/crashed_pod)
"q" = (
/obj/machinery/atmospherics/pipe/simple/hidden/scrubbers,
/turf/simulated/floor/tiled/monotile,
/area/map_template/crashed_pod)
"r" = (
/obj/structure/closet/hydrant{
	pixel_x = 24;
	pixel_y = 0
	},
/turf/simulated/floor/tiled/monotile,
/area/map_template/crashed_pod)
"s" = (
/obj/machinery/light/small{
	dir = 8
	},
/turf/simulated/floor/tiled/monotile,
/area/map_template/crashed_pod)
"t" = (
/obj/machinery/atmospherics/unary/vent_pump/on{
	dir = 1
	},
/turf/simulated/floor/tiled/monotile,
/area/map_template/crashed_pod)
"u" = (
/obj/machinery/atmospherics/unary/vent_scrubber/on{
	dir = 1
	},
/turf/simulated/floor/tiled/monotile,
/area/map_template/crashed_pod)
"v" = (
/obj/machinery/light/small{
	dir = 4
	},
/turf/simulated/floor/tiled/monotile,
/area/map_template/crashed_pod)
"w" = (
/turf/simulated/floor/tiled/monotile,
/area/map_template/crashed_pod)
"x" = (
/obj/structure/window/reinforced{
	dir = 1
	},
/obj/structure/table/standard{
	name = "plastic table frame"
	},
/obj/item/stack/material/glass/fifty,
/obj/item/stack/material/steel/fifty,
/turf/simulated/floor/tiled/monotile,
/area/map_template/crashed_pod)
"y" = (
/obj/structure/window/reinforced{
	dir = 1
	},
/obj/structure/table/standard{
	name = "plastic table frame"
	},
/obj/item/weapon/storage/belt/utility/full,
/obj/item/weapon/storage/belt/utility/full,
/turf/simulated/floor/tiled/monotile,
/area/map_template/crashed_pod)
"z" = (
/obj/structure/window/reinforced{
	dir = 1
	},
/obj/structure/table/standard{
	name = "plastic table frame"
	},
/obj/random/tech_supply,
/obj/random/tech_supply,
/obj/random/tech_supply,
/obj/random/tech_supply,
/obj/random/tech_supply,
/obj/item/weapon/pickaxe,
/turf/simulated/floor/tiled/monotile,
/area/map_template/crashed_pod)
"A" = (
/obj/structure/window/reinforced{
	dir = 1
	},
/obj/structure/table/standard{
	name = "plastic table frame"
	},
/obj/item/device/radio,
/obj/item/device/radio,
/obj/item/device/radio,
/turf/simulated/floor/tiled/monotile,
/area/map_template/crashed_pod)
"B" = (
/obj/machinery/power/apc{
	dir = 2;
	name = "south bump";
	operating = 1;
	pixel_y = -28
	},
/obj/structure/cable/cyan{
	d2 = 4;
	icon_state = "0-4"
	},
/turf/simulated/floor/tiled/monotile,
/area/map_template/crashed_pod)
"C" = (
/obj/structure/cable/cyan{
	d1 = 2;
	d2 = 8;
	icon_state = "2-8"
	},
/turf/simulated/floor/tiled/monotile,
/area/map_template/crashed_pod)
"D" = (
/obj/machinery/door/airlock/external{
	name = "escape pod airlock"
	},
/turf/simulated/floor/plating,
/area/map_template/crashed_pod)
"E" = (
/obj/effect/floor_decal/industrial/outline/yellow,
/obj/structure/cable/cyan,
/obj/machinery/light/small{
	dir = 8
	},
/obj/effect/floor_decal/industrial/warning{
	icon_state = "warning";
	dir = 5
	},
/obj/machinery/power/smes/buildable/power_shuttle,
/turf/simulated/floor/plating,
/area/map_template/crashed_pod)
"F" = (
/obj/effect/floor_decal/industrial/warning{
	icon_state = "warning";
	dir = 9
	},
/obj/structure/window/reinforced{
	dir = 8
	},
/obj/structure/window/reinforced{
	dir = 1
	},
/obj/structure/table/standard{
	name = "plastic table frame"
	},
/obj/item/weapon/storage/firstaid/surgery,
/turf/simulated/floor/tiled/white/monotile,
/area/map_template/crashed_pod)
"G" = (
/obj/effect/floor_decal/industrial/warning{
	dir = 1
	},
/turf/simulated/floor/tiled/white/monotile,
/area/map_template/crashed_pod)
"H" = (
/obj/effect/floor_decal/industrial/warning{
	icon_state = "warning";
	dir = 5
	},
/obj/structure/window/reinforced{
	dir = 1
	},
/obj/structure/closet/crate/freezer/rations,
/obj/random/handgun,
/obj/random/handgun,
/obj/random/handgun,
/turf/simulated/floor/tiled/white/monotile,
/area/map_template/crashed_pod)
"I" = (
/obj/effect/floor_decal/industrial/warning{
	dir = 9
	},
/obj/item/weapon/tank/oxygen,
/obj/item/clothing/suit/space/emergency,
/obj/item/clothing/suit/space/emergency,
/obj/item/clothing/head/helmet/space/emergency,
/obj/item/clothing/head/helmet/space/emergency,
/obj/item/weapon/tank/oxygen,
/obj/structure/table/rack,
/turf/simulated/floor/plating,
/area/map_template/crashed_pod)
"J" = (
/obj/effect/floor_decal/industrial/warning{
	dir = 5
	},
/obj/machinery/light/small{
	dir = 4
	},
/turf/simulated/floor/plating,
/area/map_template/crashed_pod)
"K" = (
/obj/machinery/power/terminal{
	icon_state = "term";
	dir = 1
	},
/obj/structure/cable/cyan{
	d2 = 2;
	icon_state = "0-2"
	},
/obj/effect/floor_decal/industrial/warning{
	dir = 4
	},
/obj/structure/closet/crate,
/obj/item/stack/material/phoron/fifty,
/turf/simulated/floor/plating,
/area/map_template/crashed_pod)
"L" = (
/obj/effect/floor_decal/industrial/warning{
	dir = 8
	},
/obj/structure/window/reinforced{
	dir = 8
	},
/obj/machinery/optable,
/turf/simulated/floor/tiled/white/monotile,
/area/map_template/crashed_pod)
"M" = (
/turf/simulated/floor/tiled/white/monotile,
/area/map_template/crashed_pod)
"N" = (
/obj/machinery/sleeper{
	dir = 8
	},
/obj/effect/floor_decal/industrial/warning{
	dir = 4
	},
/obj/machinery/light/small{
	dir = 4
	},
/turf/simulated/floor/tiled/white/monotile,
/area/map_template/crashed_pod)
"O" = (
/obj/effect/floor_decal/industrial/warning{
	dir = 10
	},
/turf/simulated/floor/plating,
/area/map_template/crashed_pod)
"P" = (
/obj/effect/floor_decal/industrial/warning{
	dir = 6
	},
/turf/simulated/floor/plating,
/area/map_template/crashed_pod)
"Q" = (
/obj/machinery/power/port_gen/pacman,
/obj/structure/cable/cyan,
/obj/effect/floor_decal/industrial/warning{
	dir = 4
	},
/turf/simulated/floor/plating,
/area/map_template/crashed_pod)
"R" = (
/obj/effect/floor_decal/industrial/warning{
	icon_state = "warning";
	dir = 10
	},
/obj/structure/window/reinforced{
	dir = 8
	},
/obj/structure/table/standard{
	name = "plastic table frame"
	},
/obj/random/firstaid,
/obj/random/firstaid,
/obj/random/firstaid,
/turf/simulated/floor/tiled/white/monotile,
/area/map_template/crashed_pod)
"S" = (
/obj/effect/floor_decal/industrial/warning,
/turf/simulated/floor/tiled/white/monotile,
/area/map_template/crashed_pod)
"T" = (
/obj/machinery/sleeper{
	dir = 8
	},
/obj/effect/floor_decal/industrial/warning{
	icon_state = "warning";
	dir = 6
	},
/turf/simulated/floor/tiled/white/monotile,
/area/map_template/crashed_pod)
"U" = (
/turf/simulated/shuttle/wall/corner/dark{
	dir = 10
	},
/area/map_template/crashed_pod)
"V" = (
/turf/simulated/shuttle/wall/corner/dark{
	dir = 6
	},
/area/map_template/crashed_pod)

(1,1,1) = {"
a
c
c
c
e
e
c
c
c
U
"}
(2,1,1) = {"
b
g
m
s
w
w
d
I
O
c
"}
(3,1,1) = {"
c
c
n
n
x
w
D
J
P
D
"}
(4,1,1) = {"
c
h
o
o
y
B
c
c
c
c
"}
(5,1,1) = {"
d
i
p
t
w
C
E
K
Q
d
"}
(6,1,1) = {"
e
j
q
u
w
w
w
w
w
e
"}
(7,1,1) = {"
c
k
n
n
z
w
F
L
R
c
"}
(8,1,1) = {"
c
c
o
o
A
w
G
M
S
c
"}
(9,1,1) = {"
b
l
r
v
w
w
H
N
T
c
"}
(10,1,1) = {"
f
c
c
c
e
e
c
c
c
V
"}
