//MAP CONVERTED BY dmm2tgm.py THIS HEADER COMMENT PREVENTS RECONVERSION, DO NOT REMOVE
"ab" = (
/obj/structure/shuttle/engine/propulsion{
	dir = 1
	},
/turf/simulated/floor/plating,
/area/map_template/oldpod)
"ad" = (
/obj/effect/wallframe_spawn/reinforced/hull,
/turf/simulated/floor/plating,
/area/map_template/oldpod)
"ak" = (
/obj/effect/floor_decal/industrial/warning{
	dir = 6;
	icon_state = "warning"
	},
/obj/effect/decal/cleanable/dirt,
/obj/effect/decal/cleanable/dirt,
/obj/effect/decal/cleanable/dirt,
/obj/structure/bed,
/obj/structure/iv_drip,
/obj/item/bedsheet/medical,
/turf/simulated/floor/tiled/white/monotile,
/area/map_template/oldpod)
"am" = (
/obj/effect/decal/cleanable/dirt,
/obj/effect/decal/cleanable/dirt,
/obj/effect/decal/cleanable/dirt,
/turf/simulated/floor/tiled/monotile,
/area/map_template/oldpod)
"as" = (
/obj/effect/decal/cleanable/filth,
/obj/effect/decal/cleanable/dirt,
/obj/effect/decal/cleanable/dirt,
/turf/simulated/floor/tiled/monotile,
/area/map_template/oldpod)
"at" = (
/obj/effect/decal/cleanable/blood/drip,
/obj/effect/decal/cleanable/blood,
/obj/effect/decal/cleanable/dirt,
/obj/effect/decal/cleanable/dirt,
/turf/simulated/floor/tiled/monotile,
/area/map_template/oldpod)
"au" = (
/obj/machinery/atmospherics/unary/vent_pump/on{
	dir = 1
	},
/obj/effect/decal/cleanable/dirt,
/obj/effect/decal/cleanable/dirt,
/obj/effect/decal/cleanable/dirt,
/turf/simulated/floor/tiled/monotile,
/area/map_template/oldpod)
"av" = (
/obj/machinery/atmospherics/unary/vent_scrubber/on{
	dir = 1
	},
/obj/effect/decal/cleanable/dirt,
/obj/effect/decal/cleanable/dirt,
/turf/simulated/floor/tiled/monotile,
/area/map_template/oldpod)
"az" = (
/obj/effect/decal/cleanable/blood/drip,
/obj/effect/decal/cleanable/dirt,
/obj/effect/decal/cleanable/dirt,
/obj/effect/decal/cleanable/dirt,
/turf/simulated/floor/tiled/monotile,
/area/map_template/oldpod)
"aA" = (
/obj/random/firstaid,
/obj/effect/decal/cleanable/dirt,
/obj/effect/decal/cleanable/dirt,
/obj/effect/decal/cleanable/dirt,
/obj/effect/decal/cleanable/dirt,
/turf/simulated/floor/tiled/monotile,
/area/map_template/oldpod)
"aB" = (
/obj/effect/decal/cleanable/blood/drip,
/obj/effect/decal/cleanable/filth,
/obj/effect/decal/cleanable/dirt,
/obj/effect/decal/cleanable/dirt,
/obj/effect/decal/cleanable/dirt,
/obj/effect/decal/cleanable/dirt,
/turf/simulated/floor/tiled/monotile,
/area/map_template/oldpod)
"aC" = (
/obj/item/clothing/head/helmet/space/emergency,
/obj/item/clothing/suit/space/emergency,
/obj/effect/decal/cleanable/dirt,
/obj/effect/decal/cleanable/dirt,
/turf/simulated/floor/tiled/monotile,
/area/map_template/oldpod)
"aH" = (
/obj/structure/cable/cyan{
	d2 = 4;
	icon_state = "0-4"
	},
/obj/item/frame/apc,
/obj/effect/decal/cleanable/dirt,
/obj/item/cell/crap/empty,
/obj/item/module/power_control,
/turf/simulated/floor/tiled/monotile,
/area/map_template/oldpod)
"aI" = (
/obj/structure/cable/cyan{
	d1 = 2;
	d2 = 8;
	icon_state = "2-8"
	},
/obj/effect/decal/cleanable/filth,
/obj/effect/decal/cleanable/dirt,
/obj/effect/decal/cleanable/dirt,
/turf/simulated/floor/tiled/monotile,
/area/map_template/oldpod)
"aK" = (
/obj/effect/decal/cleanable/blood/drip,
/obj/effect/decal/cleanable/dirt,
/turf/simulated/floor/tiled/monotile,
/area/map_template/oldpod)
"aL" = (
/obj/effect/decal/cleanable/blood/drip,
/obj/effect/decal/cleanable/blood/drip,
/obj/effect/decal/cleanable/dirt,
/obj/effect/decal/cleanable/dirt,
/obj/effect/decal/cleanable/dirt,
/obj/effect/decal/cleanable/dirt,
/turf/simulated/floor/tiled/monotile,
/area/map_template/oldpod)
"aM" = (
/obj/effect/landmark/corpse/scientist,
/obj/item/melee/baton/cattleprod,
/obj/item/material/shard,
/obj/effect/decal/cleanable/blood,
/obj/effect/decal/cleanable/dirt,
/turf/simulated/floor/tiled/monotile,
/area/map_template/oldpod)
"aO" = (
/obj/machinery/door/airlock/external{
	name = "escape pod airlock"
	},
/turf/simulated/floor/plating,
/area/map_template/oldpod)
"aP" = (
/obj/effect/floor_decal/industrial/outline/yellow,
/obj/structure/cable/cyan,
/obj/machinery/light/small{
	dir = 8
	},
/obj/effect/floor_decal/industrial/warning{
	dir = 5;
	icon_state = "warning"
	},
/obj/machinery/power/smes/buildable/power_shuttle,
/turf/simulated/floor/plating,
/area/map_template/oldpod)
"aQ" = (
/obj/effect/decal/cleanable/dirt,
/turf/simulated/floor/tiled/monotile,
/area/map_template/oldpod)
"aR" = (
/obj/effect/floor_decal/industrial/warning{
	dir = 9;
	icon_state = "warning"
	},
/obj/structure/window/reinforced{
	dir = 8
	},
/obj/structure/window/reinforced{
	dir = 1
	},
/obj/structure/table/standard{
	name = "plastic table frame"
	},
/obj/item/storage/firstaid/surgery,
/obj/effect/decal/cleanable/dirt,
/turf/simulated/floor/tiled/white/monotile,
/area/map_template/oldpod)
"aS" = (
/obj/effect/floor_decal/industrial/warning{
	dir = 1
	},
/obj/effect/decal/cleanable/dirt,
/obj/effect/decal/cleanable/dirt,
/obj/effect/decal/cleanable/dirt,
/turf/simulated/floor/tiled/white/monotile,
/area/map_template/oldpod)
"aT" = (
/obj/effect/floor_decal/industrial/warning{
	dir = 5;
	icon_state = "warning"
	},
/obj/structure/window/reinforced{
	dir = 1
	},
/obj/structure/closet/crate/freezer/rations,
/obj/effect/decal/cleanable/dirt,
/obj/item/gun/projectile/pirate,
/obj/item/gun/projectile/pirate,
/obj/item/gun/projectile/pirate,
/obj/item/gun/projectile/pirate,
/turf/simulated/floor/tiled/white/monotile,
/area/map_template/oldpod)
"aU" = (
/obj/effect/floor_decal/industrial/warning{
	dir = 9
	},
/turf/simulated/floor/plating,
/area/map_template/oldpod)
"aV" = (
/obj/effect/floor_decal/industrial/warning{
	dir = 5
	},
/obj/machinery/light/small{
	dir = 4
	},
/obj/item/clothing/head/helmet/space/emergency,
/turf/simulated/floor/plating,
/area/map_template/oldpod)
"aW" = (
/obj/machinery/power/terminal{
	dir = 1;
	icon_state = "term"
	},
/obj/structure/cable/cyan{
	d2 = 2;
	icon_state = "0-2"
	},
/obj/effect/floor_decal/industrial/warning{
	dir = 4
	},
/obj/structure/closet/crate,
/obj/item/tank/oxygen,
/turf/simulated/floor/plating,
/area/map_template/oldpod)
"aX" = (
/obj/effect/floor_decal/industrial/warning{
	dir = 8
	},
/obj/structure/window/reinforced{
	dir = 8
	},
/obj/machinery/optable,
/obj/effect/decal/cleanable/dirt,
/obj/effect/decal/cleanable/dirt,
/obj/effect/decal/cleanable/blood,
/turf/simulated/floor/tiled/white/monotile,
/area/map_template/oldpod)
"aY" = (
/obj/effect/decal/cleanable/dirt,
/obj/effect/decal/cleanable/dirt,
/obj/effect/decal/cleanable/dirt,
/obj/effect/decal/cleanable/dirt,
/turf/simulated/floor/tiled/white/monotile,
/area/map_template/oldpod)
"aZ" = (
/obj/machinery/sleeper{
	dir = 8
	},
/obj/effect/floor_decal/industrial/warning{
	dir = 4
	},
/obj/machinery/light/small{
	dir = 4
	},
/obj/effect/decal/cleanable/dirt,
/turf/simulated/floor/tiled/white/monotile,
/area/map_template/oldpod)
"ba" = (
/obj/effect/floor_decal/industrial/warning{
	dir = 10
	},
/obj/item/clothing/suit/space/emergency,
/turf/simulated/floor/plating,
/area/map_template/oldpod)
"bb" = (
/obj/effect/floor_decal/industrial/warning{
	dir = 6
	},
/turf/simulated/floor/plating,
/area/map_template/oldpod)
"bc" = (
/obj/machinery/power/port_gen/pacman,
/obj/structure/cable/cyan,
/obj/effect/floor_decal/industrial/warning{
	dir = 4
	},
/turf/simulated/floor/plating,
/area/map_template/oldpod)
"bd" = (
/obj/effect/landmark/corpse/bridgeofficer,
/obj/effect/decal/cleanable/blood,
/turf/simulated/floor/tiled/monotile,
/area/map_template/oldpod)
"be" = (
/obj/effect/floor_decal/industrial/warning{
	dir = 10;
	icon_state = "warning"
	},
/obj/structure/window/reinforced{
	dir = 8
	},
/obj/structure/table/standard{
	name = "plastic table frame"
	},
/obj/random/firstaid,
/obj/random/firstaid,
/obj/effect/decal/cleanable/dirt,
/turf/simulated/floor/tiled/white/monotile,
/area/map_template/oldpod)
"bf" = (
/obj/effect/floor_decal/industrial/warning,
/obj/effect/decal/cleanable/dirt,
/obj/effect/decal/cleanable/dirt,
/obj/effect/decal/cleanable/dirt,
/turf/simulated/floor/tiled/white/monotile,
/area/map_template/oldpod)
"bh" = (
/obj/effect/decal/cleanable/blood/drip,
/obj/effect/decal/cleanable/dirt,
/obj/effect/decal/cleanable/dirt,
/obj/effect/decal/cleanable/filth,
/obj/structure/broken_cryo,
/turf/simulated/floor/tiled/techmaint,
/area/map_template/oldpod)
"ch" = (
/obj/effect/decal/cleanable/dirt,
/obj/effect/decal/cleanable/dirt,
/obj/effect/landmark/corpse/engineer,
/obj/item/gun/energy/retro,
/turf/simulated/floor/tiled/monotile,
/area/map_template/oldpod)
"dj" = (
/obj/effect/decal/cleanable/dirt,
/obj/effect/floor_decal/industrial/warning{
	dir = 1
	},
/turf/simulated/floor/tiled/white,
/area/map_template/oldpod)
"go" = (
/obj/effect/floor_decal/industrial/outline/yellow,
/obj/machinery/portable_atmospherics/canister/empty,
/obj/machinery/atmospherics/portables_connector,
/turf/simulated/floor/plating,
/area/map_template/oldpod)
"iV" = (
/obj/effect/decal/cleanable/dirt,
/obj/effect/decal/cleanable/dirt,
/obj/effect/decal/cleanable/dirt,
/obj/machinery/atmospherics/pipe/simple/hidden/supply,
/turf/simulated/floor/tiled/monotile,
/area/map_template/oldpod)
"kA" = (
/obj/effect/decal/cleanable/filth,
/obj/effect/decal/cleanable/dirt,
/obj/effect/floor_decal/industrial/outline/yellow,
/obj/structure/table/rack,
/obj/item/clothing/suit/space/emergency,
/obj/item/clothing/head/helmet/space/emergency,
/obj/item/tank/emergency/oxygen/double,
/turf/simulated/floor/plating,
/area/map_template/oldpod)
"mp" = (
/obj/structure/table/standard{
	name = "plastic table frame"
	},
/obj/random/tech_supply,
/obj/random/tech_supply,
/obj/random/tech_supply,
/obj/random/tech_supply,
/obj/random/tech_supply,
/obj/item/pickaxe,
/obj/effect/decal/cleanable/dirt,
/turf/simulated/floor/tiled/monotile,
/area/map_template/oldpod)
"od" = (
/obj/effect/decal/cleanable/dirt,
/obj/effect/decal/cleanable/dirt,
/obj/item/disk/secret_project,
/turf/simulated/floor/tiled/monotile,
/area/map_template/oldpod)
"qV" = (
/obj/item/frame/air_alarm,
/obj/effect/decal/cleanable/dirt,
/obj/effect/decal/cleanable/dirt,
/obj/item/airalarm_electronics,
/obj/structure/bed/chair/shuttle/black{
	dir = 4
	},
/turf/simulated/floor/tiled/monotile,
/area/map_template/oldpod)
"sN" = (
/obj/effect/decal/cleanable/dirt,
/obj/structure/table,
/turf/simulated/floor/tiled/monotile,
/area/map_template/oldpod)
"ut" = (
/obj/effect/decal/cleanable/dirt,
/obj/structure/broken_cryo,
/turf/simulated/floor/tiled/techmaint,
/area/map_template/oldpod)
"vL" = (
/obj/effect/landmark/corpse/doctor,
/obj/effect/decal/cleanable/blood,
/obj/effect/decal/cleanable/dirt,
/obj/structure/bed/chair/shuttle/black{
	dir = 4
	},
/turf/simulated/floor/tiled/monotile,
/area/map_template/oldpod)
"wl" = (
/obj/effect/floor_decal/industrial/outline/yellow,
/obj/structure/table/rack,
/obj/item/crowbar/brace_jack,
/turf/simulated/floor/plating,
/area/map_template/oldpod)
"wJ" = (
/obj/machinery/door/firedoor,
/obj/effect/wallframe_spawn/reinforced/titanium,
/turf/simulated/floor/plating,
/area/map_template/oldpod)
"xv" = (
/obj/machinery/light/small{
	dir = 8
	},
/obj/effect/decal/cleanable/dirt,
/obj/effect/decal/cleanable/dirt,
/obj/structure/bed/chair/shuttle/black{
	dir = 4
	},
/turf/simulated/floor/tiled/monotile,
/area/map_template/oldpod)
"yj" = (
/obj/machinery/door/firedoor,
/obj/structure/grille,
/obj/item/stack/material/rods,
/obj/item/stack/material/rods,
/obj/item/stack/material/rods,
/obj/item/stack/material/rods,
/obj/item/material/shard,
/obj/item/material/shard,
/obj/item/material/shard,
/obj/item/material/shard,
/obj/structure/wall_frame/titanium,
/turf/simulated/floor/plating,
/area/map_template/oldpod)
"FH" = (
/turf/simulated/wall/r_titanium,
/area/map_template/oldpod)
"He" = (
/obj/machinery/light/small{
	dir = 4
	},
/obj/effect/decal/cleanable/filth,
/obj/effect/decal/cleanable/dirt,
/obj/effect/decal/cleanable/dirt,
/obj/effect/floor_decal/industrial/warning{
	dir = 1
	},
/obj/structure/closet/hydrant{
	pixel_x = 24;
	pixel_y = 0
	},
/turf/simulated/floor/tiled/white,
/area/map_template/oldpod)
"Jj" = (
/obj/effect/decal/cleanable/dirt,
/obj/effect/floor_decal/industrial/warning{
	dir = 4
	},
/turf/simulated/floor/tiled/white,
/area/map_template/oldpod)
"Kh" = (
/obj/effect/wallframe_spawn/reinforced/titanium,
/turf/simulated/floor/plating,
/area/map_template/oldpod)
"MA" = (
/obj/effect/paint/red,
/turf/simulated/wall/r_titanium,
/area/map_template/oldpod)
"Oy" = (
/obj/effect/decal/cleanable/blood,
/obj/effect/decal/cleanable/dirt,
/obj/machinery/atmospherics/pipe/simple/hidden/scrubbers,
/turf/simulated/floor/tiled/monotile,
/area/map_template/oldpod)
"Ps" = (
/obj/effect/decal/cleanable/dirt,
/obj/effect/floor_decal/industrial/warning/corner{
	dir = 4
	},
/turf/simulated/floor/tiled/white,
/area/map_template/oldpod)
"Pt" = (
/obj/machinery/door/firedoor,
/obj/effect/decal/cleanable/dirt,
/obj/effect/wallframe_spawn/reinforced/titanium,
/turf/simulated/floor/plating,
/area/map_template/oldpod)
"Tx" = (
/obj/effect/decal/cleanable/blood/drip,
/obj/effect/decal/cleanable/blood,
/obj/effect/decal/cleanable/dirt,
/obj/structure/bed/chair/shuttle/black{
	dir = 4
	},
/turf/simulated/floor/tiled/monotile,
/area/map_template/oldpod)
"Uw" = (
/obj/effect/decal/cleanable/filth,
/obj/effect/decal/cleanable/dirt,
/obj/effect/floor_decal/industrial/outline/yellow,
/obj/machinery/portable_atmospherics/canister/air/airlock,
/obj/machinery/atmospherics/portables_connector,
/obj/effect/decal/cleanable/dirt,
/turf/simulated/floor/plating,
/area/map_template/oldpod)
"Yb" = (
/obj/structure/shuttle/engine/heater{
	dir = 1;
	icon_state = "heater"
	},
/obj/structure/window/reinforced,
/turf/simulated/floor/plating,
/area/map_template/oldpod)

(1,1,1) = {"
MA
MA
FH
FH
Pt
wJ
FH
FH
FH
FH
"}
(2,1,1) = {"
ab
Yb
vL
xv
qV
Tx
ad
aU
ba
Kh
"}
(3,1,1) = {"
MA
MA
am
as
az
am
aO
aV
bb
aO
"}
(4,1,1) = {"
MA
wl
am
at
aA
aH
FH
FH
FH
FH
"}
(5,1,1) = {"
MA
Uw
iV
au
aB
aI
aP
aW
bc
Kh
"}
(6,1,1) = {"
MA
go
Oy
av
aC
ch
aQ
aK
bd
wJ
"}
(7,1,1) = {"
MA
kA
Jj
Ps
mp
aK
aR
aX
be
FH
"}
(8,1,1) = {"
MA
MA
ut
dj
sN
aL
aS
aY
bf
FH
"}
(9,1,1) = {"
ab
Yb
bh
He
od
aM
aT
aZ
ak
FH
"}
(10,1,1) = {"
MA
MA
FH
FH
wJ
yj
FH
FH
FH
FH
"}
