"aa" = (/turf/space,/area/ship_battle/osirus)
"ab" = (/turf/simulated/wall/r_wall,/area/ship_battle/osirus)
"ac" = (/turf/simulated/wall/r_wall,/area/ship_battle/osirus/central)
"ad" = (/obj/machinery/door/airlock/external,/turf/simulated/floor/plating,/area/ship_battle/osirus/central)
"ae" = (/turf/simulated/wall/r_wall,/area/ship_battle/osirus/engineering)
"af" = (/turf/simulated/floor/plating,/area/ship_battle/osirus/central)
"ag" = (/obj/machinery/space_battle/engine/electric{dir = 4; engine_id = "electric_engines"},/obj/structure/cable/orange{d2 = 4; icon_state = "0-4"},/turf/simulated/wall/r_wall,/area/ship_battle/osirus/engineering)
"ah" = (/obj/structure/cable/orange{d1 = 2; d2 = 8; icon_state = "2-8"},/turf/simulated/floor/plating,/area/ship_battle/osirus/engineering)
"ai" = (/turf/simulated/floor/plating,/area/ship_battle/osirus/engineering)
"aj" = (/obj/structure/cable/orange{d1 = 2; d2 = 8; icon_state = "2-8"},/obj/structure/cable/orange{d1 = 1; d2 = 8; icon_state = "1-8"},/obj/structure/cable/orange{d1 = 4; d2 = 8; icon_state = "4-8"},/turf/simulated/floor/plating,/area/ship_battle/osirus/engineering)
"ak" = (/obj/structure/cable/orange{d1 = 4; d2 = 8; icon_state = "4-8"},/turf/simulated/floor/plating,/area/ship_battle/osirus/engineering)
"al" = (/turf/simulated/floor/tiled,/area/ship_battle/osirus/central)
"am" = (/obj/structure/cable/orange{d1 = 1; d2 = 8; icon_state = "1-8"},/turf/simulated/floor/plating,/area/ship_battle/osirus/engineering)
"an" = (/obj/item/weapon/material/shard,/turf/simulated/floor/plating,/area/ship_battle/osirus/engineering)
"ao" = (/obj/item/stack/tile/floor_steel,/turf/simulated/floor/plating,/area/ship_battle/osirus/central)
"ap" = (/obj/item/stack/material/iron,/turf/simulated/floor/tiled,/area/ship_battle/osirus/central)
"aq" = (/obj/structure/grille/broken,/turf/simulated/floor/tiled,/area/ship_battle/osirus/central)
"ar" = (/obj/effect/floor_decal/industrial/warning,/turf/simulated/floor/airless,/area/ship_battle/osirus/central)
"as" = (/obj/structure/door_assembly/door_assembly_hatch,/turf/simulated/floor/plating,/area/ship_battle/osirus/engineering)
"at" = (/obj/machinery/atmospherics/pipe/tank/nitrogen{dir = 4},/turf/simulated/floor/tiled,/area/ship_battle/osirus/central)
"au" = (/obj/random/junk,/obj/machinery/atmospherics/valve{dir = 4},/turf/simulated/floor/tiled,/area/ship_battle/osirus/central)
"av" = (/obj/machinery/constructable_frame/machine_frame,/turf/simulated/floor/tiled,/area/ship_battle/osirus/central)
"aw" = (/turf/simulated/wall/r_wall,/area/ship_battle/osirus/bridge)
"ax" = (/obj/structure/firedoor_assembly,/turf/simulated/floor/tiled,/area/ship_battle/osirus/bridge)
"ay" = (/obj/random/trash,/turf/simulated/floor/tiled,/area/ship_battle/osirus/central)
"az" = (/obj/structure/plasticflaps/mining,/turf/simulated/floor/airless,/area/ship_battle/osirus/central)
"aA" = (/obj/machinery/space_battle/tube{damage_level = 7; dir = 4; icon_state = "mass_driver_broken"; id_tag = "osirus_tube1"},/turf/simulated/floor/airless,/area/ship_battle/osirus/central)
"aB" = (/obj/machinery/space_battle/tube_barrel{damage_level = 4; dir = 4; icon_state = "rail_broken"},/turf/simulated/floor/airless,/area/ship_battle/osirus/central)
"aC" = (/turf/simulated/floor/airless,/area/ship_battle/osirus/central)
"aD" = (/obj/machinery/space_battle/engine/fuelled{dir = 4; engine_id = "main_engines"; fuel_id = "main_engines"},/obj/structure/cable/orange{d2 = 4; icon_state = "0-4"},/turf/simulated/wall/r_wall,/area/ship_battle/osirus/engineering)
"aE" = (/obj/effect/floor_decal/industrial/warning{dir = 4},/obj/effect/decal/cleanable/liquid_fuel,/obj/structure/cable/orange{d1 = 2; d2 = 8; icon_state = "2-8"},/turf/simulated/floor/plating,/area/ship_battle/osirus/engineering)
"aF" = (/obj/machinery/fuel_port{id = "main_engines_port"},/turf/simulated/floor/plating,/area/ship_battle/osirus/engineering)
"aG" = (/obj/machinery/fuel_port{id = "main_engines_port"},/obj/structure/reagent_dispensers/fueltank/rocketfuel,/turf/simulated/floor/plating,/area/ship_battle/osirus/engineering)
"aH" = (/obj/effect/floor_decal/industrial/warning{dir = 8},/turf/simulated/floor/plating,/area/ship_battle/osirus/engineering)
"aI" = (/obj/machinery/atmospherics/pipe/tank/oxygen{dir = 4},/turf/simulated/floor/tiled,/area/ship_battle/osirus/central)
"aJ" = (/obj/machinery/atmospherics/valve{dir = 4},/turf/simulated/floor/tiled,/area/ship_battle/osirus/central)
"aK" = (/obj/machinery/atmospherics/pipe/simple/visible{tag = "icon-intact (NORTHWEST)"; icon_state = "intact"; dir = 9},/turf/simulated/floor/tiled,/area/ship_battle/osirus/central)
"aL" = (/turf/simulated/floor/tiled,/area/ship_battle/osirus/bridge)
"aM" = (/obj/machinery/atmospherics/pipe/simple/visible,/turf/simulated/floor/tiled,/area/ship_battle/osirus/bridge)
"aN" = (/obj/effect/decal/cleanable/cobweb2,/turf/simulated/floor/tiled,/area/ship_battle/osirus/bridge)
"aO" = (/obj/machinery/space_heater,/turf/simulated/floor/tiled,/area/ship_battle/osirus/central)
"aP" = (/obj/effect/floor_decal/industrial/warning{dir = 1},/turf/simulated/floor/airless,/area/ship_battle/osirus/central)
"aQ" = (/obj/effect/floor_decal/industrial/warning/corner{dir = 4},/obj/effect/floor_decal/industrial/warning/corner,/obj/effect/decal/cleanable/liquid_fuel,/obj/structure/cable/orange{d1 = 2; d2 = 8; icon_state = "2-8"},/obj/structure/cable/orange{d1 = 1; d2 = 2; icon_state = "1-2"},/turf/simulated/floor/plating,/area/ship_battle/osirus/engineering)
"aR" = (/obj/effect/floor_decal/industrial/warning{dir = 1},/obj/effect/floor_decal/industrial/warning,/turf/simulated/floor/plating,/area/ship_battle/osirus/engineering)
"aS" = (/obj/effect/floor_decal/industrial/warning{dir = 1},/obj/effect/floor_decal/industrial/warning,/obj/effect/decal/cleanable/liquid_fuel,/turf/simulated/floor/plating,/area/ship_battle/osirus/engineering)
"aT" = (/obj/effect/floor_decal/industrial/warning/corner{icon_state = "warningcorner"; dir = 1},/obj/effect/floor_decal/industrial/warning/corner{dir = 8},/obj/effect/decal/cleanable/liquid_fuel,/turf/simulated/floor/plating,/area/ship_battle/osirus/engineering)
"aU" = (/obj/item/weapon/airlock_electronics,/turf/simulated/floor/plating,/area/ship_battle/osirus/engineering)
"aV" = (/obj/machinery/door/airlock/maintenance,/turf/simulated/floor/plating,/area/ship_battle/osirus/engineering)
"aW" = (/obj/structure/table,/turf/simulated/floor/tiled,/area/ship_battle/osirus/bridge)
"aX" = (/obj/effect/decal/cleanable/blood/drip,/turf/simulated/floor/tiled,/area/ship_battle/osirus/bridge)
"aY" = (/turf/simulated/floor/plating,/area/ship_battle/osirus/bridge)
"aZ" = (/obj/structure/grille,/turf/simulated/floor/plating,/area/ship_battle/osirus/bridge)
"ba" = (/obj/structure/window/reinforced{dir = 1},/obj/structure/grille/broken,/turf/simulated/floor/plating,/area/ship_battle/osirus/central)
"bb" = (/obj/structure/grille,/obj/structure/window/reinforced{dir = 1},/obj/structure/window/reinforced,/obj/structure/window/reinforced{dir = 4},/turf/simulated/floor/plating,/area/ship_battle/osirus/central)
"bc" = (/obj/structure/inflatable/wall,/turf/simulated/floor/tiled,/area/ship_battle/osirus/central)
"bd" = (/obj/structure/grille,/obj/structure/window/reinforced{dir = 1},/obj/structure/window/reinforced,/obj/structure/window/reinforced{dir = 8},/turf/simulated/floor/airless,/area/ship_battle/osirus/central)
"be" = (/obj/structure/grille,/obj/structure/window/reinforced{dir = 4},/obj/structure/window/reinforced{dir = 1},/turf/simulated/floor/airless,/area/ship_battle/osirus/central)
"bf" = (/obj/effect/floor_decal/industrial/warning{dir = 4},/obj/structure/cable/orange{d1 = 2; d2 = 8; icon_state = "2-8"},/obj/structure/cable/orange{d1 = 1; d2 = 2; icon_state = "1-2"},/turf/simulated/floor/plating,/area/ship_battle/osirus/engineering)
"bg" = (/obj/effect/decal/cleanable/liquid_fuel,/turf/simulated/floor/plating,/area/ship_battle/osirus/engineering)
"bh" = (/obj/item/frame/apc,/turf/simulated/floor/plating,/area/ship_battle/osirus/engineering)
"bi" = (/obj/structure/table/reinforced,/obj/item/stack/medical/bruise_pack,/obj/machinery/firealarm{dir = 8; layer = 3.3; pixel_x = -26},/turf/simulated/floor/tiled,/area/ship_battle/osirus/bridge)
"bj" = (/obj/machinery/atmospherics/pipe/simple/visible,/turf/simulated/floor/plating,/area/ship_battle/osirus/bridge)
"bk" = (/obj/effect/decal/cleanable/blood,/turf/simulated/floor/tiled,/area/ship_battle/osirus/bridge)
"bl" = (/obj/machinery/space_battle/engine_control{engine_id = "electric_engines"; icon_state = "computer_off"; name = "Secondary Engines"},/turf/simulated/floor/tiled,/area/ship_battle/osirus/bridge)
"bm" = (/obj/structure/grille,/obj/structure/window/reinforced{dir = 8},/obj/structure/window/reinforced,/obj/structure/window/reinforced{dir = 4},/turf/simulated/floor/plating,/area/ship_battle/osirus/central)
"bn" = (/obj/item/stack/rods,/turf/simulated/floor/tiled,/area/ship_battle/osirus/central)
"bo" = (/obj/structure/grille,/obj/structure/window/reinforced{dir = 4},/obj/structure/window/reinforced{dir = 8},/turf/simulated/floor/airless,/area/ship_battle/osirus/central)
"bp" = (/obj/effect/floor_decal/industrial/warning/corner{dir = 4},/obj/effect/floor_decal/industrial/warning/corner,/obj/effect/decal/cleanable/liquid_fuel,/obj/structure/cable/orange{d1 = 1; d2 = 2; icon_state = "1-2"},/obj/structure/cable/orange{d1 = 2; d2 = 4; icon_state = "2-4"},/turf/simulated/floor/plating,/area/ship_battle/osirus/engineering)
"bq" = (/obj/effect/floor_decal/industrial/warning{dir = 1},/obj/effect/floor_decal/industrial/warning,/obj/effect/decal/cleanable/liquid_fuel,/obj/structure/cable/orange{d1 = 4; d2 = 8; icon_state = "4-8"},/turf/simulated/floor/plating,/area/ship_battle/osirus/engineering)
"br" = (/obj/effect/floor_decal/industrial/warning{dir = 1},/obj/effect/floor_decal/industrial/warning,/obj/effect/decal/cleanable/liquid_fuel,/obj/item/stack/cable_coil/orange{amount = 1; icon_state = "wire1"},/turf/simulated/floor/plating,/area/ship_battle/osirus/engineering)
"bs" = (/obj/effect/floor_decal/industrial/warning/corner{icon_state = "warningcorner"; dir = 1},/obj/effect/floor_decal/industrial/warning/corner{dir = 8},/obj/structure/cable/orange{d1 = 4; d2 = 8; icon_state = "4-8"},/turf/simulated/floor/plating,/area/ship_battle/osirus/engineering)
"bt" = (/obj/machinery/power/smes/buildable/battle{charge = 0},/obj/structure/cable/orange{d1 = 0; d2 = 8; icon_state = "0-8"},/turf/simulated/floor/plating,/area/ship_battle/osirus/engineering)
"bu" = (/obj/machinery/power/terminal{dir = 8},/turf/simulated/floor/plating,/area/ship_battle/osirus/engineering)
"bv" = (/obj/item/stack/cable_coil/orange{amount = 1; icon_state = "wire1"},/turf/simulated/floor/plating,/area/ship_battle/osirus/engineering)
"bw" = (/obj/machinery/power/apc/battle{dir = 8; name = "west bump"; pixel_x = -27; pixel_y = 0},/obj/structure/cable{d2 = 2; icon_state = "0-2"; pixel_y = 0},/obj/structure/table/reinforced,/obj/random/tool,/obj/random/tool,/obj/machinery/light{icon_state = "tube1"; dir = 8},/turf/simulated/floor/plating,/area/ship_battle/osirus/bridge)
"bx" = (/obj/machinery/space_battle/ship_core,/turf/simulated/floor/tiled,/area/ship_battle/osirus/bridge)
"by" = (/obj/item/weapon/stool,/turf/simulated/floor/tiled,/area/ship_battle/osirus/bridge)
"bz" = (/obj/machinery/space_battle/helm{damage_level = 3; icon_state = "computer_broken"},/turf/simulated/floor/tiled,/area/ship_battle/osirus/bridge)
"bA" = (/obj/structure/grille/broken,/turf/simulated/floor/plating,/area/ship_battle/osirus/bridge)
"bB" = (/obj/machinery/atmospherics/unary/vent_pump/on{dir = 8},/turf/simulated/floor/tiled,/area/ship_battle/osirus/central)
"bC" = (/obj/structure/inflatable/door,/turf/simulated/floor/tiled,/area/ship_battle/osirus/central)
"bD" = (/obj/item/weapon/material/shard,/turf/simulated/floor/tiled,/area/ship_battle/osirus/central)
"bE" = (/obj/structure/window/reinforced{dir = 8},/obj/structure/grille/broken,/turf/simulated/floor/airless,/area/ship_battle/osirus/central)
"bF" = (/obj/missile_start{name = "Osirus"},/turf/space,/area/ship_battle/osirus)
"bG" = (/obj/effect/floor_decal/industrial/warning{dir = 4},/obj/effect/decal/cleanable/liquid_fuel,/obj/structure/cable/orange{d1 = 1; d2 = 8; icon_state = "1-8"},/obj/structure/cable/orange{d1 = 1; d2 = 2; icon_state = "1-2"},/turf/simulated/floor/plating,/area/ship_battle/osirus/engineering)
"bH" = (/obj/machinery/fuel_port{id = "main_engines_starboard"},/obj/structure/reagent_dispensers/fueltank/rocketfuel,/turf/simulated/floor/plating,/area/ship_battle/osirus/engineering)
"bI" = (/obj/machinery/fuel_port{id = "main_engines_starboard"},/turf/simulated/floor/plating,/area/ship_battle/osirus/engineering)
"bJ" = (/obj/effect/floor_decal/industrial/warning{dir = 8},/obj/effect/decal/cleanable/liquid_fuel,/turf/simulated/floor/plating,/area/ship_battle/osirus/engineering)
"bK" = (/obj/item/remains/mouse,/turf/simulated/floor/plating,/area/ship_battle/osirus/engineering)
"bL" = (/obj/structure/cable{d1 = 1; d2 = 2; icon_state = "1-2"; pixel_y = 0},/obj/structure/table/reinforced,/obj/random/handgun,/obj/random/ammo,/turf/simulated/floor/tiled,/area/ship_battle/osirus/bridge)
"bM" = (/obj/machinery/atmospherics/unary/vent_pump/on{dir = 1},/turf/simulated/floor/plating,/area/ship_battle/osirus/bridge)
"bN" = (/obj/item/stack/material/glass,/obj/item/stack/rods,/turf/simulated/floor/tiled,/area/ship_battle/osirus/bridge)
"bO" = (/obj/machinery/space_battle/engine_control{engine_id = "main_engines"; icon_state = "computer_off"; name = "Main Engines"},/turf/simulated/floor/tiled,/area/ship_battle/osirus/bridge)
"bP" = (/obj/structure/grille,/obj/structure/window/reinforced{dir = 8},/obj/structure/window/reinforced{dir = 4},/obj/structure/window/reinforced{dir = 1},/turf/simulated/floor/plating,/area/ship_battle/osirus/central)
"bQ" = (/obj/effect/floor_decal/industrial/warning/corner{dir = 4},/obj/effect/floor_decal/industrial/warning/corner,/obj/effect/decal/cleanable/liquid_fuel,/obj/structure/cable/orange{d1 = 1; d2 = 8; icon_state = "1-8"},/obj/structure/cable/orange{d1 = 1; d2 = 2; icon_state = "1-2"},/turf/simulated/floor/plating,/area/ship_battle/osirus/engineering)
"bR" = (/obj/effect/floor_decal/industrial/warning,/obj/effect/floor_decal/industrial/warning{dir = 1},/obj/effect/decal/cleanable/liquid_fuel,/turf/simulated/floor/plating,/area/ship_battle/osirus/engineering)
"bS" = (/obj/effect/floor_decal/industrial/warning,/obj/effect/floor_decal/industrial/warning{dir = 1},/turf/simulated/floor/plating,/area/ship_battle/osirus/engineering)
"bT" = (/obj/effect/floor_decal/industrial/warning/corner{icon_state = "warningcorner"; dir = 1},/obj/effect/floor_decal/industrial/warning/corner{dir = 8},/turf/simulated/floor/plating,/area/ship_battle/osirus/engineering)
"bU" = (/obj/structure/girder/displaced,/turf/simulated/floor/plating,/area/ship_battle/osirus/engineering)
"bV" = (/obj/structure/girder/reinforced,/turf/simulated/floor/plating,/area/ship_battle/osirus/engineering)
"bW" = (/obj/machinery/power/smes/buildable/battle,/obj/structure/cable,/turf/simulated/floor/tiled,/area/ship_battle/osirus/bridge)
"bX" = (/obj/item/remains/human,/turf/simulated/floor/tiled,/area/ship_battle/osirus/bridge)
"bY" = (/obj/item/weapon/material/shard,/turf/simulated/floor/tiled,/area/ship_battle/osirus/bridge)
"bZ" = (/obj/structure/grille,/obj/structure/window/reinforced{dir = 8},/obj/structure/window/reinforced,/turf/simulated/floor/plating,/area/ship_battle/osirus/central)
"ca" = (/obj/structure/grille,/obj/structure/window/reinforced,/obj/structure/window/reinforced{dir = 4},/turf/simulated/floor/plating,/area/ship_battle/osirus/central)
"cb" = (/obj/structure/grille,/obj/structure/window/reinforced,/obj/structure/window/reinforced{dir = 8},/obj/structure/window/reinforced{dir = 1},/turf/simulated/floor/airless,/area/ship_battle/osirus/central)
"cc" = (/obj/structure/grille,/obj/structure/window/reinforced{dir = 4},/obj/structure/window/reinforced,/turf/simulated/floor/airless,/area/ship_battle/osirus/central)
"cd" = (/obj/machinery/space_battle/engine/fuelled{dir = 4; engine_id = "main_engines"; fuel_id = "main_engines_starboard"},/obj/structure/cable/orange{d2 = 4; icon_state = "0-4"},/turf/simulated/wall/r_wall,/area/ship_battle/osirus/engineering)
"ce" = (/obj/effect/floor_decal/industrial/warning{dir = 4},/obj/effect/decal/cleanable/liquid_fuel,/obj/structure/cable/orange{d1 = 1; d2 = 8; icon_state = "1-8"},/turf/simulated/floor/plating,/area/ship_battle/osirus/engineering)
"cf" = (/obj/effect/decal/cleanable/cobweb,/turf/simulated/floor/tiled,/area/ship_battle/osirus/central)
"cg" = (/obj/machinery/power/terminal{icon_state = "term"; dir = 1},/turf/simulated/floor/tiled,/area/ship_battle/osirus/bridge)
"ch" = (/obj/item/mecha_parts/mecha_equipment/tool/extinguisher,/turf/simulated/floor/tiled,/area/ship_battle/osirus/bridge)
"ci" = (/obj/structure/reagent_dispensers/watertank,/turf/simulated/floor/tiled,/area/ship_battle/osirus/central)
"cj" = (/obj/item/weapon/newspaper,/turf/simulated/floor/tiled,/area/ship_battle/osirus/central)
"ck" = (/obj/machinery/door/airlock/glass_command{name = "Command Room"},/turf/simulated/floor/tiled,/area/ship_battle/osirus/bridge)
"cl" = (/obj/random/junk,/turf/simulated/floor/tiled,/area/ship_battle/osirus/central)
"cm" = (/obj/item/robot_parts/robot_component/binary_communication_device,/turf/simulated/floor/plating,/area/ship_battle/osirus/engineering)
"cn" = (/obj/item/stack/material/wood/fifty,/turf/simulated/floor/tiled,/area/ship_battle/osirus/central)
"co" = (/obj/item/stack/tile/floor_steel,/turf/simulated/floor/tiled,/area/ship_battle/osirus/central)
"cp" = (/obj/item/frame/apc,/turf/simulated/floor/tiled,/area/ship_battle/osirus/central)
"cq" = (/obj/structure/cable/orange{d1 = 1; d2 = 8; icon_state = "1-8"},/obj/structure/cable/orange{d1 = 2; d2 = 8; icon_state = "2-8"},/obj/structure/cable/orange{d1 = 4; d2 = 8; icon_state = "4-8"},/turf/simulated/floor/plating,/area/ship_battle/osirus/engineering)
"cr" = (/obj/structure/table,/turf/simulated/floor/tiled,/area/ship_battle/osirus/central)
"cs" = (/turf/space,/area/space)
"ct" = (/obj/effect/mapinfo/ship/derelict{mapx = null; mapy = null},/turf/space,/area/ship_battle/osirus)

(1,1,1) = {"
aaaaaaaaaaaaaaaaaaaaaaaaaaaaaaaaaaaaaaaaaaaaaaaaaaaaaaaaaaaaaaaaaaaaaaaaaaaaaaaaaaaaaaaaaaaaaaaaaaaa
aaaaaaaaaaaaaaaaaaaaaaaaaaaaaaaaaaaaaaaaaaaaaaaaaaaaaaaaaaaaaaaaaaaaaaaaaaaaaaaaaaaaaaaaaaaaaaaaaaaa
aaaaaaaaaaaaaaaaaaaaaaaaaaaaaaaaaaaaaaaaaaaaaaaaaaaaaaaaaaaaaaaaaaaaaaaaaaaaaaaaaaaaaaaaaaaaaaaaaaaa
aaaaaaaaaaaaaaaaaaaaaaaaaaaaaaaaaaaaaaaaaaaaaaaaaaaaaaaaaaaaaaaaaaaaaaaaaaaaaaaaaaaaaaaaaaaaaaaaaaaa
aaaaaaaaaaaaaaaaaaaaaaaaaaaaaaaaaaaaaaaaaaaaaaaaaaaaaaaaaaaaaaaaaaaaaaaaaaaaaaaaaaaaaaaaaaaaaaaaaaaa
aaaaaaaaaaaaaaaaaaaaaaaaaaaaaaaaaaaaaaaaaaaaaaaaaaaaaaaaaaaaaaaaaaaaaaaaaaaaaaaaaaaaaaaaaaaaaaaaaaaa
aaaaaaaaaaaaaaaaaaaaaaaaaaaaaaaaaaaaaaaaaaaaaaaaaaaaaaaaaaaaaaaaaaaaaaaaaaaaaaaaaaaaaaaaaaaaaaaaaaaa
aaaaaaaaaaaaaaaaaaaaaaaaaaaaaaaaaaaaaaaaaaaaaaaaaaaaaaaaaaaaaaaaaaaaaaaaaaaaaaaaaaaaaaaaaaaaaaaaaaaa
aaaaaaaaaaaaaaaaaaaaaaaaaaaaaaaaaaaaaaaaaaaaaaaaaaaaaaaaaaaaaaaaaaaaaaaaaaaaaaaaaaaaaaaaaaaaaaaaaaaa
aaaaaaaaaaaaaaaaaaaaaaaaaaaaaaaaaaaaaaaaaaaaaaababababaaaaaaaaaaaaaaaaaaaaaaaaaaaaaaaaaaaaaaaaaaaaaa
aaaaaaaaaaaaaaaaaaaaaaaaaaaaaaaaaaaaaaaaaaaaabababaaaaaaaaaaaaaaaaaaaaaaaaaaaaaaaaaaaaaaaaaaaaaaaaaa
aaaaaaaaaaaaaaaaaaaaaaaaaaaaaaaaaaaaaaaaababababaaaaaaaaaaaaaaaaaaaaaaaaaaaaaaaaaaaaaaaaaaaaaaaaaaaa
aaaaaaaaaaaaaaaaaaaaaaaaaaaaaaaaaaaaaaaaababababaaaaaaaaaaaaaaaaaaaaaaaaaaaaaaaaaaaaaaaaaaaaaaaaaaaa
aaaaaaaaaaaaaaaaaaaaaaaaaaaaaaaaaaaaaaaaaaababababaaaaaaaaaaaaaaaaaaaaaaaaaaaaaaaaaaaaaaaaaaaaaaaaaa
aaaaaaaaaaaaaaaaaaaaaaaaaaaaaaaaaaaaaaaaaaaaababababaaaaaaaaaaaaaaaaaaaaaaaaaaaaaaaaaaaaaaaaaaaaaaaa
aaaaaaaaaaaaaaaaaaaaaaaaaaaaaaaaaaaaaaaaaaaaaaababababaaaaaaaaaaaaaaaaaaaaaaaaaaaaaaaaaaaaaaaaaaaaaa
aaaaaaaaaaaaaaaaaaaaaaacacacaaaaaaaaaaaaaaaaaaaaacacacacaaaaaaaaaaaaaaaaaaaaaaaaaaaaaaaaaaaaaaaaaaaa
aaaaaaaaaaaaaaaaaaaaacacacacacacadacacacacacacacacacacacacaaaaaaaaaaaaaaaaaaaaaaaaaaaaaaaaaaaaaaaaaa
aaaaaaaaaaaaaaaaaaaeaeaeaeaeaeaeafacacacacacacacacacacacacacaaacacaaacacacaaaaaaaaaaaaaaaaaaaaaaaaaa
aaaaaaaaaaaaaaaaaaagahaiaiaiaiaeadacacacacacacacacacacacacacacacacacacacacacaaacacacacacaaaaaaaaaaaa
aaaaaaaaaaaaaaaaaaagajakaiakahaealalalalalalalalalalalalalalacacacacacacacacacacacacacacacaaaaaaaaaa
aaaaaaaaaaaaaaaaaaagamaianaiaiaealalaoalapaqalalalalalalafafalalalacarararacacacacacacacacaaaaaaaaaa
aaaaaaaaaaaeaeaeaeaeaeaeaeaeasaeatauavafalawawaxawawawawalayalalalazaAaBaBaBaBaCaBaBaCaCaCaaaaaaaaaa
aaaaaaaaaaaDaEaFaiaFaGaGaFaHaiaeaIaJaKalalawaLaMaLaLaNawalalalalaOacaCaPaPacacacacacacacacaaaaaaaaaa
aaaaaaaaaaaDaQaRaRaSaRaRaRaTaUaeaeaeaeaeaVawaWaXaLaYaLaZalalalalalbabbbcbdbeaaaaaaaaaaaaaaaaaaaaaaaa
aaaaaaaaaaaDbfaFaFaFaiaFaFaHbgaiaibhaiaiaiawbibjaLbkblaZalalalalalbmalalbnboaaaaaaaaaaaaaaaaaaaaaaaa
aaaaaaaaaaaebpbqaSbrbqaRaRbsakbtbuaibvaiaiawbwbjbxbybzbAalafafbBalbCayalbDbEaaaaaaaaaaaaaaaaaaaabFaa
aaaaaaaaaaaDbGbHbHbIbIbIbIbJbKaiaiaiaiaiaiawbLbMaLbNbOaZalalafalalbPalafalboaaaaaaaaaaaaaaaaaaaaaaaa
aaaaaaaaaaaDbQbRbRbSbSbSbSbTbgaeaebUbVaeasawbWaXbXbYbYaZalalalalalbZcabccbccaaaaaaaaaaaaaaaaaaaaaaaa
aaaaaaaaaacdcebHbIbIbIbIbIaHaiaecfalalalalawcgaLaLchaLawcialayalalacaraCaracacacacacacacacaaaaaaaaaa
aaaaaaaaaaaeaeaeaeaeaeaeaeaeaVaealcjalalalawawckawawawawalalclalalazaCaCaBaBaCaBaCaCaCaCaCaaaaaaaaaa
aaaaaaaaaaaaaaaaaaagahaiaicmaiaealalalcnalalalcoalalalalalalalalcpacaPaPaPacacacacacacacacaaaaaaaaaa
aaaaaaaaaaaaaaaaaaagcqakbvaiaiaealcralalalalalafalalalalalalacacacacacacacacacacacacacacacaaaaaaaaaa
aaaaaaaaaaaaaaaaaaagamaiaiaiaiaeadacacacacacacacacacacacacacacacacacacacacacacacacacacacaaaaaaaaaaaa
aaaaaaaaaaaaaaaaaaaeaeaeaeaeaeaeafacacacacacacacacacacacacacaaacacaaacacacaaaaaaaaaaaaaaaaaaaaaaaaaa
aaaaaaaaaaaaaaaaaaaaacacacacacacadacacacacacacacacacacacacaaaaaaaaaaaaaaaaaaaaaaaaaaaaaaaaaaaaaaaaaa
aaaaaaaaaaaaaaaaaaaaaaacacacaaaaaaaaaaaaaaaaaaaaababababaaaaaaaaaaaaaaaaaaaaaaaaaaaaaaaaaaaaaaaaaaaa
aaaaaaaaaaaaaaaaaaaaaaaaaaaaaaaaaaaaaaaaaaaaaaababababaaaaaaaaaaaaaaaaaaaaaaaaaaaaaaaaaaaaaaaaaaaaaa
aaaaaaaaaaaaaaaaaaaaaaaaaaaaaaaacsaaaaaaaaaaababababaaaaaaaaaaaaaaaaaaaaaaaaaaaaaaaaaaaaaaaaaaaaaaaa
aaaaaaaaaaaaaaaaaaaaaaaaaaaaaaaaaaaaaaaaaaababababaaaaaaaaaaaaaaaaaaaaaaaaaaaaaaaaaaaaaaaaaaaaaaaaaa
aaaaaaaaaaaaaaaaaaaaaaaaaaaaaaaaaaaaaaaaaaababababaaaaaaaaaaaaaaaaaaaaaaaaaaaaaaaaaaaaaaaaaaaaaaaaaa
aaaaaaaaaaaaaaaaaaaaaaaaaaaaaaaaaaaaaaaaaaaaaaabababaaaaaaaaaaaaaaaaaaaaaaaaaaaaaaaaaaaaaaaaaaaaaaaa
aaaaaaaaaaaaaaaaaaaaaaaaaaaaaaaaaaaaaaaaaaaaaaaaababababaaaaaaaaaaaaaaaaaaaaaaaaaaaaaaaaaaaaaaaaaaaa
aaaaaaaaaaaaaaaaaaaaaaaaaaaaaaaaaaaaaaaaaaaaaaaaaaaaaaaaaaaaaaaaaaaaaaaaaaaaaaaaaaaaaaaaaaaaaaaaaaaa
aaaaaaaaaaaaaaaaaaaaaaaaaaaaaaaaaaaaaaaaaaaaaaaaaaaaaaaaaaaaaaaaaaaaaaaaaaaaaaaaaaaaaaaaaaaaaaaaaaaa
aaaaaaaaaaaaaaaaaaaaaaaaaaaaaaaaaaaaaaaaaaaaaaaaaaaaaaaaaaaaaaaaaaaaaaaaaaaaaaaaaaaaaaaaaaaaaaaaaaaa
aaaaaaaaaaaaaaaaaaaaaaaaaaaaaaaaaaaaaaaaaaaaaaaaaaaaaaaaaaaaaaaaaaaaaaaaaaaaaaaaaaaaaaaaaaaaaaaaaaaa
aaaaaaaaaaaaaaaaaaaaaaaaaaaaaaaaaaaaaaaaaaaaaaaaaaaaaaaaaaaaaaaaaaaaaaaaaaaaaaaaaaaaaaaaaaaaaaaaaaaa
aaaaaaaaaaaaaaaaaaaaaaaaaaaaaaaaaaaaaaaaaaaaaaaaaaaaaaaaaaaaaaaaaaaaaaaaaaaaaaaaaaaaaaaaaaaaaaaaaaaa
ctaaaaaaaaaaaaaaaaaaaaaaaaaaaaaaaaaaaaaaaaaaaaaaaaaaaaaaaaaaaaaaaaaaaaaaaaaaaaaaaaaaaaaaaaaaaaaaaaaa
"}
