"a" = (/turf/space,/area/mine/unexplored)
"b" = (/turf/simulated/mineral/random{mineralChance = 10},/area/mine/unexplored)
"c" = (/turf/space,/area/shuttle/mining_shuttle/destination)
"d" = (/turf/simulated/floor/asteroid,/area/shuttle/mining_shuttle/destination)
"e" = (/turf/simulated/floor/asteroid,/area/mine/unexplored)
"f" = (/turf/simulated/mineral/random{mineralChance = 5},/area/mine/unexplored)
"g" = (/turf/simulated/mineral/random{mineralChance = 100},/area/mine/unexplored)
"h" = (/turf/space,/area/space)
"i" = (/obj/effect/mapinfo/asteroid{known = 1; name = "Medium Asteroid"},/turf/space,/area/mine/unexplored)

(1,1,1) = {"
aaaaaaaaaaaaaaaaaaaaaaaaaaaaaaaaaaaaaaaaaaaaaaaaaaaaaaaaaaaaaaaaaaaaaaaaaaa
aaaaaaaaaaaaaaaaaaaaaaaaaaaaaaaaaaaaaaaaaaaaaaaaaaaaaaaaaaaaaaaaaaaaaaaaaaa
aaaaaaaaaaaaaaaaaaaaaaaaaaaaaaaaaaaaaaaaaaaaaaaaaaaaaaaaaaaaaaaaaaaaaaaaaaa
aaaaaaaaaaaaaaaaaaaaaaaaaaaaaaaaaaaaaaaaaaaaaaaaaaaaaaaaaaaaaaaaaaaaaaaaaaa
aaaaaaaaaaaaaaaaaaaaaaaaaaaaaaaaaaaaaaaaaaaaaaaaaaaaaaaaaaaaaaaaaaaaaaaaaaa
aaaaaaaaaaaaaaaaaaaaaaaaaaaaaaaaaaaaaaaaaaaaaaaaaaaaaaaaaaaaaaaaaaaaaaaaaaa
aaaaaaaaaaaaaaaaaaaaaaaaaaaaaaaaaaaaaaaaaaaaaaaaaaaaaaaaaaaaaaaaaaaaaaaaaaa
aaaaaaaaaaaaaaaaaaaaaaaaaaaaaaaaaaaaaaaaaaaaaaaaaaaaaaaaaaaaaaaaaaaaaaaaaaa
aaaaaaaaaaaaaaaaaaaaaaaaaaaaaaaaaaaaaaaaaaaaaaaaaaaaaaaaaaaaaaaaaaaaaaaaaaa
aaaaaaaaaaaaaaaaaaaaaaaaaaaaaaaaaaaaaaaaaaaaaaaaabbaaaaaaaaaaaaaaaaaaaaaaaa
aaaaaaaaaaaaaaaaaaaaaaaaaaaaaaaaaaaaaaaaaaaaaaaabbbaaaaaaaaaaaaaaaaaaaaaaaa
aaaaaaaaaaaaaaaaaaaaaaaaaaaaaaaaaaaaaaaaaaaaaaaaabaaaaaaaaaaaaaaaaaaaaaaaaa
aaaaaaaaaaaaaaaaaaaaaaaaaaaaaaaaaaaaaaaaaaaaaaaaaaaaaaaaaaaaaaaaaaaaaaaaaaa
aaaaaaaaaaaaaaaaaaaaaaaaaaaaaaaaaaaaaaaaaaaaaaaaaaaaaaaaaaaaaaaaaaaaaaaaaaa
aaaaaaaaaaaaaaaaaaaaaaaaaaaaaaaaaaaaaaaaaaaaaaaaaaaaaaaaaaaaaaaaaaaaaaaaaaa
aaaaaaaaaaaaaaaaaaaaaaaaaaaaaaaaacccccccccccccaaaaaaaaaaaaaaaaaaaaaaaaaaaaa
aaaaaaaaaaaaaaaaaaaaaaaaaaaaaaaaacccccccccccccaaaaaaaaaaaaaaaaaaaaaaaaaaaaa
aaaaaaaaaaaaaaaaaaaaaaaaaaaaaaaaacccccdddcccccaaaaaaaaaaaabaaaaaaaaaaaaaaaa
aaaaaaaaaaaaaaaaaaaaaaaaaaaaaaaaaccdddddddccccaaaaaaaaaabbbaaaaaaaaaaaaaaaa
aaaaaaaaaaaaaaaaaaaaaaaaaaaaaaaaacdddddddddcccaeaaaaaaaabbbbaaaaaaaaaaaaaaa
aaaaaaaaaaaaaaaaaaaaaaaaaaaaaaeaedddddddddddddaeeaaaaaabbbbbbaaaaaaaaaaaaaa
aaaaaaaaaaaaaaaaaaaaaaaaaaaaaaeeedddddddddddddeeeeeeaaaabbbbaaaaaaaaaaaaaaa
aaaaaaaaaaaaaabbbbaaaaaaaaaaaeeeedddddddddddddeeeeeeaaaabbbbaaaaaaaaaaaaaaa
aaaaaaaaaaaaabbbbbaaaaaaeeeaeeeeedddddddddddddeeeeeeeaaaabbbaaaaaaaaaaaaaaa
aaaaaaaaaaaabbbbbbbaaaaaaeeeeeeeeeeeeeeeeeeeeeeeefefeeaaabaaaaaaaaaaaaaaaaa
aaaaaaaaaaaabbbbbbaaaaaaaeeefeeeeeeeeeeeeeeefefeefefffeaaaaaaaaaaaaaaaaaaaa
aaaaaaaaaaaabbbbbaaaaaaafffffeeeeeeeeeeeeeeeeefeefefffeaaaaaaaaaaaaaaaaaaaa
aaaaaaaaaaaabbbaaaaaaaaffbbbfffffeefffefefefeeffeeffffeeaaaaaaaaaaaaaaaaaaa
aaaaaaaaaaaaaaaaaaaaaaffbbbbbbbbffffeeefffeffffffffffffeaaaaaaaaaaaaaaaaaaa
aaaaaaaaaaaaaaaaaaaaaaefbbbeebbbbbbeebbbbbeeeeebbbbbfffeaaaaaaaaaaaaaaaaaaa
aaaaaaaaaaaaaaaaaaaaafffbbbeebbbeebbbbbbeeeebbbffffbfffeefaaaaabbbaaaaaaaaa
aaaaaaaaaaaaaaaaaaaaaefbbbbbebbbeebbbbebebbbbbbfeeffffeeffaaabbbbbaaaaaaaaa
aaaaaaaaaaaaaaabbaaaeefbbbbebbbbebbbeebbebbbbbbffeeeeeeeffeaaabbbbaaaaaaaaa
aaaaaaaaaaaaaaaabaaaeffbbbbbbbbbbbbbbebbbbbbbbbbfeeeeeeeefeaaabbbbbaaaaaaaa
aaaaaaaaaaaaaaaaaaaeefbbbbbbbbbbbbbbbbbbbbbbbbbbfeeeeeeefeeaaaabbaaaaaaaaaa
aaaaaaaaaaaaaaaaaaaaafbbbbbbbbbbbbbbbbbbbbbbbbbbfffffffeeeaaaaaaaaaaaaaaaaa
aaaaaaaaaaaaaaaaaaafefbbbbbbbbbbbbbbbbbbbbbbbbbbbbbefefeeeaaaaaaaaaaaaaaaaa
aaaaaaaaaaaaaaaaafefffebbbbbbbbbbbbbbbbbbbbbbbbbbbbbfefeeeegaaaaaaaaaaaaaaa
aaaaaaaaaabbbaaaafefbbbbbbbbbbbbbbbbbbbbbbbbbbbbbbbffeeeeeggaaaaaaaaaaaaaaa
aaaaaaaaaabbbbbaafffbbbbbbbbbbbbbbbeebbbbbbbbbbbbbbfeeeeegggaaaaaaaaaaaaaaa
aaaaaaaaaaabbbbafffbbbbbbbbbbbbbbbbbbbbbbbbbbbbbbbbfffffeaggaaaaaaaaaaaaaaa
aaaaaaaaaaaaaaaaaeffffbbbbbbbbbbbbgggbbbbbbbbbbbbbbbbffeeggaaaaaaaaaaaaaaaa
aaaaaaaaaaaaaaaaaeeeefffbbbbbbbbbbgggbbbbbbbbbbbbbbbbfeeaaaaaaaaaaaaaaaaaaa
aaaaaaaaaaaaaaaaaaaaeeefbbbbbbbbbbgggbbbbbeebbbbbbbbbfffaaaaaaaaaaaaaaaaaaa
aaaaaaaaaaaaaaaaaaaeeeffbbbbbbbbbbbbbbbbbbbeebbbbbbbbbbfaaaaaaaaaaaaaaaaaaa
aaaaaaaaaaaaabbbaaaaefffbbbbbbbbbbbbbbbbbbbbbbbbbbbbbbbfaaaaaaaaaaaaaaaaaaa
aaaaaaaaaaaaabbbaaeeeeefbbbbbbebbbbbbbbbbbbbbbbbbbbbbbbfeaaaaaaaaaaaaaaaaaa
aaaaaaaaaaaaaabaaaeeefffbbbbbbebbbbbbbbbbbbbbbbbbbbbbbffeaaaaaaaaaaaaaaaaaa
aaaaaaaaaaaaaaaaaabfffbbbbbbbbbbbbbbbbbbbbbbbbbbbbbbbbfaaaaaaaaaaaaaaaaaaaa
aaaaaaaaaaaaaaaaaaaafbbbbbbbbbbbbbbbbbbbbbbbbbbbbbbbfffaaaaaaaaaaaaaaaaaaaa
aaaaaaaaaaaaaaaaaaaafbbbbbbbbbbbbbbbbbbbbbbbbbbbbbbbfaaaaaaaaaaaaaaaaaaaaaa
aaaaaaaaaaaaaaaaaaaaffffbbbbbbbbbbbbbbbbbbbbbbbbbbbbfffaaaaaaaaaaaaaaaaaaaa
aaaaaaaaaaaaaaaaaaaaefefffbbbbbbbbbbbbbbbbbbbbbbbbffffffaaaaaaaaaaaaaaaaaaa
aaaaaaaaaaaaaaaaaaaaeeefeffbbbbbbbbbbbbbffffbbbbbfffefffaaaaaaaaaaaaaaaaaaa
aaaaaaaaaaaaaaaaaaaaaaeeeefbbbbbbbbbbbbbfeefffbfffefeeafaaaaaaaaaaaaaaaaaaa
aaaaaaaaaaaaaaaaaabaaaaaaeffbbbbbbbbbbbffeeeefffefefeaaaaaaaaaaaaaaaaaaaaaa
aaaaaaaaaaaaaaaaaaaaaaaaaeefbbbbbbfffebfeeaaeeeeeeeeaaaaaaaaaaaaaaaaaaaaaaa
aaaaaaaaaaaaaaaaaaaaaaaaaaeffffffffeffffeaaaaaaaaaaaaaaaaaaaaaaaaaaaaaaaaaa
aaaaaaaaaaaaaaaaaaaaaaaaaaeeffeeefeeefeeeeaaaaaaaaaaaaaaaaaaaaaaaaaaaaaaaaa
aaaaaaaaaaaaaaaaaaaaaaaaaaaeeeeeeeeeeeeeeaaaaaaaaaaaaaaaaaaaaaaaaaaaaaaaaaa
aaaaaaaaaaaaaaaaaaaaabebbaaaeeeeeeeeeeeaaaaaaaaaaaaaaaaaaaaaaaaaaaaaaaaaaaa
aaaaaaaaaaaaaaaaaaaaaaebbbaaaaaaaaaaaaaaaaaaaaaaaaaaaaaaaaaaaaaaaaaaaaaaaaa
aaaaaaaaaaaaaaaaaaaaaaaabbbbabaaaaaaaaaaaaaaaaaaaaaaaaaaaaaaaaaaaaaaaaaaaaa
aaaaaaaaaaaaaaaaaaaaaaabbbbbbbeaaaaaaaaaaaaaaaaaaaaaaaaaaaaaaaaaaaaaaaaaaaa
aaaaaaaaaaaaaaaaaaaaaaaaebbbbbbeeaaaaaaaaaaaaaaaaaaaaaaaaaaaaaaaaaaaaaaaaaa
aaaaaaaaaaaaaaaaaaaaaaaaebbbbbbbbaaaaaaaaaaaaaaaaaaaaaaaaaaaaaaaaaaaaaaaaaa
aaaaaaaaaaaaaaaaaaaaaaaaebbbbbbbbaaaaaaaaaaaaaaaaaaaaaaaaaaaaaaaaaaaaaaaaaa
aaaaaaaaaaaaaaaaaaaaaaaaeeeeaaaeeaaaaaaaaaaaaaaaaaaaaaaaaaaaaaaaaaaaaaaaaaa
aaaaaaaaaaaaaaaaaaaaaaaaaaeaaaaeaaaaaaaaaaaaaaaaaaaaaaaaaaaaaaaaaaaaaaaaaaa
aaaaaaaaaaaaaaaaaaaaaaaaaaaaaaaeaaaaaaaaaaaaaaaaaaaaaaaaaaaaaaaaaaaaaaaaaaa
aaaaaaaaaaaaaaaaaaaaaaaaaaaaaaaaaaaaaaaaaaaaaaaaaaaaaaaaaaaaaaaaaaaaaaaaaaa
aaaaaaaaaaaaaaaaaaaaaaaaaaaaaaaaaaaaaaaaaaaaaaaaaaaaaaaaaaaaaaaaaaaaaaaaaaa
aaaaaaaaaaaaaaaaaaaaaaaaaaaaaaaaaaaaaaaaaaaaaaaaaaaaaaaaaaaaaaaaaaaaaaaaaaa
aaaaaaaaaaaaaaaaaaaaaaaaaaaaaaaaaaaaaaaaaaaaaaaaaaaaaaaaaaaahhhhhhhhhhhhhhh
iaaaaaaaaaaaaaaaaaaaaaaaaaaaaaaaaaaaaaaaaaaaaaaaaaaaaaaaaaaahhhhhhhhhhhhhhh
"}
