//MAP CONVERTED BY dmm2tgm.py THIS HEADER COMMENT PREVENTS RECONVERSION, DO NOT REMOVE
"dG" = (
/obj/structure/table/woodentable/walnut,
/obj/structure/window/reinforced,
/obj/machinery/light{
	dir = 8
	},
/turf/simulated/floor/wood/walnut,
/area/map_template/deepmaint)
"dJ" = (
/obj/machinery/light{
	dir = 8
	},
/turf/simulated/floor/wood/walnut,
/area/map_template/deepmaint)
"dT" = (
/mob/living/simple_animal/hostile/russian,
/turf/simulated/floor/wood/walnut,
/area/map_template/deepmaint)
"fN" = (
/obj/structure/table/woodentable/walnut,
/obj/item/device/eftpos,
/turf/simulated/floor/carpet/red,
/area/map_template/deepmaint)
"fQ" = (
/obj/structure/window/reinforced,
/obj/structure/closet/cabinet,
/obj/item/storage/briefcase,
/obj/item/clothing/under/rank/dispatch,
/obj/item/clothing/head/beret/centcom/officer,
/obj/item/clothing/glasses/sunglasses,
/obj/item/clothing/accessory/blue,
/obj/item/clothing/accessory/wristwatch/leather,
/obj/item/clothing/accessory/ubac/blue,
/obj/item/clothing/accessory/toggleable/navy_jacket,
/obj/item/clothing/accessory/storage/holster/armpit,
/obj/item/clothing/shoes/dress,
/obj/item/clothing/accessory/armor_plate/sneaky,
/turf/simulated/floor/carpet/blue2,
/area/map_template/deepmaint)
"fU" = (
/obj/structure/table/rack,
/obj/random/voidsuit,
/obj/random/voidhelmet,
/obj/floor_decal/corner/red/mono,
/turf/simulated/floor/tiled/dark/monotile,
/area/map_template/deepmaint)
"iR" = (
/obj/structure/window/reinforced{
	dir = 1
	},
/turf/simulated/floor/carpet/blue2,
/area/map_template/deepmaint)
"jp" = (
/obj/structure/bed/chair/padded/blue{
	dir = 8
	},
/turf/simulated/floor/carpet/blue2,
/area/map_template/deepmaint)
"kp" = (
/obj/machinery/door/airlock/glass/command{
	name = "Blueshield Detective"
	},
/turf/simulated/floor/wood/walnut,
/area/map_template/deepmaint)
"ku" = (
/obj/machinery/door/airlock/glass/command{
	name = "Blueshield Detective Services"
	},
/turf/simulated/floor/wood/walnut,
/area/map_template/deepmaint)
"kv" = (
/obj/machinery/constructable_frame/computerframe/deconstruct{
	dir = 8
	},
/turf/simulated/floor/carpet/red,
/area/map_template/deepmaint)
"ll" = (
/obj/structure/window/reinforced,
/obj/structure/table/woodentable/walnut,
/obj/structure/flora/pottedplant/deskleaf,
/turf/simulated/floor/carpet/blue2,
/area/map_template/deepmaint)
"lK" = (
/turf/simulated/floor,
/area/map_template/deepmaint)
"mm" = (
/turf/simulated/floor/carpet/blue2,
/area/map_template/deepmaint)
"np" = (
/obj/machinery/door/window/brigdoor/southright,
/obj/machinery/light/small{
	dir = 4
	},
/turf/simulated/floor/steel_dirty,
/area/map_template/deepmaint)
"oc" = (
/obj/structure/table/woodentable/walnut,
/obj/structure/window/reinforced,
/obj/item/device/flashlight/lamp,
/turf/simulated/floor/carpet/red,
/area/map_template/deepmaint)
"or" = (
/mob/living/simple_animal/hostile/russian/ranged,
/turf/simulated/floor/wood/walnut,
/area/map_template/deepmaint)
"pF" = (
/obj/structure/table/rack,
/obj/machinery/light/small{
	dir = 1
	},
/obj/random/cash,
/obj/random/cash,
/obj/random/cash,
/obj/random/cash,
/obj/floor_decal/corner/red/mono,
/turf/simulated/floor/tiled/dark/monotile,
/area/map_template/deepmaint)
"pS" = (
/obj/structure/table/woodentable/walnut,
/obj/structure/window/reinforced,
/obj/item/folder/blue,
/turf/simulated/floor/wood/walnut,
/area/map_template/deepmaint)
"qI" = (
/obj/structure/table/rack,
/obj/random/firstaid,
/obj/random/firstaid,
/obj/random/firstaid,
/obj/floor_decal/corner/red/mono,
/turf/simulated/floor/tiled/dark/monotile,
/area/map_template/deepmaint)
"qP" = (
/turf/simulated/floor/carpet/red,
/area/map_template/deepmaint)
"ss" = (
/obj/structure/table/woodentable/walnut,
/obj/item/material/clipboard/plastic,
/obj/item/pen/blue,
/turf/simulated/floor/carpet/red,
/area/map_template/deepmaint)
"sR" = (
/obj/structure/flora/pottedplant/thinbush,
/turf/simulated/floor/wood/walnut,
/area/map_template/deepmaint)
"tf" = (
/obj/structure/table/woodentable/walnut,
/obj/machinery/light,
/obj/item/device/paicard,
/turf/simulated/floor/carpet/red,
/area/map_template/deepmaint)
"tV" = (
/obj/structure/table/woodentable/walnut,
/obj/item/device/camera,
/turf/simulated/floor/carpet/red,
/area/map_template/deepmaint)
"uP" = (
/obj/wallframe_spawn/reinforced,
/turf/simulated/floor,
/area/map_template/deepmaint)
"wK" = (
/obj/structure/table/woodentable/walnut,
/obj/structure/window/reinforced,
/obj/item/material/clipboard/plastic,
/obj/item/folder/blue,
/obj/machinery/light{
	dir = 4
	},
/turf/simulated/floor/carpet/red,
/area/map_template/deepmaint)
"wM" = (
/obj/structure/table/woodentable/walnut,
/obj/structure/window/reinforced{
	dir = 1
	},
/obj/item/paper_bin,
/obj/item/pen/blue,
/obj/machinery/light{
	dir = 8
	},
/turf/simulated/floor/wood/walnut,
/area/map_template/deepmaint)
"xg" = (
/obj/structure/table/rack,
/obj/item/gun/projectile/shotgun/pump,
/obj/machinery/door/window/brigdoor/southleft,
/obj/item/gun/projectile/pistol/military,
/turf/simulated/floor/tiled/dark/monotile,
/area/map_template/deepmaint)
"yQ" = (
/mob/living/simple_animal/hostile/russian/ranged,
/turf/simulated/floor/carpet/blue2,
/area/map_template/deepmaint)
"zy" = (
/obj/structure/table/woodentable/walnut,
/obj/item/device/tape/random,
/obj/item/device/tape/random,
/turf/simulated/floor/carpet/red,
/area/map_template/deepmaint)
"At" = (
/obj/structure/bed/chair/padded/blue,
/turf/simulated/floor/wood/walnut,
/area/map_template/deepmaint)
"AK" = (
/obj/structure/bed/chair/comfy/blue{
	dir = 4
	},
/turf/simulated/floor/carpet/red,
/area/map_template/deepmaint)
"Cs" = (
/obj/structure/flora/pottedplant/minitree,
/turf/simulated/floor/wood/walnut,
/area/map_template/deepmaint)
"Du" = (
/obj/structure/table/woodentable/walnut,
/obj/structure/window/reinforced{
	dir = 1
	},
/turf/simulated/floor/carpet/red,
/area/map_template/deepmaint)
"DI" = (
/obj/machinery/door/airlock/highsecurity,
/obj/floor_decal/corner/red/diagonal,
/turf/simulated/floor/tiled/dark/monotile,
/area/map_template/deepmaint)
"DM" = (
/obj/structure/bed/chair,
/mob/living/simple_animal/hostile/russian,
/turf/simulated/floor/steel_dirty,
/area/map_template/deepmaint)
"Em" = (
/obj/machinery/door/window/northleft,
/turf/simulated/floor/wood/walnut,
/area/map_template/deepmaint)
"Fy" = (
/obj/structure/table/rack,
/obj/item/folder/blue,
/obj/item/folder/blue,
/obj/item/folder/blue,
/obj/item/folder/blue,
/turf/simulated/floor/wood/walnut,
/area/map_template/deepmaint)
"GI" = (
/obj/structure/table/woodentable/walnut,
/obj/item/device/hailer,
/turf/simulated/floor/carpet/red,
/area/map_template/deepmaint)
"Hj" = (
/obj/structure/window/reinforced,
/obj/structure/table/woodentable/walnut,
/obj/item/folder/blue,
/obj/item/crowbar/prybar,
/obj/item/melee/classic_baton,
/turf/simulated/floor/carpet/blue2,
/area/map_template/deepmaint)
"Iz" = (
/obj/structure/table/rack,
/obj/random/backpack,
/obj/floor_decal/corner/red/mono,
/turf/simulated/floor/tiled/dark/monotile,
/area/map_template/deepmaint)
"Jl" = (
/turf/simulated/wall,
/area/map_template/deepmaint)
"Js" = (
/obj/floor_decal/corner/red/diagonal,
/turf/simulated/floor/tiled/dark,
/area/map_template/deepmaint)
"Jt" = (
/obj/machinery/papershredder,
/turf/simulated/floor/wood/walnut,
/area/map_template/deepmaint)
"Ju" = (
/obj/structure/table/rack,
/obj/random/ammo,
/obj/random/ammo,
/obj/random/ammo,
/obj/random/ammo,
/obj/floor_decal/corner/red/mono,
/turf/simulated/floor/tiled/dark/monotile,
/area/map_template/deepmaint)
"Kn" = (
/obj/machinery/door/window/southleft,
/turf/simulated/floor/wood/walnut,
/area/map_template/deepmaint)
"KN" = (
/obj/structure/table/woodentable/walnut,
/obj/item/flame/lighter/zippo/gunmetal,
/obj/item/material/ashtray/glass,
/turf/simulated/floor/carpet/blue2,
/area/map_template/deepmaint)
"Mo" = (
/obj/wallframe_spawn/reinforced/bare,
/turf/simulated/floor,
/area/map_template/deepmaint)
"Nj" = (
/obj/structure/table/woodentable/walnut,
/obj/item/folder/blue,
/turf/simulated/floor/carpet/blue2,
/area/map_template/deepmaint)
"ND" = (
/obj/structure/table/rack,
/obj/item/storage/briefcase/crimekit,
/obj/item/crowbar/prybar,
/turf/simulated/floor/wood/walnut,
/area/map_template/deepmaint)
"NH" = (
/obj/structure/table/woodentable/walnut,
/turf/simulated/floor/carpet/red,
/area/map_template/deepmaint)
"NS" = (
/obj/structure/table/woodentable/walnut,
/obj/structure/window/reinforced{
	dir = 1
	},
/obj/item/hand_labeler,
/turf/simulated/floor/wood/walnut,
/area/map_template/deepmaint)
"Op" = (
/obj/structure/table/woodentable/walnut,
/obj/item/paper_bin,
/obj/item/pen/blue,
/turf/simulated/floor/carpet/blue2,
/area/map_template/deepmaint)
"OA" = (
/obj/machinery/door/window/brigdoor/southright,
/obj/structure/table/rack,
/obj/item/ammo_magazine/pistol/double,
/obj/item/ammo_magazine/pistol/double,
/obj/item/ammo_magazine/pistol/double/rubber,
/obj/item/ammo_magazine/pistol/double/rubber,
/obj/item/storage/box/ammo/stunshells,
/obj/item/storage/box/ammo/shotgunshells,
/obj/item/storage/box/ammo/beanbags,
/obj/item/storage/box/ammo/shotgunammo,
/obj/item/clothing/suit/armor/vest/old/security,
/turf/simulated/floor/tiled/dark/monotile,
/area/map_template/deepmaint)
"PV" = (
/obj/decal/cleanable/blood,
/turf/simulated/floor/carpet/blue2,
/area/map_template/deepmaint)
"Rc" = (
/obj/structure/table/woodentable/walnut,
/obj/structure/window/reinforced{
	dir = 1
	},
/obj/item/folder/blue,
/obj/machinery/light{
	dir = 4
	},
/turf/simulated/floor/carpet/red,
/area/map_template/deepmaint)
"Sc" = (
/obj/structure/filingcabinet/chestdrawer,
/turf/simulated/floor/wood/walnut,
/area/map_template/deepmaint)
"TZ" = (
/obj/structure/bed/chair/comfy/blue{
	dir = 4
	},
/obj/landmark/corpse/commander,
/obj/machinery/light{
	dir = 8
	},
/turf/simulated/floor/carpet/blue2,
/area/map_template/deepmaint)
"Ue" = (
/obj/structure/bed/chair/comfy/blue,
/turf/simulated/floor/carpet/red,
/area/map_template/deepmaint)
"WM" = (
/obj/machinery/photocopier,
/obj/structure/filingcabinet/chestdrawer,
/turf/simulated/floor/wood/walnut,
/area/map_template/deepmaint)
"XO" = (
/obj/structure/table/woodentable/walnut,
/obj/item/paper_bin,
/obj/item/pen/blue,
/turf/simulated/floor/carpet/red,
/area/map_template/deepmaint)
"Yc" = (
/obj/structure/table/woodentable/walnut,
/obj/machinery/light{
	dir = 1
	},
/obj/item/device/taperecorder,
/turf/simulated/floor/carpet/red,
/area/map_template/deepmaint)
"YJ" = (
/obj/structure/bed/chair/padded/blue{
	dir = 4
	},
/turf/simulated/floor/wood/walnut,
/area/map_template/deepmaint)
"ZB" = (
/obj/structure/table/rack,
/obj/machinery/light/small{
	dir = 1
	},
/obj/random/energy,
/obj/random/handgun,
/obj/floor_decal/corner/red/mono,
/turf/simulated/floor/tiled/dark/monotile,
/area/map_template/deepmaint)
"ZG" = (
/turf/simulated/floor/wood/walnut,
/area/map_template/deepmaint)

(1,1,1) = {"
lK
lK
lK
lK
lK
lK
lK
lK
lK
lK
lK
lK
lK
lK
lK
"}
(2,1,1) = {"
lK
Jl
Jl
Jl
Jl
Jl
Jl
Jl
Jl
Jl
Jl
Jl
Jl
Jl
lK
"}
(3,1,1) = {"
lK
Jl
ZB
Js
Iz
Jl
xg
dJ
fQ
iR
PV
TZ
mm
Jl
lK
"}
(4,1,1) = {"
lK
Jl
Ju
Js
fU
Jl
OA
ZG
Hj
iR
Op
Nj
KN
Jl
lK
"}
(5,1,1) = {"
lK
Jl
qI
Js
Jl
Jl
Jl
ZG
ll
iR
yQ
jp
mm
Jl
lK
"}
(6,1,1) = {"
lK
Jl
pF
Js
Jl
DM
np
ZG
ZG
ZG
ZG
ZG
ZG
Jl
lK
"}
(7,1,1) = {"
lK
Jl
Jl
DI
Jl
Jl
Jl
Jl
Jl
Jl
Mo
kp
Mo
Jl
lK
"}
(8,1,1) = {"
lK
Jl
Fy
ZG
ZG
dG
YJ
YJ
YJ
wM
ZG
or
Sc
Jl
lK
"}
(9,1,1) = {"
lK
Jl
Fy
ZG
dT
pS
ZG
ZG
ZG
NS
ZG
ZG
WM
Jl
lK
"}
(10,1,1) = {"
lK
Jl
ND
ZG
ZG
Kn
ZG
ZG
ZG
Em
ZG
ZG
Jt
Jl
lK
"}
(11,1,1) = {"
lK
Jl
Yc
qP
qP
oc
ZG
ZG
ZG
Du
qP
qP
tf
Jl
lK
"}
(12,1,1) = {"
lK
Jl
zy
qP
Ue
XO
ZG
ZG
At
NH
AK
qP
GI
Jl
lK
"}
(13,1,1) = {"
lK
Jl
tV
NH
kv
wK
sR
ZG
Cs
Rc
kv
ss
fN
Jl
lK
"}
(14,1,1) = {"
lK
Jl
Jl
Jl
Jl
Jl
uP
ku
uP
Jl
Jl
Jl
Jl
Jl
lK
"}
(15,1,1) = {"
lK
lK
lK
lK
lK
lK
lK
lK
lK
lK
lK
lK
lK
lK
lK
"}
