//MAP CONVERTED BY dmm2tgm.py THIS HEADER COMMENT PREVENTS RECONVERSION, DO NOT REMOVE
"cD" = (
/obj/structure/table/steel_reinforced,
/obj/random/snack,
/turf/simulated/floor/carpet,
/area/map_template/deepmaint)
"cF" = (
/obj/floor_decal/industrial/warning,
/obj/item/ammo_casing/pistol/used,
/turf/simulated/floor/shuttle/darkred,
/area/map_template/deepmaint)
"dh" = (
/turf/simulated/floor,
/area/map_template/deepmaint)
"dW" = (
/obj/floor_decal/industrial/warning,
/turf/simulated/floor/shuttle/darkred,
/area/map_template/deepmaint)
"fo" = (
/obj/item/ammo_casing/pistol/used,
/obj/item/ammo_casing/pistol/used,
/obj/item/ammo_casing/pistol/used,
/obj/floor_decal/industrial/warning/corner,
/turf/simulated/floor/shuttle/darkred,
/area/map_template/deepmaint)
"fL" = (
/obj/structure/table/rack,
/obj/random/clothing,
/obj/random/clothing,
/obj/random/clothing,
/obj/random/clothing,
/turf/simulated/floor/shuttle/darkred,
/area/map_template/deepmaint)
"gb" = (
/obj/item/stool/bar/padded,
/turf/simulated/floor/carpet,
/area/map_template/deepmaint)
"gP" = (
/turf/simulated/floor/shuttle/darkred,
/area/map_template/deepmaint)
"hv" = (
/obj/floor_decal/industrial/warning{
	dir = 4
	},
/obj/machinery/vending/sovietsoda{
	dir = 4
	},
/obj/machinery/light/spot{
	dir = 8
	},
/turf/simulated/floor/shuttle/darkred,
/area/map_template/deepmaint)
"hM" = (
/obj/structure/table/gamblingtable,
/obj/item/deck/cards{
	pixel_x = 5;
	pixel_y = -5
	},
/turf/simulated/floor/carpet,
/area/map_template/deepmaint)
"ik" = (
/obj/floor_decal/industrial/warning{
	dir = 4
	},
/obj/machinery/vending/weeb{
	dir = 4
	},
/turf/simulated/floor/shuttle/darkred,
/area/map_template/deepmaint)
"iI" = (
/obj/item/ammo_casing/pistol/used,
/turf/simulated/floor/wood/mahogany,
/area/map_template/deepmaint)
"jI" = (
/obj/structure/table/gamblingtable,
/obj/random/coin,
/obj/random/coin,
/obj/random/coin,
/obj/random/coin,
/turf/simulated/floor/carpet,
/area/map_template/deepmaint)
"jM" = (
/obj/item/ammo_casing/pistol/used,
/mob/living/simple_animal/hostile/viscerator,
/turf/simulated/floor/wood/mahogany,
/area/map_template/deepmaint)
"kj" = (
/obj/item/stock_parts/circuitboard/broken,
/turf/simulated/floor/wood/mahogany,
/area/map_template/deepmaint)
"lf" = (
/obj/structure/table/gamblingtable,
/obj/item/clothing/mask/smokable/cigarette/cigar/havana,
/obj/item/material/ashtray/bronze,
/obj/random/single/playing_cards,
/turf/simulated/floor/carpet,
/area/map_template/deepmaint)
"lF" = (
/obj/floor_decal/industrial/warning{
	dir = 4
	},
/obj/machinery/vending/snix{
	dir = 4
	},
/turf/simulated/floor/shuttle/darkred,
/area/map_template/deepmaint)
"mS" = (
/mob/living/simple_animal/hostile/viscerator,
/turf/simulated/floor/wood/mahogany,
/area/map_template/deepmaint)
"pl" = (
/obj/random/drinkbottle,
/turf/simulated/floor/wood/mahogany,
/area/map_template/deepmaint)
"py" = (
/obj/random/junk,
/turf/simulated/floor/wood/mahogany,
/area/map_template/deepmaint)
"qU" = (
/obj/random/trash,
/turf/simulated/floor/wood/mahogany,
/area/map_template/deepmaint)
"rd" = (
/turf/simulated/floor/carpet,
/area/map_template/deepmaint)
"ru" = (
/obj/item/ammo_casing/pistol/used,
/obj/item/ammo_casing/pistol/used,
/obj/floor_decal/industrial/warning{
	dir = 10
	},
/turf/simulated/floor/shuttle/darkred,
/area/map_template/deepmaint)
"sm" = (
/obj/item/trash/cigbutt/cigarbutt,
/turf/simulated/floor/wood/mahogany,
/area/map_template/deepmaint)
"ur" = (
/obj/floor_decal/industrial/warning{
	dir = 8
	},
/obj/machinery/vending/cigarette{
	dir = 8
	},
/turf/simulated/floor/shuttle/darkred,
/area/map_template/deepmaint)
"vl" = (
/turf/simulated/wall,
/area/map_template/deepmaint)
"vp" = (
/obj/gibspawner/human,
/turf/simulated/floor/wood/mahogany,
/area/map_template/deepmaint)
"wH" = (
/obj/item/material/shard/shrapnel/steel,
/turf/simulated/floor/wood/mahogany,
/area/map_template/deepmaint)
"xL" = (
/obj/floor_decal/industrial/warning/corner{
	dir = 8
	},
/turf/simulated/floor/shuttle/darkred,
/area/map_template/deepmaint)
"yl" = (
/obj/random/cash,
/turf/simulated/floor/wood/mahogany,
/area/map_template/deepmaint)
"zs" = (
/obj/structure/table/gamblingtable,
/obj/random/cash,
/obj/random/cash,
/turf/simulated/floor/carpet,
/area/map_template/deepmaint)
"zL" = (
/obj/floor_decal/industrial/warning{
	dir = 8
	},
/obj/machinery/vending/hotfood{
	dir = 8
	},
/turf/simulated/floor/shuttle/darkred,
/area/map_template/deepmaint)
"Cr" = (
/obj/item/material/shard,
/turf/simulated/floor/wood/mahogany,
/area/map_template/deepmaint)
"DH" = (
/obj/item/ammo_casing/pistol/used,
/obj/random/cash,
/mob/living/simple_animal/hostile/viscerator,
/turf/simulated/floor/wood/mahogany,
/area/map_template/deepmaint)
"Ex" = (
/obj/item/stool/bar/padded,
/obj/floor_decal/industrial/warning,
/turf/simulated/floor/carpet,
/area/map_template/deepmaint)
"Fz" = (
/obj/decal/cleanable/blood/splatter,
/obj/item/bananapeel,
/turf/simulated/floor/wood/mahogany,
/area/map_template/deepmaint)
"Gs" = (
/obj/floor_decal/industrial/warning{
	dir = 8
	},
/obj/machinery/vending/snack{
	dir = 8
	},
/obj/machinery/light/spot{
	dir = 4
	},
/turf/simulated/floor/shuttle/darkred,
/area/map_template/deepmaint)
"Gw" = (
/obj/structure/table/gamblingtable,
/obj/random/handgun,
/turf/simulated/floor/carpet,
/area/map_template/deepmaint)
"Hr" = (
/obj/decal/cleanable/blood/splatter,
/obj/floor_decal/industrial/warning{
	dir = 9;
	icon_state = "warning"
	},
/obj/item/ammo_casing/pistol/used,
/turf/simulated/floor/shuttle/darkred,
/area/map_template/deepmaint)
"HF" = (
/obj/item/ammo_casing/pistol/used,
/obj/item/ammo_casing/pistol/used,
/obj/floor_decal/industrial/warning{
	dir = 5
	},
/turf/simulated/floor/shuttle/darkred,
/area/map_template/deepmaint)
"HN" = (
/obj/decal/cleanable/blood/splatter,
/obj/item/stool/bar/padded,
/obj/item/ammo_casing/pistol/used,
/turf/simulated/floor/carpet,
/area/map_template/deepmaint)
"HQ" = (
/obj/item/ammo_casing/pistol/used,
/obj/item/ammo_casing/pistol/used,
/obj/item/ammo_casing/pistol/used,
/turf/simulated/floor/wood/mahogany,
/area/map_template/deepmaint)
"Jk" = (
/obj/decal/cleanable/generic,
/obj/item/trash/cigbutt/jerichos,
/obj/floor_decal/industrial/warning{
	dir = 8
	},
/obj/machinery/light/spot{
	dir = 4
	},
/turf/simulated/floor/shuttle/darkred,
/area/map_template/deepmaint)
"JE" = (
/obj/floor_decal/industrial/warning/corner{
	dir = 1
	},
/turf/simulated/floor/shuttle/darkred,
/area/map_template/deepmaint)
"JP" = (
/obj/decal/cleanable/liquid_fuel,
/obj/floor_decal/industrial/warning/corner{
	dir = 4
	},
/turf/simulated/floor/shuttle/darkred,
/area/map_template/deepmaint)
"Kv" = (
/obj/machinery/light/spot,
/turf/simulated/floor/wood/mahogany,
/area/map_template/deepmaint)
"Ky" = (
/obj/machinery/door/unpowered/simple/mahogany,
/turf/simulated/floor/wood/mahogany,
/area/map_template/deepmaint)
"LJ" = (
/obj/decal/cleanable/blood/splatter,
/obj/floor_decal/industrial/warning,
/turf/simulated/floor/shuttle/darkred,
/area/map_template/deepmaint)
"MB" = (
/obj/random/trash,
/mob/living/simple_animal/hostile/viscerator,
/turf/simulated/floor/wood/mahogany,
/area/map_template/deepmaint)
"MO" = (
/obj/floor_decal/industrial/warning{
	dir = 6
	},
/obj/structure/closet/crate/trashcart,
/mob/living/simple_animal/hostile/retaliate/parrot,
/turf/simulated/floor/shuttle/darkred,
/area/map_template/deepmaint)
"Ng" = (
/obj/decal/cleanable/blood/splatter,
/turf/simulated/floor/wood/mahogany,
/area/map_template/deepmaint)
"Nw" = (
/obj/decal/cleanable/liquid_fuel,
/obj/floor_decal/industrial/warning{
	dir = 4
	},
/obj/machinery/light/spot{
	dir = 8
	},
/turf/simulated/floor/shuttle/darkred,
/area/map_template/deepmaint)
"Oh" = (
/obj/decal/cleanable/blood/splatter,
/obj/item/ammo_casing/pistol/used,
/obj/item/ammo_casing/pistol/used,
/obj/item/ammo_casing/pistol/used,
/turf/simulated/floor/carpet,
/area/map_template/deepmaint)
"Oy" = (
/obj/structure/bed/chair/comfy/black,
/obj/item/ammo_casing/pistol/used,
/obj/item/ammo_casing/pistol/used,
/obj/item/ammo_casing/pistol/used,
/turf/simulated/floor/carpet,
/area/map_template/deepmaint)
"OZ" = (
/turf/simulated/floor/wood/mahogany,
/area/map_template/deepmaint)
"Pp" = (
/obj/structure/table/gamblingtable,
/obj/item/trash/cigbutt/cigarbutt,
/obj/random/single/lighter,
/turf/simulated/floor/carpet,
/area/map_template/deepmaint)
"Pt" = (
/obj/floor_decal/industrial/warning/corner,
/turf/simulated/floor/shuttle/darkred,
/area/map_template/deepmaint)
"PY" = (
/obj/item/dice/d4,
/turf/simulated/floor/carpet,
/area/map_template/deepmaint)
"Qx" = (
/obj/decal/cleanable/generic,
/turf/simulated/floor/wood/mahogany,
/area/map_template/deepmaint)
"Rn" = (
/obj/structure/synthesized_instrument/synthesizer/piano,
/turf/simulated/floor/carpet,
/area/map_template/deepmaint)
"St" = (
/obj/item/trash/cigbutt/jerichos,
/obj/floor_decal/industrial/warning{
	dir = 4
	},
/turf/simulated/floor/shuttle/darkred,
/area/map_template/deepmaint)
"Sv" = (
/obj/landmark/corpse/commander,
/turf/simulated/floor/wood/mahogany,
/area/map_template/deepmaint)
"Sz" = (
/obj/item/stool/bar/padded,
/obj/decal/cleanable/generic,
/turf/simulated/floor/carpet,
/area/map_template/deepmaint)
"Wd" = (
/obj/structure/table/steel_reinforced,
/obj/random/lilgun,
/turf/simulated/floor/carpet,
/area/map_template/deepmaint)
"Wq" = (
/obj/structure/table/gamblingtable,
/turf/simulated/floor/carpet,
/area/map_template/deepmaint)
"XK" = (
/obj/structure/table/gamblingtable,
/obj/item/dice,
/turf/simulated/floor/carpet,
/area/map_template/deepmaint)
"XP" = (
/obj/item/ammo_casing/pistol/used,
/obj/item/ammo_casing/pistol/used,
/turf/simulated/floor/shuttle/darkred,
/area/map_template/deepmaint)
"Zh" = (
/obj/floor_decal/industrial/warning,
/obj/machinery/light/spot{
	dir = 1
	},
/turf/simulated/floor/shuttle/darkred,
/area/map_template/deepmaint)
"ZH" = (
/obj/floor_decal/industrial/warning{
	dir = 8
	},
/obj/structure/table/rack,
/obj/random/clothing,
/obj/random/clothing,
/obj/random/clothing,
/turf/simulated/floor/shuttle/darkred,
/area/map_template/deepmaint)

(1,1,1) = {"
dh
dh
dh
dh
dh
dh
dh
dh
dh
dh
dh
dh
dh
dh
dh
"}
(2,1,1) = {"
dh
vl
vl
vl
vl
vl
vl
vl
vl
vl
vl
vl
vl
vl
dh
"}
(3,1,1) = {"
dh
vl
gP
fo
hv
ik
zs
XK
Wq
lF
Nw
JP
XP
vl
dh
"}
(4,1,1) = {"
dh
vl
Pt
MO
OZ
Qx
rd
rd
PY
Fz
Cr
HF
St
vl
dh
"}
(5,1,1) = {"
dh
vl
cF
OZ
OZ
mS
Ng
OZ
OZ
OZ
vp
rd
Rn
vl
dh
"}
(6,1,1) = {"
dh
vl
dW
Ex
gb
OZ
Ng
Ng
qU
iI
py
rd
gb
vl
dh
"}
(7,1,1) = {"
dh
vl
Zh
Gw
jI
gb
jM
OZ
iI
OZ
OZ
OZ
Kv
vl
dh
"}
(8,1,1) = {"
dh
vl
LJ
Oy
hM
gb
OZ
wH
OZ
mS
OZ
OZ
OZ
Ky
dh
"}
(9,1,1) = {"
dh
vl
Zh
lf
Pp
gb
OZ
OZ
OZ
OZ
sm
OZ
Kv
vl
dh
"}
(10,1,1) = {"
dh
vl
dW
gb
Sz
OZ
Sv
OZ
Ng
Ng
OZ
cD
Wd
vl
dh
"}
(11,1,1) = {"
dh
vl
dW
MB
DH
yl
OZ
Ng
Ng
iI
pl
Oh
HN
vl
dh
"}
(12,1,1) = {"
dh
vl
xL
ru
HQ
Cr
rd
rd
rd
kj
wH
Hr
ZH
vl
dh
"}
(13,1,1) = {"
dh
vl
gP
xL
Gs
zL
XK
zs
Gw
ur
Jk
JE
fL
vl
dh
"}
(14,1,1) = {"
dh
vl
vl
vl
vl
vl
vl
vl
vl
vl
vl
vl
vl
vl
dh
"}
(15,1,1) = {"
dh
dh
dh
dh
dh
dh
dh
dh
dh
dh
dh
dh
dh
dh
dh
"}
