//MAP CONVERTED BY dmm2tgm.py THIS HEADER COMMENT PREVENTS RECONVERSION, DO NOT REMOVE
"a" = (
/turf/simulated/wall,
/area/map_template/deepmaint)
"b" = (
/obj/machinery/light/spot{
	dir = 4
	},
/turf/simulated/floor/exoplanet/grass,
/area/map_template/deepmaint)
"c" = (
/obj/structure/fireaxecabinet{
	pixel_x = -32
	},
/turf/simulated/floor/diona,
/area/map_template/deepmaint)
"d" = (
/obj/structure/flora/ausbushes/sunnybush,
/turf/simulated/floor/diona,
/area/map_template/deepmaint)
"e" = (
/obj/structure/diona_gestalt,
/turf/simulated/floor/exoplanet/grass,
/area/map_template/deepmaint)
"g" = (
/turf/simulated/floor,
/area/map_template/deepmaint)
"h" = (
/obj/structure/flora/ausbushes/fullgrass,
/mob/living/simple_animal/hostile/retaliate/goat/guard,
/turf/simulated/floor/exoplanet/grass,
/area/map_template/deepmaint)
"i" = (
/obj/structure/fireaxecabinet{
	pixel_x = 32
	},
/turf/simulated/floor/exoplanet/grass,
/area/map_template/deepmaint)
"j" = (
/mob/living/simple_animal/hostile/retaliate/goat/guard,
/turf/simulated/floor/exoplanet/grass,
/area/map_template/deepmaint)
"n" = (
/obj/structure/flora/ausbushes/leafybush,
/turf/simulated/floor/diona,
/area/map_template/deepmaint)
"q" = (
/obj/structure/flora/ausbushes/stalkybush,
/turf/simulated/floor/diona,
/area/map_template/deepmaint)
"t" = (
/obj/structure/flora/ausbushes/grassybush,
/mob/living/simple_animal/hostile/retaliate/goose,
/turf/simulated/floor/exoplanet/grass,
/area/map_template/deepmaint)
"x" = (
/obj/structure/flora/ausbushes/fullgrass,
/turf/simulated/floor/exoplanet/grass,
/area/map_template/deepmaint)
"y" = (
/mob/living/simple_animal/hostile/retaliate/goose,
/turf/simulated/floor/diona,
/area/map_template/deepmaint)
"B" = (
/obj/structure/flora/ausbushes/fernybush,
/turf/simulated/floor/diona,
/area/map_template/deepmaint)
"C" = (
/mob/living/simple_animal/hostile/retaliate/goose,
/turf/simulated/floor/exoplanet/grass,
/area/map_template/deepmaint)
"D" = (
/obj/structure/flora/ausbushes/stalkybush,
/turf/simulated/floor/exoplanet/grass,
/area/map_template/deepmaint)
"E" = (
/obj/machinery/light/spot{
	dir = 1
	},
/turf/simulated/floor/exoplanet/grass,
/area/map_template/deepmaint)
"G" = (
/obj/machinery/door/airlock/glass/virology,
/turf/simulated/floor/diona,
/area/map_template/deepmaint)
"J" = (
/turf/simulated/floor/diona,
/area/map_template/deepmaint)
"K" = (
/obj/structure/flora/ausbushes/sunnybush,
/turf/simulated/floor/exoplanet/grass,
/area/map_template/deepmaint)
"L" = (
/obj/structure/flora/ausbushes/grassybush,
/turf/simulated/floor/exoplanet/grass,
/area/map_template/deepmaint)
"M" = (
/turf/simulated/floor/exoplanet/grass,
/area/map_template/deepmaint)
"N" = (
/obj/structure/flora/ausbushes/lavendergrass,
/turf/simulated/floor/exoplanet/grass,
/area/map_template/deepmaint)
"Q" = (
/obj/wallframe_spawn/reinforced/bare,
/turf/simulated/floor,
/area/map_template/deepmaint)
"S" = (
/obj/structure/flora/ausbushes/ppflowers,
/turf/simulated/floor/exoplanet/grass,
/area/map_template/deepmaint)
"T" = (
/obj/machinery/light/spot,
/turf/simulated/floor/exoplanet/grass,
/area/map_template/deepmaint)
"Y" = (
/obj/machinery/light/spot{
	dir = 8
	},
/turf/simulated/floor/exoplanet/grass,
/area/map_template/deepmaint)
"Z" = (
/obj/structure/pit/closed/grave,
/obj/structure/gravemarker/random,
/turf/simulated/floor/exoplanet/grass,
/area/map_template/deepmaint)

(1,1,1) = {"
g
g
g
g
g
g
g
g
g
g
g
g
g
g
g
"}
(2,1,1) = {"
g
a
a
a
a
a
a
a
a
a
a
a
a
a
g
"}
(3,1,1) = {"
g
a
M
t
M
M
M
e
M
M
M
M
M
a
g
"}
(4,1,1) = {"
g
a
M
Z
M
L
M
M
S
M
q
D
M
a
g
"}
(5,1,1) = {"
g
a
M
M
M
b
N
M
M
M
J
M
C
a
g
"}
(6,1,1) = {"
g
a
Q
Q
Q
a
E
C
d
J
J
K
T
a
g
"}
(7,1,1) = {"
g
c
J
M
M
Q
M
J
J
M
M
j
M
a
g
"}
(8,1,1) = {"
g
J
J
J
J
G
J
J
n
J
J
M
M
a
g
"}
(9,1,1) = {"
g
i
J
M
J
Q
M
J
J
J
N
M
M
a
g
"}
(10,1,1) = {"
g
a
Q
Q
Q
a
E
M
M
J
B
M
T
a
g
"}
(11,1,1) = {"
g
a
J
K
M
Y
M
S
S
M
J
J
M
a
g
"}
(12,1,1) = {"
g
a
J
J
h
J
M
M
M
e
x
y
J
a
g
"}
(13,1,1) = {"
g
a
J
J
C
J
J
M
M
M
x
M
M
a
g
"}
(14,1,1) = {"
g
a
a
a
a
a
a
a
a
a
a
a
a
a
g
"}
(15,1,1) = {"
g
g
g
g
g
g
g
g
g
g
g
g
g
g
g
"}
