//MAP CONVERTED BY dmm2tgm.py THIS HEADER COMMENT PREVENTS RECONVERSION, DO NOT REMOVE
"a" = (
/obj/machinery/door/blast/regular{
	id_tag = "deepmaints_med"
	},
/turf/simulated/floor/tiled/white,
/area/map_template/deepmaint)
"e" = (
/obj/effect/wallframe_spawn/reinforced/no_grille,
/obj/machinery/door/blast/regular{
	id_tag = "deepmaints_med"
	},
/turf/simulated/floor/plating,
/area/map_template/deepmaint)
"f" = (
/obj/effect/floor_decal/corner/blue{
	dir = 6
	},
/obj/machinery/body_scanconsole{
	dir = 4
	},
/obj/machinery/light/small,
/turf/simulated/floor/tiled/white,
/area/map_template/deepmaint)
"g" = (
/obj/effect/floor_decal/floordetail/edgedrain{
	dir = 10
	},
/turf/simulated/floor/tiled/white,
/area/map_template/deepmaint)
"h" = (
/obj/effect/floor_decal/floordetail/edgedrain{
	dir = 4
	},
/turf/simulated/floor/tiled/white,
/area/map_template/deepmaint)
"i" = (
/obj/effect/floor_decal/industrial/warning,
/turf/simulated/floor/tiled/white,
/area/map_template/deepmaint)
"j" = (
/obj/structure/closet/crate/med_crate/toxin,
/obj/effect/floor_decal/corner/blue/mono,
/turf/simulated/floor/tiled/white/monotile,
/area/map_template/deepmaint)
"k" = (
/obj/effect/floor_decal/corner/blue/mono,
/turf/simulated/floor/tiled/white/monotile,
/area/map_template/deepmaint)
"l" = (
/obj/effect/floor_decal/floordetail/edgedrain{
	dir = 9
	},
/turf/simulated/floor/tiled/white,
/area/map_template/deepmaint)
"m" = (
/obj/structure/barricade/spike{
	dir = 4
	},
/obj/effect/floor_decal/industrial/warning/corner{
	dir = 4
	},
/turf/simulated/floor/tiled/white,
/area/map_template/deepmaint)
"p" = (
/obj/effect/floor_decal/corner/blue/mono,
/obj/machinery/bodyscanner{
	dir = 8
	},
/turf/simulated/floor/tiled/white/monotile,
/area/map_template/deepmaint)
"q" = (
/obj/effect/floor_decal/industrial/warning{
	dir = 1
	},
/obj/machinery/button/blast_door{
	id_tag = "deepmaints_med";
	pixel_y = -25
	},
/turf/simulated/floor/tiled/white,
/area/map_template/deepmaint)
"r" = (
/obj/effect/floor_decal/corner/blue{
	dir = 5
	},
/mob/living/simple_animal/passive/mouse/brown/Tom,
/turf/simulated/floor/tiled/white,
/area/map_template/deepmaint)
"s" = (
/obj/structure/closet/crate/med_crate/burn,
/obj/effect/floor_decal/corner/blue/mono,
/turf/simulated/floor/tiled/white/monotile,
/area/map_template/deepmaint)
"t" = (
/obj/effect/floor_decal/floordetail/edgedrain,
/turf/simulated/floor/tiled/white,
/area/map_template/deepmaint)
"u" = (
/obj/machinery/vending/medical{
	dir = 1;
	req_access = null
	},
/obj/effect/floor_decal/corner/blue/mono,
/obj/effect/floor_decal/industrial/warning/corner,
/turf/simulated/floor/tiled/white/monotile,
/area/map_template/deepmaint)
"y" = (
/obj/effect/floor_decal/corner/blue/mono,
/obj/machinery/bodyscanner{
	dir = 4
	},
/turf/simulated/floor/tiled/white/monotile,
/area/map_template/deepmaint)
"A" = (
/obj/effect/floor_decal/floordetail/edgedrain{
	dir = 6
	},
/turf/simulated/floor/tiled/white,
/area/map_template/deepmaint)
"B" = (
/obj/item/storage/firstaid/surgery,
/obj/structure/table/standard,
/obj/effect/floor_decal/corner/blue/mono,
/turf/simulated/floor/tiled/white/monotile,
/area/map_template/deepmaint)
"C" = (
/obj/effect/floor_decal/corner/blue{
	dir = 9
	},
/obj/machinery/body_scanconsole{
	dir = 8
	},
/obj/machinery/light/small,
/turf/simulated/floor/tiled/white,
/area/map_template/deepmaint)
"D" = (
/obj/effect/wallframe_spawn/reinforced/no_grille,
/obj/machinery/door/blast/regular{
	dir = 4;
	id_tag = "deepmaints_med"
	},
/turf/simulated/floor/plating,
/area/map_template/deepmaint)
"E" = (
/obj/effect/floor_decal/corner/blue{
	dir = 10
	},
/obj/effect/floor_decal/floordetail/edgedrain{
	dir = 1
	},
/turf/simulated/floor/tiled/white,
/area/map_template/deepmaint)
"F" = (
/turf/simulated/wall/r_wall,
/area/map_template/deepmaint)
"G" = (
/obj/structure/iv_drip,
/obj/effect/floor_decal/corner/blue/mono,
/turf/simulated/floor/tiled/white/monotile,
/area/map_template/deepmaint)
"H" = (
/obj/machinery/light/small{
	dir = 1
	},
/turf/simulated/floor/tiled/white,
/area/map_template/deepmaint)
"J" = (
/obj/machinery/optable,
/obj/effect/floor_decal/corner/blue/mono,
/obj/machinery/light/small/red{
	dir = 1
	},
/turf/simulated/floor/tiled/white/monotile,
/area/map_template/deepmaint)
"K" = (
/obj/structure/closet/crate/med_crate/trauma,
/obj/effect/floor_decal/corner/blue/mono,
/obj/machinery/light/small{
	dir = 4
	},
/turf/simulated/floor/tiled/white/monotile,
/area/map_template/deepmaint)
"L" = (
/obj/structure/table/standard,
/obj/item/reagent_containers/spray/cleaner{
	pixel_x = -5
	},
/obj/item/reagent_containers/spray/sterilizine,
/obj/machinery/vending/wallmed1{
	pixel_y = 32
	},
/obj/item/reagent_containers/dropper/peridaxon,
/obj/effect/floor_decal/corner/blue/mono,
/turf/simulated/floor/tiled/white/monotile,
/area/map_template/deepmaint)
"N" = (
/obj/structure/table/standard,
/obj/item/reagent_containers/chem_disp_cartridge/rezadone,
/obj/effect/floor_decal/corner/blue/mono,
/obj/machinery/button/blast_door{
	id_tag = "deepmaints_med";
	pixel_y = -25
	},
/obj/effect/floor_decal/industrial/warning/corner{
	dir = 8
	},
/turf/simulated/floor/tiled/white/monotile,
/area/map_template/deepmaint)
"O" = (
/turf/simulated/floor/tiled/white,
/area/map_template/deepmaint)
"P" = (
/obj/effect/floor_decal/floordetail/edgedrain{
	dir = 1
	},
/turf/simulated/floor/tiled/white,
/area/map_template/deepmaint)
"Q" = (
/obj/structure/barricade/spike{
	dir = 4
	},
/obj/effect/floor_decal/industrial/warning/corner{
	dir = 1
	},
/turf/simulated/floor/tiled/white,
/area/map_template/deepmaint)
"R" = (
/obj/effect/floor_decal/floordetail/edgedrain{
	dir = 8
	},
/turf/simulated/floor/tiled/white,
/area/map_template/deepmaint)
"S" = (
/obj/effect/floor_decal/floordetail/edgedrain{
	dir = 5
	},
/turf/simulated/floor/tiled/white,
/area/map_template/deepmaint)
"T" = (
/obj/effect/floor_decal/corner/blue{
	dir = 9
	},
/obj/effect/floor_decal/floordetail/edgedrain{
	dir = 4
	},
/turf/simulated/floor/tiled/white,
/area/map_template/deepmaint)
"X" = (
/obj/effect/floor_decal/corner/blue{
	dir = 6
	},
/obj/effect/floor_decal/floordetail/edgedrain{
	dir = 8
	},
/turf/simulated/floor/tiled/white,
/area/map_template/deepmaint)
"Y" = (
/obj/structure/closet/crate/med_crate/oxyloss,
/obj/effect/floor_decal/corner/blue/mono,
/obj/machinery/light/small{
	dir = 8
	},
/turf/simulated/floor/tiled/white/monotile,
/area/map_template/deepmaint)
"Z" = (
/turf/simulated/floor/tiled/dark,
/area/map_template/deepmaint)

(1,1,1) = {"
Z
Z
Z
Z
Z
Z
Z
Z
Z
Z
Z
"}
(2,1,1) = {"
Z
l
R
R
X
X
X
R
R
g
Z
"}
(3,1,1) = {"
Z
P
F
F
K
s
K
F
O
t
Z
"}
(4,1,1) = {"
Z
P
f
F
F
D
F
F
H
A
Z
"}
(5,1,1) = {"
Z
E
y
F
J
k
u
F
m
F
Z
"}
(6,1,1) = {"
Z
E
k
e
B
r
i
a
q
F
Z
"}
(7,1,1) = {"
Z
E
p
F
L
G
N
F
Q
F
Z
"}
(8,1,1) = {"
Z
P
C
F
F
D
F
F
H
g
Z
"}
(9,1,1) = {"
Z
P
F
F
Y
j
Y
F
O
t
Z
"}
(10,1,1) = {"
Z
S
h
h
T
T
T
h
h
A
Z
"}
(11,1,1) = {"
Z
Z
Z
Z
Z
Z
Z
Z
Z
Z
Z
"}
