//MAP CONVERTED BY dmm2tgm.py THIS HEADER COMMENT PREVENTS RECONVERSION, DO NOT REMOVE
"a" = (
/turf/simulated/floor,
/area/map_template/deepmaint)
"b" = (
/obj/machinery/door/unpowered/simple/ebony,
/turf/simulated/floor/tiled/old_cargo,
/area/map_template/deepmaint)
"c" = (
/turf/simulated/floor/light,
/area/map_template/deepmaint)
"e" = (
/obj/structure/flora/pottedplant/unusual,
/turf/simulated/floor/tiled/old_cargo,
/area/map_template/deepmaint)
"i" = (
/obj/structure/table/rack,
/obj/random/biggun,
/turf/simulated/floor/tiled/old_tile,
/area/map_template/deepmaint)
"j" = (
/obj/structure/table/woodentable_reinforced/ebony,
/obj/item/material/clipboard/ebony,
/turf/simulated/floor/greengrid,
/area/map_template/deepmaint)
"k" = (
/obj/structure/table/woodentable/walnut,
/obj/random/snack,
/turf/simulated/floor/tiled/old_tile,
/area/map_template/deepmaint)
"l" = (
/obj/machinery/vending/cigarette{
	dir = 8
	},
/turf/simulated/floor/tiled/old_cargo,
/area/map_template/deepmaint)
"n" = (
/obj/structure/table/woodentable_reinforced/ebony,
/obj/item/device/flashlight/lamp/green,
/turf/simulated/floor/greengrid,
/area/map_template/deepmaint)
"o" = (
/obj/machinery/computer/arcade,
/turf/simulated/floor/tiled/old_cargo,
/area/map_template/deepmaint)
"v" = (
/obj/structure/table/woodentable/walnut,
/obj/item/hand_labeler,
/turf/simulated/floor/tiled/old_tile,
/area/map_template/deepmaint)
"w" = (
/turf/simulated/floor/greengrid,
/area/map_template/deepmaint)
"y" = (
/obj/structure/table/woodentable_reinforced/ebony,
/obj/structure/flora/pottedplant/deskferntrim,
/turf/simulated/floor/greengrid,
/area/map_template/deepmaint)
"z" = (
/obj/machinery/papershredder,
/turf/simulated/floor/tiled/old_tile,
/area/map_template/deepmaint)
"A" = (
/obj/structure/flora/pottedplant/unusual,
/obj/machinery/light/spot,
/turf/simulated/floor/tiled/old_cargo,
/area/map_template/deepmaint)
"E" = (
/obj/structure/table/woodentable_reinforced/ebony,
/obj/item/device/megaphone,
/turf/simulated/floor/greengrid,
/area/map_template/deepmaint)
"F" = (
/obj/structure/table/woodentable_reinforced/ebony,
/obj/item/pen/fancy/quill,
/turf/simulated/floor/greengrid,
/area/map_template/deepmaint)
"G" = (
/obj/structure/table/woodentable/walnut,
/obj/random/hat,
/turf/simulated/floor/tiled/old_tile,
/area/map_template/deepmaint)
"H" = (
/obj/structure/filingcabinet/chestdrawer,
/turf/simulated/floor/tiled/old_tile,
/area/map_template/deepmaint)
"I" = (
/obj/structure/table/woodentable/walnut,
/obj/item/pen,
/obj/item/pen/crayon/rainbow,
/obj/item/pen/blue,
/turf/simulated/floor/tiled/old_tile,
/area/map_template/deepmaint)
"J" = (
/turf/simulated/floor/tiled/old_cargo,
/area/map_template/deepmaint)
"L" = (
/obj/structure/bed/chair/wood/wings/ebony,
/obj/random/plushie/large,
/turf/simulated/floor/greengrid,
/area/map_template/deepmaint)
"M" = (
/obj/machinery/light/spot{
	dir = 1
	},
/turf/simulated/floor/tiled/old_cargo,
/area/map_template/deepmaint)
"N" = (
/turf/simulated/wall,
/area/map_template/deepmaint)
"O" = (
/obj/structure/flora/pottedplant/mysterious,
/obj/machinery/light/spot{
	dir = 4
	},
/turf/simulated/floor/tiled/old_tile,
/area/map_template/deepmaint)
"Q" = (
/obj/machinery/photocopier,
/obj/machinery/light/spot{
	dir = 8
	},
/turf/simulated/floor/tiled/old_tile,
/area/map_template/deepmaint)
"U" = (
/obj/structure/flora/pottedplant/mysterious,
/obj/machinery/light/spot{
	dir = 8
	},
/turf/simulated/floor/tiled/old_tile,
/area/map_template/deepmaint)
"Y" = (
/obj/machinery/light/spot{
	dir = 4
	},
/obj/structure/table/rack,
/obj/random/donkpocket,
/obj/random/drinkbottle,
/turf/simulated/floor/tiled/old_tile,
/area/map_template/deepmaint)
"Z" = (
/obj/structure/table/woodentable/walnut,
/obj/item/paper_bin,
/turf/simulated/floor/tiled/old_tile,
/area/map_template/deepmaint)

(1,1,1) = {"
a
a
a
a
a
a
a
a
a
a
a
a
a
a
a
"}
(2,1,1) = {"
a
a
a
a
a
a
a
a
a
a
a
a
a
a
a
"}
(3,1,1) = {"
a
a
N
N
N
N
N
N
N
N
N
N
N
a
a
"}
(4,1,1) = {"
a
a
N
e
Q
z
H
v
Z
U
J
o
N
a
a
"}
(5,1,1) = {"
a
a
N
J
c
c
c
c
c
c
J
J
N
a
a
"}
(6,1,1) = {"
a
a
N
J
c
c
c
c
c
c
J
J
N
a
a
"}
(7,1,1) = {"
a
a
N
J
c
w
F
E
c
c
J
A
N
a
a
"}
(8,1,1) = {"
a
a
N
M
c
w
L
j
c
c
J
J
b
a
a
"}
(9,1,1) = {"
a
a
N
J
c
w
y
n
c
c
J
A
N
a
a
"}
(10,1,1) = {"
a
a
N
J
c
c
c
c
c
c
J
J
N
a
a
"}
(11,1,1) = {"
a
a
N
J
c
c
c
c
c
c
J
J
N
a
a
"}
(12,1,1) = {"
a
a
N
e
Y
i
I
G
k
O
J
l
N
a
a
"}
(13,1,1) = {"
a
a
N
N
N
N
N
N
N
N
N
N
N
a
a
"}
(14,1,1) = {"
a
a
a
a
a
a
a
a
a
a
a
a
a
a
a
"}
(15,1,1) = {"
a
a
a
a
a
a
a
a
a
a
a
a
a
a
a
"}
