//MAP CONVERTED BY dmm2tgm.py THIS HEADER COMMENT PREVENTS RECONVERSION, DO NOT REMOVE
"a" = (
/turf/simulated/floor/exoplanet/snow,
/area/map_template/deepmaint)
"d" = (
/obj/floor_decal/industrial/traffic{
	dir = 8
	},
/turf/simulated/floor/exoplanet/snow,
/area/map_template/deepmaint)
"i" = (
/obj/structure/cable{
	d1 = 1;
	d2 = 8;
	icon_state = "1-8"
	},
/obj/structure/cable{
	d1 = 1;
	d2 = 4;
	icon_state = "1-4"
	},
/mob/living/simple_animal/hostile/bear,
/turf/simulated/floor/exoplanet/snow,
/area/map_template/deepmaint)
"j" = (
/obj/machinery/door/airlock/freezer,
/turf/simulated/floor/exoplanet/snow,
/area/map_template/deepmaint)
"k" = (
/obj/structure/cable{
	d2 = 2;
	icon_state = "0-2"
	},
/obj/machinery/power/smes/buildable/preset/admin,
/turf/simulated/floor/exoplanet/snow,
/area/map_template/deepmaint)
"m" = (
/obj/structure/flora/bush,
/turf/simulated/floor/exoplanet/snow,
/area/map_template/deepmaint)
"o" = (
/obj/structure/table/rack,
/obj/item/clothing/suit/storage/hooded/wintercoat,
/obj/item/clothing/suit/storage/hooded/wintercoat,
/obj/item/clothing/suit/storage/hooded/wintercoat,
/obj/floor_decal/industrial/traffic{
	dir = 8
	},
/turf/simulated/floor/exoplanet/snow,
/area/map_template/deepmaint)
"q" = (
/obj/structure/cable{
	d1 = 4;
	d2 = 8;
	icon_state = "4-8";
	pixel_x = 0
	},
/mob/living/simple_animal/hostile/bear,
/turf/simulated/floor/exoplanet/snow,
/area/map_template/deepmaint)
"s" = (
/obj/structure/flora/grass/green,
/turf/simulated/floor/exoplanet/snow,
/area/map_template/deepmaint)
"t" = (
/obj/structure/flora/tree/dead,
/turf/simulated/floor/exoplanet/snow,
/area/map_template/deepmaint)
"v" = (
/turf/simulated/floor,
/area/map_template/deepmaint)
"y" = (
/obj/structure/flora/grass/both,
/turf/simulated/floor/exoplanet/snow,
/area/map_template/deepmaint)
"A" = (
/obj/structure/cable{
	d1 = 1;
	d2 = 2;
	icon_state = "1-2"
	},
/obj/structure/flora/bush,
/turf/simulated/floor/exoplanet/snow,
/area/map_template/deepmaint)
"E" = (
/obj/structure/flora/grass/brown,
/turf/simulated/floor/exoplanet/snow,
/area/map_template/deepmaint)
"G" = (
/obj/structure/table/rack,
/obj/random/ammo,
/obj/random/ammo,
/obj/random/ammo,
/obj/random/ammo,
/obj/random/ammo,
/obj/random/ammo,
/obj/random/handgun,
/obj/random/handgun,
/turf/simulated/floor/exoplanet/snow,
/area/map_template/deepmaint)
"H" = (
/mob/living/simple_animal/hostile/retaliate/beast/shantak/alt,
/turf/simulated/floor/exoplanet/snow,
/area/map_template/deepmaint)
"K" = (
/obj/structure/cable{
	d1 = 2;
	d2 = 4;
	icon_state = "2-4"
	},
/obj/structure/cable{
	d1 = 1;
	d2 = 4;
	icon_state = "1-4"
	},
/turf/simulated/floor/exoplanet/snow,
/area/map_template/deepmaint)
"L" = (
/turf/simulated/wall,
/area/map_template/deepmaint)
"N" = (
/obj/structure/cable{
	d1 = 2;
	d2 = 8;
	icon_state = "2-8"
	},
/obj/structure/cable{
	d1 = 1;
	d2 = 8;
	icon_state = "1-8"
	},
/turf/simulated/floor/exoplanet/snow,
/area/map_template/deepmaint)
"O" = (
/obj/structure/cable{
	d2 = 2;
	icon_state = "0-2"
	},
/obj/machinery/shieldwallgen/online{
	req_access = list()
	},
/turf/simulated/floor/exoplanet/snow,
/area/map_template/deepmaint)
"R" = (
/obj/structure/table/rack,
/obj/random/medical,
/obj/random/medical,
/obj/random/medical,
/obj/random/medical,
/obj/random/hardsuit,
/turf/simulated/floor/exoplanet/snow,
/area/map_template/deepmaint)
"S" = (
/obj/item/gun/projectile/flare/loaded,
/obj/structure/table/rack,
/obj/item/device/flashlight/flare,
/obj/item/device/flashlight/flare,
/obj/item/device/flashlight/flare,
/obj/item/device/flashlight/flare,
/obj/floor_decal/industrial/traffic{
	dir = 8
	},
/turf/simulated/floor/exoplanet/snow,
/area/map_template/deepmaint)
"X" = (
/obj/structure/cable,
/obj/machinery/shieldwallgen/online{
	req_access = list()
	},
/turf/simulated/floor/exoplanet/snow,
/area/map_template/deepmaint)
"Z" = (
/obj/structure/cable{
	d1 = 1;
	d2 = 2;
	icon_state = "1-2"
	},
/turf/simulated/floor/exoplanet/snow,
/area/map_template/deepmaint)

(1,1,1) = {"
v
v
v
v
v
v
v
v
v
v
v
v
v
v
v
"}
(2,1,1) = {"
v
L
L
L
L
L
o
d
S
L
L
L
L
L
v
"}
(3,1,1) = {"
v
L
a
s
a
L
L
j
L
L
a
a
a
L
v
"}
(4,1,1) = {"
v
L
m
a
a
a
a
a
a
a
a
y
a
L
v
"}
(5,1,1) = {"
v
L
a
a
a
a
y
a
a
H
a
m
a
L
v
"}
(6,1,1) = {"
v
L
a
a
a
a
a
a
a
a
a
a
a
L
v
"}
(7,1,1) = {"
v
L
a
a
a
O
Z
K
X
a
a
a
a
L
v
"}
(8,1,1) = {"
v
L
a
a
a
a
G
q
a
a
a
a
a
L
v
"}
(9,1,1) = {"
v
L
a
s
a
E
k
i
a
s
a
E
a
L
v
"}
(10,1,1) = {"
v
L
a
a
H
a
R
q
a
a
a
a
a
L
v
"}
(11,1,1) = {"
v
L
a
m
a
O
A
N
X
a
a
a
a
L
v
"}
(12,1,1) = {"
v
L
a
a
a
a
a
s
a
a
a
t
a
L
v
"}
(13,1,1) = {"
v
L
a
a
a
a
a
a
a
a
a
a
a
L
v
"}
(14,1,1) = {"
v
L
L
L
L
L
L
L
L
L
L
L
L
L
v
"}
(15,1,1) = {"
v
v
v
v
v
v
v
v
v
v
v
v
v
v
v
"}
