//MAP CONVERTED BY dmm2tgm.py THIS HEADER COMMENT PREVENTS RECONVERSION, DO NOT REMOVE
"a" = (
/turf/simulated/floor/wood/walnut,
/area/map_template/deepmaint)
"b" = (
/turf/space,
/area/map_template/deepmaint)
"c" = (
/obj/structure/table/woodentable_reinforced/walnut,
/obj/item/paper/crumpled{
	name = "dnd manual";
	desc = "It's totally stained in pizza grease."
	},
/turf/simulated/floor/wood/walnut,
/area/map_template/deepmaint)
"d" = (
/obj/forcefield,
/turf/space,
/area/map_template/deepmaint)
"e" = (
/obj/decal/cleanable/blood,
/turf/simulated/floor/wood/walnut,
/area/map_template/deepmaint)
"g" = (
/obj/structure/table/woodentable_reinforced/walnut,
/obj/item/material/ashtray/plastic,
/obj/random/smokes,
/obj/random/single/lighter,
/turf/simulated/floor/wood/walnut,
/area/map_template/deepmaint)
"j" = (
/obj/structure/bed/chair/armchair/brown{
	dir = 4
	},
/turf/simulated/floor/carpet/red,
/area/map_template/deepmaint)
"k" = (
/obj/structure/flora/pottedplant/orientaltree,
/obj/structure/sign/xenobio_1{
	pixel_y = 31
	},
/turf/simulated/floor/wood/walnut,
/area/map_template/deepmaint)
"l" = (
/obj/structure/lattice,
/turf/space,
/area/map_template/deepmaint)
"m" = (
/obj/gibspawner/human,
/obj/decal/remains,
/turf/simulated/floor/wood/walnut,
/area/map_template/deepmaint)
"n" = (
/obj/machinery/vending/coffee{
	dir = 4
	},
/turf/simulated/floor/wood/walnut,
/area/map_template/deepmaint)
"o" = (
/obj/structure/reagent_dispensers/water_cooler{
	dir = 4
	},
/turf/simulated/floor/wood/walnut,
/area/map_template/deepmaint)
"q" = (
/turf/simulated/floor,
/area/map_template/deepmaint)
"r" = (
/obj/machinery/light,
/turf/simulated/floor/wood/walnut,
/area/map_template/deepmaint)
"s" = (
/obj/random/junk,
/turf/simulated/floor/wood/walnut,
/area/map_template/deepmaint)
"v" = (
/obj/wallframe_spawn/reinforced,
/turf/simulated/floor,
/area/map_template/deepmaint)
"w" = (
/obj/structure/flora/pottedplant/dead,
/obj/machinery/light{
	dir = 1
	},
/turf/simulated/floor/wood/walnut,
/area/map_template/deepmaint)
"y" = (
/obj/structure/flora/pottedplant/shoot,
/obj/machinery/light{
	dir = 1
	},
/turf/simulated/floor/wood/walnut,
/area/map_template/deepmaint)
"A" = (
/obj/structure/table/woodentable_reinforced/walnut,
/obj/item/dice/d8,
/turf/simulated/floor/carpet/red,
/area/map_template/deepmaint)
"B" = (
/obj/structure/bed/chair/armchair/brown,
/mob/living/simple_animal/hostile/drake{
	name = "young red dragon"
	},
/turf/simulated/floor/carpet/red,
/area/map_template/deepmaint)
"E" = (
/obj/structure/showcase{
	density = 0;
	name = "rune";
	icon = 'icons/obj/rune.dmi';
	icon_state = "6";
	desc = "an unknown rune, drawn in blood. You can't seem to wipe it away."
	},
/turf/simulated/floor/wood/walnut,
/area/map_template/deepmaint)
"F" = (
/obj/decal/cleanable/blood/tracks/claw{
	setdirs = list("1"=1,"2"=0,"4"=0,"8"=0,"16"=16,"32"=0,"64"=0,"128"=0)
	},
/turf/simulated/floor/wood/walnut,
/area/map_template/deepmaint)
"G" = (
/turf/simulated/floor/carpet/red,
/area/map_template/deepmaint)
"I" = (
/obj/structure/table/woodentable_reinforced/walnut,
/obj/item/dice,
/obj/item/dice/d10,
/obj/item/dice/d12,
/obj/item/dice/d20,
/obj/item/dice/d4,
/turf/simulated/floor/wood/walnut,
/area/map_template/deepmaint)
"J" = (
/obj/decal/cleanable/blood/drip,
/turf/simulated/floor/wood/walnut,
/area/map_template/deepmaint)
"L" = (
/obj/structure/flora/pottedplant/tropical,
/obj/structure/sign/xenobio_1{
	pixel_y = 31
	},
/turf/simulated/floor/wood/walnut,
/area/map_template/deepmaint)
"M" = (
/obj/structure/table/woodentable_reinforced/walnut,
/obj/item/paper/crumpled{
	name = "character sheet";
	desc = "It's totally stained in pizza grease."
	},
/obj/item/device/flashlight/lamp,
/turf/simulated/floor/carpet/red,
/area/map_template/deepmaint)
"N" = (
/obj/structure/table/woodentable_reinforced/walnut,
/obj/random/medical,
/obj/random/medical,
/obj/random/medical,
/turf/simulated/floor/carpet/red,
/area/map_template/deepmaint)
"P" = (
/obj/structure/bed/chair/armchair/brown{
	dir = 8
	},
/turf/simulated/floor/carpet/red,
/area/map_template/deepmaint)
"Q" = (
/obj/machinery/door/airlock/civilian,
/obj/mech_shield,
/turf/simulated/floor/wood/walnut,
/area/map_template/deepmaint)
"S" = (
/turf/simulated/wall,
/area/map_template/deepmaint)
"T" = (
/obj/decal/remains,
/obj/gibspawner/human,
/turf/simulated/floor/wood/walnut,
/area/map_template/deepmaint)
"U" = (
/obj/structure/table/woodentable_reinforced/walnut,
/obj/item/paper_bin,
/obj/item/pen/red,
/obj/item/pen,
/turf/simulated/floor/wood/walnut,
/area/map_template/deepmaint)
"V" = (
/turf/simulated/wall/r_wall,
/area/map_template/deepmaint)
"X" = (
/obj/mech_shield,
/turf/simulated/wall,
/area/map_template/deepmaint)
"Y" = (
/obj/structure/table/woodentable_reinforced/walnut,
/obj/item/pizzabox/meat,
/obj/item/material/knife/kitchen,
/turf/simulated/floor/wood/walnut,
/area/map_template/deepmaint)
"Z" = (
/obj/decal/remains,
/turf/simulated/floor/wood/walnut,
/area/map_template/deepmaint)

(1,1,1) = {"
q
q
q
q
q
q
q
q
q
q
q
q
q
q
q
"}
(2,1,1) = {"
q
S
S
S
S
S
S
S
S
S
S
S
S
S
q
"}
(3,1,1) = {"
q
S
b
l
l
d
d
d
d
d
l
l
b
S
q
"}
(4,1,1) = {"
q
S
b
V
V
v
v
v
v
v
V
V
b
S
q
"}
(5,1,1) = {"
q
S
b
V
w
e
Z
a
e
o
n
V
b
S
q
"}
(6,1,1) = {"
q
S
d
v
a
e
a
F
F
F
r
V
S
S
q
"}
(7,1,1) = {"
q
S
d
v
U
G
j
j
j
a
e
a
X
L
q
"}
(8,1,1) = {"
q
S
d
v
c
B
N
A
M
a
E
e
Q
a
q
"}
(9,1,1) = {"
q
S
d
v
I
G
P
P
P
a
m
a
X
k
q
"}
(10,1,1) = {"
q
S
d
v
a
a
a
J
a
J
r
V
S
S
q
"}
(11,1,1) = {"
q
S
b
V
y
s
T
a
e
Y
g
V
b
S
q
"}
(12,1,1) = {"
q
S
b
V
V
v
v
v
v
v
V
V
b
S
q
"}
(13,1,1) = {"
q
S
b
l
l
d
d
d
d
d
l
l
b
S
q
"}
(14,1,1) = {"
q
S
S
S
S
S
S
S
S
S
S
S
S
S
q
"}
(15,1,1) = {"
q
q
q
q
q
q
q
q
q
q
q
q
q
q
q
"}
