//MAP CONVERTED BY dmm2tgm.py THIS HEADER COMMENT PREVENTS RECONVERSION, DO NOT REMOVE
"c" = (
/obj/machinery/door/unpowered/simple/uranium,
/turf/template_noop,
/area/template_noop)
"d" = (
/turf/simulated/wall/uranium,
/area/template_noop)
"e" = (
/obj/effect/floor_decal/spline/fancy/wood{
	dir = 9;
	icon_state = "spline_fancy"
	},
/turf/simulated/floor/exoplanet/water/shallow,
/area/template_noop)
"g" = (
/obj/effect/floor_decal/spline/fancy/wood{
	dir = 5
	},
/turf/simulated/floor/exoplanet/water/shallow,
/area/template_noop)
"k" = (
/obj/effect/floor_decal/spline/fancy/wood{
	dir = 4
	},
/turf/simulated/floor/exoplanet/water/shallow,
/area/template_noop)
"x" = (
/obj/effect/floor_decal/spline/fancy/wood{
	dir = 8
	},
/turf/simulated/floor/exoplanet/water/shallow,
/area/template_noop)
"y" = (
/obj/item/trash/candle,
/turf/simulated/floor/fixed/alium,
/area/template_noop)
"A" = (
/obj/machinery/artifact,
/obj/effect/floor_decal/spline/fancy/wood/cee{
	dir = 1
	},
/obj/structure/window/phoronreinforced{
	dir = 8
	},
/obj/structure/window/phoronreinforced{
	dir = 4
	},
/obj/structure/window/phoronreinforced{
	dir = 1
	},
/turf/simulated/floor/fixed/alium,
/area/template_noop)
"E" = (
/obj/effect/decal/cleanable/cobweb,
/obj/item/weapon/stool/stone,
/obj/item/remains/xeno/charred,
/turf/simulated/floor/fixed/alium,
/area/template_noop)
"H" = (
/obj/item/weapon/stool/stone,
/obj/item/remains/xeno/charred,
/turf/simulated/floor/fixed/alium,
/area/template_noop)
"K" = (
/turf/simulated/floor/fixed/alium,
/area/template_noop)
"N" = (
/obj/effect/floor_decal/spline/fancy/wood{
	dir = 1;
	icon_state = "spline_fancy"
	},
/turf/simulated/floor/exoplanet/water/shallow,
/area/template_noop)
"Y" = (
/turf/simulated/wall/alium,
/area/template_noop)

(1,1,1) = {"
d
Y
Y
d
Y
Y
d
"}
(2,1,1) = {"
Y
E
K
K
y
y
Y
"}
(3,1,1) = {"
Y
K
K
H
e
x
Y
"}
(4,1,1) = {"
c
K
K
K
N
A
d
"}
(5,1,1) = {"
Y
K
K
K
g
k
Y
"}
(6,1,1) = {"
Y
K
H
K
y
y
Y
"}
(7,1,1) = {"
d
Y
Y
d
Y
Y
d
"}
