//MAP CONVERTED BY dmm2tgm.py THIS HEADER COMMENT PREVENTS RECONVERSION, DO NOT REMOVE
"b" = (
/turf/simulated/wall/iron,
/area/template_noop)
"c" = (
/obj/machinery/door/unpowered/simple/uranium,
/turf/template_noop,
/area/template_noop)
"d" = (
/turf/simulated/wall/uranium,
/area/template_noop)
"e" = (
/obj/structure/bed/chair/wood,
/obj/effect/decal/cleanable/cobweb,
/turf/simulated/floor/carpet/red,
/area/template_noop)
"f" = (
/turf/simulated/floor/carpet/red,
/area/template_noop)
"g" = (
/obj/item/trash/candle,
/turf/simulated/floor/carpet/red,
/area/template_noop)
"h" = (
/obj/effect/wallframe_spawn/reinforced,
/turf/simulated/floor/plating,
/area/template_noop)
"i" = (
/obj/machinery/artifact,
/turf/simulated/floor/reinforced,
/area/template_noop)
"I" = (
/obj/structure/bed/chair/wood,
/turf/simulated/floor/carpet/red,
/area/template_noop)

(1,1,1) = {"
d
b
b
d
b
b
d
"}
(2,1,1) = {"
b
e
I
f
g
g
b
"}
(3,1,1) = {"
b
I
I
f
h
h
b
"}
(4,1,1) = {"
c
f
f
f
h
i
d
"}
(5,1,1) = {"
b
I
I
f
h
h
b
"}
(6,1,1) = {"
b
I
I
f
g
g
b
"}
(7,1,1) = {"
d
b
b
d
b
b
d
"}
