//MAP CONVERTED BY dmm2tgm.py THIS HEADER COMMENT PREVENTS RECONVERSION, DO NOT REMOVE
"b" = (
/obj/effect/decal/cleanable/cobweb,
/obj/item/weapon/stool/stone,
/obj/item/remains/xeno/charred,
/turf/simulated/floor/fixed/alium,
/area/template_noop)
"c" = (
/obj/machinery/door/unpowered/simple/uranium,
/turf/template_noop,
/area/template_noop)
"d" = (
/turf/simulated/wall/uranium,
/area/template_noop)
"e" = (
/obj/effect/floor_decal/spline/fancy/wood{
	dir = 5
	},
/turf/simulated/floor/exoplanet/water/shallow,
/area/template_noop)
"n" = (
/obj/effect/floor_decal/spline/fancy/wood{
	dir = 8
	},
/turf/simulated/floor/exoplanet/water/shallow,
/area/template_noop)
"u" = (
/turf/simulated/floor/fixed/alium,
/area/template_noop)
"y" = (
/obj/structure/totem,
/turf/simulated/floor/fixed/alium,
/area/template_noop)
"z" = (
/obj/effect/floor_decal/spline/fancy/wood{
	dir = 9;
	icon_state = "spline_fancy"
	},
/turf/simulated/floor/exoplanet/water/shallow,
/area/template_noop)
"D" = (
/obj/item/trash/candle,
/turf/simulated/floor/fixed/alium,
/area/template_noop)
"L" = (
/obj/effect/floor_decal/spline/fancy/wood{
	dir = 4
	},
/turf/simulated/floor/exoplanet/water/shallow,
/area/template_noop)
"P" = (
/obj/machinery/artifact,
/obj/effect/floor_decal/spline/fancy/wood/cee{
	dir = 1
	},
/obj/structure/window/phoronreinforced{
	dir = 8
	},
/obj/structure/window/phoronreinforced{
	dir = 4
	},
/obj/structure/window/phoronreinforced{
	dir = 1
	},
/turf/simulated/floor/fixed/alium,
/area/template_noop)
"T" = (
/obj/item/weapon/stool/stone,
/obj/item/remains/xeno/charred,
/turf/simulated/floor/fixed/alium,
/area/template_noop)
"W" = (
/turf/simulated/wall/alium,
/area/template_noop)
"X" = (
/obj/effect/floor_decal/spline/fancy/wood{
	dir = 1;
	icon_state = "spline_fancy"
	},
/turf/simulated/floor/exoplanet/water/shallow,
/area/template_noop)

(1,1,1) = {"
d
W
W
d
W
W
d
"}
(2,1,1) = {"
W
b
u
u
D
D
W
"}
(3,1,1) = {"
W
u
u
T
z
n
W
"}
(4,1,1) = {"
c
u
y
u
X
P
d
"}
(5,1,1) = {"
W
u
u
u
e
L
W
"}
(6,1,1) = {"
W
u
T
u
D
D
W
"}
(7,1,1) = {"
d
W
W
d
W
W
d
"}
