"aa" = (/turf/space,/area/space)
"ab" = (/turf/simulated/wall/r_wall,/area/space)
"ac" = (/turf/simulated/floor/plating,/area/space)
"ad" = (/turf/simulated/floor/tiled/dark,/area/space)
"ae" = (/turf/simulated/floor/tiled,/area/space)
"af" = (/turf/simulated/floor/airless,/area/space)
"ag" = (/obj/machinery/door/firedoor/battle,/turf/simulated/floor/tiled,/area/space)
"ah" = (/obj/effect/wingrille_spawn/reinforced,/obj/machinery/door/firedoor/battle,/turf/simulated/floor/plating,/area/space)
"ai" = (/obj/machinery/power/smes/buildable/battle{output_level = 30000},/turf/simulated/floor/plating,/area/space)
"aj" = (/obj/machinery/power/terminal{dir = 1},/turf/simulated/floor/plating,/area/space)
"ak" = (/obj/machinery/door/firedoor/battle,/turf/simulated/floor/plating,/area/space)
"al" = (/obj/machinery/space_battle/ecm{radius = 0},/turf/simulated/floor/plating,/area/space)
"am" = (/obj/structure/missile_rack/light,/obj/effect/floor_decal/industrial/outline/blue,/turf/simulated/floor/plating,/area/space)
"an" = (/obj/structure/missile_rack,/obj/effect/floor_decal/industrial/outline/yellow,/turf/simulated/floor/plating,/area/space)
"ao" = (/obj/structure/missile_rack/heavy,/obj/effect/floor_decal/industrial/outline/red,/turf/simulated/floor/plating,/area/space)
"ap" = (/turf/simulated/floor/tiled/white,/area/space)
"aq" = (/obj/machinery/power/breakerbox,/turf/simulated/floor/plating,/area/space)
"ar" = (/obj/machinery/power/terminal{dir = 8},/turf/simulated/floor/plating,/area/space)
"as" = (/obj/structure/disposaloutlet{dir = 4},/obj/structure/disposalpipe/trunk{dir = 8},/turf/simulated/floor/plating,/area/space)
"at" = (/turf/simulated/floor/reinforced,/area/space)
"au" = (/obj/machinery/door/firedoor/battle,/turf/simulated/floor/tiled/dark,/area/space)
"av" = (/obj/machinery/space_battle/tube_barrel{dir = 4},/turf/simulated/floor/reinforced,/area/space)
"aw" = (/turf/simulated/floor/greengrid,/area/space)
"ax" = (/obj/structure/window/reinforced{dir = 4},/turf/simulated/floor/greengrid,/area/space)
"ay" = (/obj/machinery/space_battle/missile_computer,/turf/simulated/floor/tiled/dark,/area/space)
"az" = (/obj/machinery/space_battle/hacking,/turf/simulated/floor/tiled/dark,/area/space)
"aA" = (/turf/simulated/floor/holofloor/tiled,/area/space)
"aB" = (/obj/item/weapon/stool,/turf/simulated/floor/holofloor/tiled,/area/space)
"aC" = (/turf/simulated/floor/bluegrid,/area/space)
"aD" = (/obj/structure/window/reinforced{dir = 4},/turf/simulated/floor/bluegrid,/area/space)
"aE" = (/obj/effect/floor_decal/industrial/warning{dir = 1},/turf/simulated/floor/tiled,/area/space)
"aF" = (/obj/effect/floor_decal/industrial/warning{icon_state = "warning"; dir = 5},/turf/simulated/floor/tiled,/area/space)
"aG" = (/obj/structure/window/reinforced,/turf/simulated/floor/bluegrid,/area/space)
"aH" = (/obj/structure/window/reinforced,/obj/structure/window/reinforced{dir = 4},/turf/simulated/floor/bluegrid,/area/space)
"aI" = (/obj/structure/window/reinforced{dir = 8},/obj/structure/window/reinforced{dir = 1},/turf/simulated/floor/carpet,/area/space)
"aJ" = (/obj/structure/window/reinforced{dir = 1},/turf/simulated/floor/carpet,/area/space)
"aK" = (/obj/structure/window/reinforced{dir = 1},/obj/machinery/computer/security/battle,/turf/simulated/floor/carpet,/area/space)
"aL" = (/turf/simulated/floor/holofloor/wood,/area/space)
"aM" = (/obj/structure/window/reinforced{dir = 8},/turf/simulated/floor/carpet,/area/space)
"aN" = (/turf/simulated/floor/carpet,/area/space)
"aO" = (/obj/structure/bed/chair/comfy/blue{dir = 1},/turf/simulated/floor/carpet,/area/space)
"aP" = (/obj/machinery/space_battle/identification_computer,/turf/simulated/floor/carpet,/area/space)
"aQ" = (/obj/machinery/space_battle/ecm{radius = 0},/turf/simulated/floor/carpet,/area/space)
"aR" = (/obj/structure/bed/chair/comfy/blue,/turf/simulated/floor/carpet,/area/space)
"aS" = (/obj/machinery/space_battle/communication,/turf/simulated/floor/carpet,/area/space)
"aT" = (/obj/structure/window/reinforced{dir = 1},/turf/simulated/floor/bluegrid,/area/space)
"aU" = (/obj/structure/window/reinforced{dir = 4},/obj/structure/window/reinforced{dir = 1},/turf/simulated/floor/bluegrid,/area/space)
"aV" = (/obj/structure/window/reinforced{dir = 8},/obj/structure/window/reinforced,/turf/simulated/floor/carpet,/area/space)
"aW" = (/obj/structure/window/reinforced,/turf/simulated/floor/carpet,/area/space)
"aX" = (/obj/effect/floor_decal/industrial/warning,/turf/simulated/floor/tiled,/area/space)
"aY" = (/obj/effect/floor_decal/industrial/warning{dir = 6; icon_state = "warning"},/turf/simulated/floor/tiled,/area/space)
"aZ" = (/obj/structure/window/reinforced,/turf/simulated/floor/greengrid,/area/space)
"ba" = (/obj/structure/window/reinforced,/obj/structure/window/reinforced{dir = 4},/turf/simulated/floor/greengrid,/area/space)
"bb" = (/obj/machinery/door/airlock/multi_tile/glass{name = "Medical Bay"; req_access = list(31)},/obj/machinery/door/firedoor/battle,/turf/simulated/floor/tiled/white,/area/space)
"bc" = (/obj/machinery/door/firedoor/battle,/turf/simulated/floor/tiled/white,/area/space)
"bd" = (/obj/machinery/bodyscanner{dir = 8},/turf/simulated/floor/tiled/white,/area/space)
"be" = (/obj/machinery/body_scanconsole{dir = 8},/turf/simulated/floor/tiled/white,/area/space)
"bf" = (/obj/structure/table/rack,/turf/simulated/floor/tiled/white,/area/space)
"bg" = (/obj/structure/bed/chair{dir = 8},/turf/simulated/floor/tiled/white,/area/space)
"bh" = (/obj/machinery/sleeper{dir = 4},/turf/simulated/floor/tiled/white,/area/space)
"bi" = (/obj/structure/table/standard,/obj/machinery/door/firedoor/battle,/turf/simulated/floor/tiled/white,/area/space)
"bj" = (/obj/effect/floor_decal/corner/grey/diagonal,/obj/machinery/door/airlock/multi_tile/glass{name = "Medical Bay"; req_access = list(31,40)},/obj/machinery/door/firedoor/battle,/turf/simulated/floor/tiled/white,/area/space)
"bk" = (/obj/effect/floor_decal/corner/grey/diagonal,/obj/machinery/door/firedoor/battle,/turf/simulated/floor/tiled/white,/area/space)
"bl" = (/obj/effect/floor_decal/corner/grey/diagonal,/turf/simulated/floor/tiled/white,/area/space)
"bm" = (/obj/effect/floor_decal/corner/grey/diagonal,/obj/structure/bed,/obj/structure/curtain/open/privacy,/obj/item/weapon/bedsheet/medical,/turf/simulated/floor/tiled/white,/area/space)
"bn" = (/obj/effect/floor_decal/corner/grey/diagonal,/obj/structure/table/standard,/obj/item/device/healthanalyzer,/obj/item/device/healthanalyzer,/turf/simulated/floor/tiled/white,/area/space)
"bo" = (/obj/effect/floor_decal/corner/grey/diagonal,/obj/machinery/door/airlock/multi_tile/glass{dir = 2; name = "Medical Bay"; req_access = list(31,40)},/turf/simulated/floor/tiled/white,/area/space)
"bp" = (/obj/effect/floor_decal/corner/grey/diagonal,/obj/structure/table/standard,/obj/item/weapon/storage/firstaid/regular,/obj/item/weapon/storage/firstaid/regular,/turf/simulated/floor/tiled/white,/area/space)
"bq" = (/obj/machinery/door/firedoor/battle,/obj/structure/curtain/medical,/turf/simulated/floor/tiled/white,/area/space)
"br" = (/obj/machinery/organ_printer/robot/mapped,/turf/simulated/floor/tiled/white,/area/space)
"bs" = (/obj/structure/table/glass,/obj/item/weapon/reagent_containers/glass/beaker/large,/obj/item/weapon/reagent_containers/glass/beaker/large,/turf/simulated/floor/tiled/white,/area/space)
"bt" = (/obj/machinery/smartfridge/chemistry,/turf/simulated/floor/tiled/white,/area/space)
"bu" = (/obj/structure/closet/crate/medical,/turf/simulated/floor/tiled/white,/area/space)
"bv" = (/obj/structure/sink{dir = 8; icon_state = "sink"; pixel_x = -15; pixel_y = 2},/turf/simulated/floor/tiled/white,/area/space)
"bw" = (/obj/structure/table/rack,/obj/item/clothing/gloves/latex,/obj/item/weapon/reagent_containers/spray/sterilizine,/turf/simulated/floor/tiled/white,/area/space)
"bx" = (/obj/structure/table/glass,/obj/item/weapon/storage/box/beakers,/obj/item/weapon/storage/box/syringes,/turf/simulated/floor/tiled/white,/area/space)
"by" = (/obj/structure/table/standard,/obj/item/weapon/storage/firstaid/surgery,/turf/simulated/floor/tiled/white,/area/space)
"bz" = (/obj/machinery/optable,/obj/machinery/oxygen_pump/anesthetic{dir = 1; pixel_y = -27},/obj/machinery/light,/turf/simulated/floor/tiled/white,/area/space)
"bA" = (/obj/machinery/computer/operating,/turf/simulated/floor/tiled/white,/area/space)
"bB" = (/obj/structure/table/glass,/obj/machinery/reagentgrinder,/turf/simulated/floor/tiled/white,/area/space)
"bC" = (/obj/machinery/chemical_dispenser/full,/turf/simulated/floor/tiled/white,/area/space)
"bD" = (/obj/machinery/chem_master,/turf/simulated/floor/tiled/white,/area/space)
"bE" = (/obj/machinery/power/terminal,/turf/simulated/floor/plating,/area/space)

(1,1,1) = {"
aaaaaaaaaaaaaaaaaaaaaaaaaaaaaaaaaaaaaaaaaaaaaaaaaaaaaaaaaaaaaaaaaaaaaaaaaaaaaaaaaaaaaaaaaaaaaaaaaaaaaaaaaaaaaaaaaaaaaaaaaaaaaaaaaaaaaaaaaaaaaaaaaaaaaaaaaaaaaaaaaaaaaaaaaaaaaaaaaaaaaaaaaaaaaaaaaaaaaaaa
aaaaaaaaaaaaaaaaaaaaaaaaaaaaaaaaaaaaaaaaaaaaaaaaaaaaaaaaaaaaaaaaaaaaaaaaaaaaaaaaaaaaaaaaaaaaaaaaaaaaaaaaaaaaaaaaaaaaaaaaaaaaaaaaaaaaaaaaaaaaaaaaaaaaaaaaaaaaaaaaaaaaaaaaaaaaaaaaaaaaaaaaaaaaaaaaaaaaaaaa
aaaaaaaaaaaaaaaaaaaaaaaaaaaaaaaaaaaaaaaaaaaaaaaaaaaaaaaaaaaaaaaaaaaaaaaaaaaaaaaaaaaaaaaaaaaaaaaaaaaaaaaaaaaaaaaaaaaaaaaaaaaaaaaaaaaaaaaaaaaaaaaaaaaaaaaaaaaaaaaaaaaaaaaaaaaaaaaaaaaaaaaaaaaaaaaaaaaaaaaa
aaaaaaaaaaaaaaaaaaaaaaaaaaaaaaaaaaaaaaaaaaaaaaaaaaaaaaaaaaaaaaaaaaaaaaaaaaaaaaaaaaaaaaaaaaaaaaaaaaaaaaaaaaaaaaaaaaaaaaaaaaaaaaaaaaaaaaaaaaaaaaaaaaaaaaaaaaaaaaaaaaaaaaaaaaaaaaaaaaaaaaaaaaaaaaaaaaaaaaaa
aaaaaaaaaaaaaaaaaaaaaaaaaaaaaaaaaaaaaaaaaaaaaaaaaaaaaaaaaaaaaaaaaaaaaaaaaaaaaaaaaaaaaaaaaaaaaaaaaaaaaaaaaaaaaaaaaaaaaaaaaaaaaaaaaaaaaaaaaaaaaaaaaaaaaaaaaaaaaaaaaaaaaaaaaaaaaaaaaaaaaaaaaaaaaaaaaaaaaaaa
aaaaaaaaaaaaaaaaaaaaaaaaaaaaaaaaaaaaaaaaaaaaaaaaaaaaaaaaaaaaaaaaaaaaaaaaaaaaaaaaaaaaaaaaaaaaaaaaaaaaaaaaaaaaaaaaaaaaaaaaaaaaaaaaaaaaaaaaaaaaaaaaaaaaaaaaaaaaaaaaaaaaaaaaaaaaaaaaaaaaaaaaaaaaaaaaaaaaaaaa
aaaaaaaaaaaaaaaaaaaaaaaaaaaaaaaaaaaaaaaaaaaaaaaaaaaaaaaaaaaaaaaaaaaaaaaaaaaaaaaaaaaaababababababababaaaaaaaaaaaaaaaaaaaaaaaaaaaaaaaaaaaaaaaaaaaaaaaaaaaaaaaaaaaaaaaaaaaaaaaaaaaaaaaaaaaaaaaaaaaaaaaaaaaa
aaaaaaaaaaaaaaaaaaaaaaaaaaaaaaaaaaaaaaaaaaaaaaaaaaaaaaaaaaaaaaaaaaaaaaaaaaaaabababababababababababababababaaaaaaaaaaaaaaaaaaaaaaaaaaaaaaaaaaaaaaaaaaaaaaaaaaaaaaaaaaaaaaaaaaaaaaaaaaaaaaaaaaaaaaaaaaaaaa
aaaaaaaaaaaaaaaaaaaaaaaaaaaaaaaaaaaaaaaaaaaaaaaaaaaaaaaaaaaaaaaaaaaaaaaaabababababababababababababababababababababaaaaaaaaaaaaaaaaaaaaaaaaaaaaaaaaaaaaaaaaaaaaaaaaaaaaaaaaaaaaaaaaaaaaaaaaaaaaaaaaaaaaaa
aaaaaaaaaaaaaaaaaaaaaaaaaaaaaaaaaaaaaaaaaaaaaaaaaaaaaaaaaaaaaaaaaaaaaaabababababacacacacacacacacacacacababababababababaaaaaaaaaaaaaaaaaaaaaaaaaaaaaaaaaaaaaaaaaaaaaaaaaaaaaaaaaaaaaaaaaaaaaaaaaaaaaaaaaa
aaaaaaaaaaaaaaaaaaaaaaaaaaaaaaaaaaaaaaaaaaaaaaaaaaaaaaaaaaaaaaaaaaaaababababacacacacacacacacacacacacababababababababaaaaaaaaaaaaaaaaaaaaaaaaaaaaaaaaaaaaaaaaaaaaaaaaaaaaaaaaaaaaaaaaaaaaaaaaaaaaaaaaaaaa
aaaaaaaaaaaaaaaaaaaaaaaaaaaaaaaaaaaaaaaaaaaaaaaaaaaaaaaaaaaaaaaaaaaaababababacacacacacacacacacacacacacababababababababaaaaaaaaaaaaaaaaaaaaaaaaaaaaaaaaaaaaaaaaaaaaaaaaaaaaaaaaaaaaaaaaaaaaaaaaaaaaaaaaaa
aaaaaaaaaaaaaaaaaaaaaaaaaaaaaaaaaaaaaaaaaaaaaaaaaaaaaaaaaaaaaaaaaaabababababababababacabababababababababababababababaaaaaaaaaaaaaaaaaaaaaaaaaaaaaaaaaaaaaaaaaaaaaaaaaaaaaaaaaaaaaaaaaaaaaaaaaaaaaaaaaaaa
aaaaaaaaaaaaaaaaaaaaaaaaaaaaaaaaaaaaaaaaaaaaaaaaaaaaaaaaaaaaaaaaaaababababadabadabadaeaeadabadabadabadababababababababaaaaaaaaaaaaaaaaaaaaaaaaaaaaaaaaaaaaaaaaaaaaaaaaaaaaaaaaaaaaaaaaaaaaaaaaaaaaaaaaaa
aaaaaaaaaaaaaaaaaaaaaaaaaaaaaaaaaaaaaaaaaaaaaaaaaaaaaaaaaaaaaaaaababababaeaeaeaeaeaeaeaeaeaeaeaeaeaeaeaeababababababababaaaaaaaaaaaaaaaaaaaaaaaaaaaaaaaaaaaaaaaaaaaaaaaaaaaaaaaaaaaaaaaaaaaaaaaaaaaaaaaa
aaaaaaaaaaaaaaaaaaaaaaaaaaaaaaaaaaaaaaaaaaaaaaaaaaaaaaaaaaaaaaaaababababaeaeaeaeaeaeaeaeaeaeaeaeaeaeaeaeaeababababababababaaaaaaaaaaaaaaaaaaaaaaaaaaaaaaaaaaaaaaaaaaaaaaaaaaaaaaaaaaaaaaaaaaaaaaaaaaaaaa
aaaaaaaaaaaaaaaaaaaaaaaaaaaaaaaaaaaaaaaaaaaaaaaaaaaaaaaaaaaaaaababababaeaeaeaeaeaeaeaeaeaeaeaeaeaeaeaeaeaeaaaaaaaaaaaaaaaaaaaaaaaaaaaaaaaaaaaaaaaaaaaaaaaaaaaaaaaaaaaaaaaaaaaaaaaaaaaaaaaaaaaaaaaaaaaaaa
aaaaaaaaaaaaaaaaaaaaaaaaaaaaaaaaaaaaaaaaaaaaaaaaaaaaaaaaaaaaaaababababaeaeaeaeaeaeaeaeaeaeaeaeaeaeaeaeaeaeababababababababaaaaaaaaaaaaaaaaaaaaaaaaaaaaaaaaaaaaaaaaaaaaaaaaaaaaaaaaaaaaaaaaaaaaaaaaaaaaaa
aaaaaaaaaaaaaaaaaaaaaaaaaaaaaaaaaaaaaaaaaaaaaaaaaaaaaaaaaaaaaaababababaeaeaeaeaeaeaeaeaeaeaeaeaeaeaeaeaeababababababababaaaaaaaaaaaaaaaaaaaaaaaaaaaaaaaaaaaaaaaaaaaaaaaaaaaaaaaaaaaaaaaaaaaaaaaaaaaaaaaa
aaaaaaaaaaafafafaaafafafaaafafafaaaaaaaaaaaaaaaaaaaaaaaaaaaaaaababababaeaeaeaeaeaeaeaeaeaeaeaeaeaeaeaeababababababababaaaaaaaaaaaaaaaaaaaaaaaaaaaaaaaaaaaaaaaaaaaaaaaaaaaaaaaaaaaaaaaaaaaaaaaaaaaaaaaaaa
aaaaaaaaaaafafafaaafafafaaafafafaaafafafafafaaaaaaaaaaaaaaaaabababababaeaeaeaeaeaeaeaeaeaeaeaeaeaeaeababababababababaaaaaaaaaaaaaaaaaaaaaaaaaaaaaaaaaaaaaaaaaaaaaaaaaaaaaaaaaaaaaaaaaaaaaaaaaaaaaaaaaaaa
aaaaaaaaaaafafafaaafafafaaafafafaaafafafafafaaaaaaaaaaaaaaaaabababababaeaeaeaeaeaeaeaeaeaeaeaeaeaeaeaeababababababababaaaaaaaaaaaaaaaaaaaaaaaaaaaaaaaaaaaaaaaaaaaaaaaaaaaaaaaaaaaaaaaaaaaaaaaaaaaaaaaaaa
aaaaaaaaaaafafafaaafafafaaafafafaaaaaaafaaaaaaaaaaaaaaaaaaababababababaeaeaeaeaeaeaeaeaeaeaeaeaeaeaeababababababababababaaaaaaaaaaaaaaaaaaaaaaaaaaaaaaaaaaaaaaaaaaaaaaaaaaaaaaaaaaaaaaaaaaaaaaaaaaaaaaaa
aaaaaaaaaaafafafaaafafafaaafafafaaafafafafafaaaaaaaaaaaaabababababacacaeaeaeaeaeaeaeaeaeaeaeaeaeaeaeacacacacacacacacacababababababababababaaaaaaaaaaaaaaaaaaaaaaaaaaaaaaaaaaaaaaaaaaaaaaaaaaaaaaaaaaaaaa
aaaaaaaaaaafafafaaafafafaaafafafaaafafafafafaaaaaaaaaaababababababacabagagagababahahahabababahahahabababababababababacababababababababababababababaaaaaaaaaaaaaaaaaaaaaaaaaaaaaaaaaaaaaaaaaaaaaaaaaaaaaa
aaaaaaaaaaafafafaaafafafaaafafafaaaaaaafaaaaaaaaaaaaababababaiaiaiacabaeaeaeaeaeaeaeaeaeaeaeaeaeaeaeaeaeaeagaeaeaeabacabababababababababababababababahabaaaaaaaaaaaaaaaaaaaaaaaaaaaaaaaaaaaaaaaaaaaaaaaa
aaaaaaaaaaafafafafafafafafafafafafafafafaaaaaaaaaaababababacajajajacakaeaeaeaeaeaeaeaeaeaeaeaeaeaeaeaeaeaeagaeaeaeabacacacacacacacacacacacacacacacacacabababaaaaaaaaaaaaaaaaaaaaaaaaaaaaaaaaaaaaaaaaaaaa
aaaaaaaaaaafafafaaafafafaaafafafaaaaaaafaaaaaaaaababababacacacacacacabaeaeaeaeaeaeaeaeaeaeaeaeaeaeaeaeaeaeagaeaeaeabababababababababababababababababacalababababaaaaaaaaaaaaaaaaaaaaaaaaaaaaaaaaaaaaaaaa
aaaaaaaaaaafafafaaafafafaaafafafaaaaaaafaaaaaaaaabababababababababababagagagababababababababababababababababaeaeaeabamacamamacamanacananacanaoacaoabacacababababababaaaaaaaaaaaaaaaaaaaaaaaaaaaaaaaaaaaa
aaaaaaaaaaafafafaaafafafaaafafafaaaaaaafaaaaaaabababacacacacacacacacabaeaeaeabapapapapapapapapapapapapapapabaeaeaeabamacamamacamanacananacanaoacaoabacabababababababababaaaaaaaaaaaaaaaaaaaaaaaaaaaaaaaa
aaaaaaaaaaafafafaaafafafaaafafafaaaaaaafaaaaaaabababacacacacacacacacabaeaeaeabapapapapapapapapapapapapapapabaeaeaeahacadacacadacacadacacadacacadababacabababababababababababaaaaaaaaaaaaaaaaaaaaaaaaaaaa
aaaaaaaaaaafafafaaafafafaaafafafaaaaaaafaaaaabababacacacacacacacacacabaeaeaeabapapapapapapapapapapapapapapabaeaeaeahahadahahadahahadahahadahahadabaqacababababababababababababaaaaaaaaaaaaaaaaaaaaaaaaaa
aaaaaaaaaaafafafaaafafafaaafafafaaabahacahababacacacacacacacacacacacabaeaeaeabapapapapapapapapapapapapapapabaeaeaeagaeadaeaeadaeaeadaeaeadaeaeadacacacababababababababababababababaaaaaaaaaaaaaaaaaaaaaa
aaaaaaaaaaafafafaaafafafaaafafafaaahacacacahacacacacacacacacacacacacabaeaeaeabapapapapapapapapapapapapapapabaeaeaeagaeadaeaeadaeaeadaeaeadaeaeadabaiarabababababababababababababaaaaaaaaaaaaaaaaaaaaaaaa
aaaaaaaaaaaaaaaaaaaaaaaaaaaaaaaaaaahacacacacacacacacacacacacacacacacabaeaeaeabapapapapapapapapapapapapapapabaeaeaeahaeadaeaeadaeaeadaeaeadaeaeadabababababababababababababababababaaaaaaaaaaaaaaaaaaaaaa
aaaaaaaaaaaaaaaaaaaaaaaaaaaaaaaaaaahacacacahacacacacacacacacacacacacabaeaeaeabapapapapapapapapapapapapapapabaeaeaeahaeadaeaeadaeaeadaeaeadaeaeadababababababababababababababababaaaaaaaaaaaaaaaaaaaaaaaa
aaaaaaaaaaaaaaaaaaaaaaaaaaaaaaaaaaabahahahabacacacacacacacacacacacacabaeaeaeabapapapapapapapapapapapapapapabaeaeaeabaeadaeaeadaeaeadaeaeadaeaeadadababababababababababababababababaaaaaaaaaaaaaaaaaaaaaa
aaaaaaaaaaaaaaaaaaaaaaaaaaaaaaaaaaabababacacacacacacacacacacacacacacabaeaeaeabapapapapapapapapapapapapapapabaeaeaeabasacacacacacacacacacacacacabatabababababababababababababababaaaaaaaaaaaaaaaaaaaaaaaa
aaaaaaaaaaaaaaaaaaaaaaaaaaaaaaaaaaabababacacacacacacacacacacacacacacabaeaeaeabapapapapapapapapapapapapapapabaeaeaeababababahahahabahahahababatabatatabababababababababababababababaaaaaaaaaaaaaaaaaaaaaa
aaaaaaaaaaaaaaaaaaaaaaaaaaaaaaaaaaabababacacacacacacacacacacacacacacabaeaeaeabapapapapapapapapapapapapapapabaeaeaeabatatatatatatatatatatatatatatatatababababababababababababababaaaaaaaaaaaaaaaaaaaaaaaa
aaaaaaaaaaaaaaaaaaaaaaaaaaaaaaaaabababacacacacacacacacacacacacacacacabaeaeaeabapapapapapapapapapapapapapapabaeaeaeabatababahahahabahahahabababababababababababababababababababababaaaaaaaaaaaaaaaaaaaaaa
aaaaaaaaaaaaaaaaaaaaaaaaaaaaaaaaabababacacacacacacacacacacacacacacacabagagagababababababababababababababababaeaeaeabatababaaaaaaaaaaaaaaaaabababababababababababababababababababababaaaaaaaaaaaaaaaaaaaa
aaaaaaaaaaaaaaaaaaaaaaaaaaaaaaaaabababacacacacacacacacacacacacacacacabaeaeaeaeaeaeaeaeaeaeaeaeaeagaeaeaeaeaeaeaeaeabatababahahahabahahahabababababababababababababababababababababababaaaaaaaaaaaaaaaaaa
aaaaaaaaaaaaaaaaaaaaaaaaaaaaaaaaabababacacacacacacacacacacacacacacacabaeaeaeaeaeaeaeaeaeaeaeaeaeagaeaeaeaeaeaeaeaeahatatatatatatatatatatatatatatatatatatatatatatababababababababababababaaaaaaaaaaaaaaaa
aaaaaaaaaaaaaaaaaaaaaaaaaaaaaaabababacacacacacacacacacacacacacacacacabaeaeaeaeadadadadadadadadadauadadadadabaeaeaeahatatavavavavavavavavavavavavavavavavavavavavavavavavavavavavavavataaaaaaaaaaaaaaaaaa
aaaaaaaaaaaaaaaaaaaaaaaaaaaaabababacacacacacacacacacacacacacacacacacabagagagabahahahahahahahahahahadadadadadaeaeaeahatatatatatatatatatatatatatatatatatatatatatatababababababababababababaaaaaaaaaaaaaaaa
aaaaaaaaaaaaaaaaaaaaaaaaaaaaabababacacacacacacacacacacacacacacacacacabaeaeaeabawawawaxadadayayazahadadadadadaeaeaeabatababahahahabahahahabababababababababababababababababababababababaaaaaaaaaaaaaaaaaa
aaaaaaaaaaaaaaaaaaaaaaaaaaaaabababacacacacacacacacacacacacacacacacacabaeaeaeabawawawaxadaAaAaBadahadadadadadaeaeaeabatababaaaaaaaaaaaaaaaaabababababababababababababababababababababaaaaaaaaaaaaaaaaaaaa
aaaaaaaaaaaaaaaaaaaaaaaaaaabababacacacacacacacacacacacacacacacacacacabaeaeaeabadaCawadadaAaAaAadahadadadadadaeaeaeabatababahahahabahahahabababababababababababababababababababababaaaaaaaaaaaaaaaaaaaaaa
aaaaaaaaaaaaaaaaaaaaaaaaaaabababacacacacacacacacacacacacacacacacacacabaeaeaeabaCaCaCaDadaAaAaAadahahahahahadaeaeaeahaeaEaEaEaEaEaEaEaEaEaFabababababababababababababababababababaaaaaaaaaaaaaaaaaaaaaaaa
aaaaaaaaaaaaaaaaaaaaaaaaaaabababacacacacacacacacacacacacacacacacacacabaeaeaeahaGaGaGaHadaAaAaAadaIaJaJaKahahaeaeaeahaeaeaeaeaeaeaeaeaeaeaeaeaeababababababababababababababababababaaaaaaaaaaaaaaaaaaaaaa
aaaaaaaaaaaaaaaaaaaaaaaaabababacacacacacacacacacacacacacacacacacacacabaeaeaeaLaLaLaLaLaLaLaLaLaLaMaNaOaNaPahaeaeaeaeaeaeaeaeaeaeaeaeaeaeaeaeaeaeaeabababababababababababababababaaaaaaaaaaaaaaaaaaaaaaaa
aaaaaaaaaaaaaaaaaaaaaaaaabababacacacacacacacacacacacacacacacacacacacabaeaeaeaLaLaLaLaLaLaLaLaLaLaNaNaNaNaQahaeaeaeahaeaeaeaeaeaeaeaeaeaeaeaeaeaeaeababababababababababababababababaaaaaaaaaaaaaaaaaaaaaa
aaaaaaaaaaaaaaaaaaaaaaaaabababacacacacacacacacacacacacacacacacacacacabaeaeaeaLaLaLaLaLaLaLaLaLaLaMaNaRaNaSahaeaeaeaeaeaeaeaeaeaeaeaeaeaeaeaeaeaeaeabababababababababababababababaaaaaaaaaaaaaaaaaaaaaaaa
aaaaaaaaaaaaaaaaaaaaaaaaabababacacacacacacacacacacacacacacacacacacacabaeaeaeahaTaTaTaUadaAaAaAadaVaWaWaNahahaeaeaeahaeaeaeaeaeaeaeaeaeaeaeaeaeababababababababababababababababababaaaaaaaaaaaaaaaaaaaaaa
aaaaaaaaaaaaaaaaaaaaaaaaaaabababacacacacacacacacacacacacacacacacacacabaeaeaeabaCaCaCaDadaAaAaAadahahahahahadaeaeaeahaeaXaXaXaXaXaXaXaXaXaYabababababababababababababababababababaaaaaaaaaaaaaaaaaaaaaaaa
aaaaaaaaaaaaaaaaaaaaaaaaaaabababacacacacacacacacacacacacacacacacacacabaeaeaeabadawaCadadaAaAaAadahadadadadadaeaeaeabatababahahahabahahahabababababababababababababababababababababaaaaaaaaaaaaaaaaaaaaaa
aaaaaaaaaaaaaaaaaaaaaaaaaaabababacacacacacacacacacacacacacacacacacacabaeaeaeabawawawaxadaAaAaBadahadadadadadaeaeaeabatababaaaaaaaaaaaaaaababababababababababababababababababababababaaaaaaaaaaaaaaaaaaaa
aaaaaaaaaaaaaaaaaaaaaaaaaaaaabababacacacacacacacacacacacacacacacacacabaeaeaeabaZaZaZbaadadayayazahadadadadadaeaeaeabatababahahahabahahahabababababababababababababababababababababababaaaaaaaaaaaaaaaaaa
aaaaaaaaaaaaaaaaaaaaaaaaaaaaabababacacacacacacacacacacacacacacacacacabagagagabahahahahahahahahahahadadadadadaeaeaeahatatatatatatatatatatatatatatatatatatatatatatababababababababababababaaaaaaaaaaaaaaaa
aaaaaaaaaaaaaaaaaaaaaaaaaaaaabababacacacacacacacacacacacacacacacacacabaeaeaeaeadadadadadadadadadadadadadadabaeaeaeahatatavavavavavavavavavavavavavavavavavavavavavavavavavavavavavavataaaaaaaaaaaaaaaaaa
aaaaaaaaaaaaaaaaaaaaaaaaaaaaaaabababacacacacacacacacacacacacacacacacabaeaeaeaeaeaeaeaeaeaeaeaeaeaeaeaeaeaeaeaeaeaeahatatatatatatatatatatatatatatatatatatatatatatababababababababababababaaaaaaaaaaaaaaaa
aaaaaaaaaaaaaaaaaaaaaaaaaaaaaaaaabababacacacacacacacacacacacacacacacabaeaeaeaeaeaeaeaeaeaeaeaeaeaeaeaeaeaeaeaeaeaeabatababahahahabahahahabababababababababababababababababababababababaaaaaaaaaaaaaaaaaa
aaaaaaaaaaaaaaaaaaaaaaaaaaaaaaaaabababacacacacacacacacacacacacacacacabagagagababababababababababababbbbcababaeaeaeabatababaaaaaaaaaaaaaaaaabababababababababababababababababababababaaaaaaaaaaaaaaaaaaaa
aaaaaaaaaaaaaaaaaaaaaaaaaaaaaaaaabababacacacacacacacacacacacacacacacabaeaeaeabbdbeapapapapapapapbfahapapbgabaeaeaeabatababahahahabahahahabababababababababababababababababababababaaaaaaaaaaaaaaaaaaaaaa
aaaaaaaaaaaaaaaaaaaaaaaaaaaaaaaaaaababacacacacacacacacacacacacacacacabaeaeaeabapapapapapapapapapapahapapbgabaeaeaeabatatatatatatatatatatatatatatatatababababababababababababababaaaaaaaaaaaaaaaaaaaaaaaa
aaaaaaaaaaaaaaaaaaaaaaaaaaaaaaaaaaababacacacacacacacacacacacacacacacabaeaeaeabbhapapapapapapapapapbiapapbgabaeaeaeababababahahahabahahahababatabatatabababababababababababababababaaaaaaaaaaaaaaaaaaaaaa
aaaaaaaaaaaaaaaaaaaaaaaaaaaaaaaaaaababahahahabacacacacacacacacacacacabaeaeaeabapapapapapapapapapababbjbkababaeaeaeabasacacacacacacacacacacacacabatabababababababababababababababaaaaaaaaaaaaaaaaaaaaaaaa
aaaaaaaaaaaaaaaaaaaaaaaaaaaaaaaaaaaaahacacacahacacacacacacacacacacacabaeaeaeabapapapapapapapapapabblblblbmabaeaeaeabaeadaeaeadaeaeadaeaeadaeaeadadababababababababababababababababaaaaaaaaaaaaaaaaaaaaaa
aaaaaaaaaaaaaaaaaaaaaaaaaaaaaaaaaaaaahacacacacacacacacacacacacacacacabaeaeaeabapapapapapapapapapblblblblbnabaeaeaeahaeadaeaeadaeaeadaeaeadaeaeadababababababababababababababababaaaaaaaaaaaaaaaaaaaaaaaa
aaaaaaaaaaaaafafafaaafafafaaafafafaaahacacacahacacacacacacacacacacacabaeaeaeabapapapapapapapapapboblblblbpabaeaeaeahaeadaeaeadaeaeadaeaeadaeaeadabababababababababababababababababaaaaaaaaaaaaaaaaaaaaaa
aaaaaaaaaaaaafafafaaafafafaaafafafaaabahacahababacacacacacacacacacacabaeaeaeabapapapapapapapapapabblblblbmabaeaeaeagaeadaeaeadaeaeadaeaeadaeaeadabaiarabababababababababababababaaaaaaaaaaaaaaaaaaaaaaaa
aaaaaaaaaaaaafafafaaafafafaaafafafaaaaaaafaaabababacacacacacacacacacabaeaeaeabahbqahahahbcahahahabahbjbkahabaeaeaeagaeadaeaeadaeaeadaeaeadaeaeadacacacababababababababababababababaaaaaaaaaaaaaaaaaaaaaa
aaaaaaaaaaaaafafafaaafafafaaafafafaaaaaaafaaabababacacacacacacacacacabaeaeaeabapapbrahbsapapapapbtapapapbuabaeaeaeahahadahahadahahadahahadahahadabaqacababababababababababababaaaaaaaaaaaaaaaaaaaaaaaaaa
aaaaaaaaaaaaafafafaaafafafaaafafafaaaaaaafaaaaabababacacacacacacacacabaeaeaeabbvapbwabbxapapapapahbfapapbuabaeaeaeahacacacacacacacacacacacacacacababacababababababababababaaaaaaaaaaaaaaaaaaaaaaaaaaaaaa
aaaaaaaaaaaaafafafaaafafafaaafafafaaaaaaafaaaaabababacacacacacacacacabaeaeaeabbybzbAabbBbCbDbDbCahbfapapbuabaeaeaeabamacamamacamanacananacanaoacaoabacabababababababababaaaaaaaaaaaaaaaaaaaaaaaaaaaaaaaa
aaaaaaaaaaaaafafafaaafafafaaafafafaaaaaaafaaaaaaabababacacacacacacacabagagagababababababababababababababababaeaeaeabamacamamacamanacananacanaoacaoabacabababababababaaaaaaaaaaaaaaaaaaaaaaaaaaaaaaaaaaaa
aaaaaaaaaaaaafafafafafafafafafafafafafafafaaaaaaabababababababababababaeaeaeaeaeaeaeaeaeaeaeaeaeaeaeaeaeaeagaeaeaeabababababababababababababababababacalababababaaaaaaaaaaaaaaaaaaaaaaaaaaaaaaaaaaaaaaaa
aaaaaaaaaaaaafafafaaafafafaaafafafaaaaaaafaaaaaaaaabababacacacacacacabaeaeaeaeaeaeaeaeaeaeaeaeaeaeaeaeaeaeagaeaeaeacacacacacacacacacacacacacacacacacacababababaaaaaaaaaaaaaaaaaaaaaaaaaaaaaaaaaaaaaaaaaa
aaaaaaaaaaaaafafafaaafafafaaafafafaaafafafafafaaaaaaabababacbEbEbEacakaeaeaeaeaeaeaeaeaeaeaeaeaeaeaeaeaeaeagaeaeaeabacabababababababababababababababahabababaaaaaaaaaaaaaaaaaaaaaaaaaaaaaaaaaaaaaaaaaaaa
aaaaaaaaaaaaafafafaaafafafaaafafafaaafafafafafaaaaaaaaabababaiaiaiacabagagagababahahahabababahahahabababababababababacababababababababababababababaaaaaaaaaaaaaaaaaaaaaaaaaaaaaaaaaaaaaaaaaaaaaaaaaaaaaa
aaaaaaaaaaaaafafafaaafafafaaafafafaaaaaaafaaaaaaaaaaaaaaabababababacacaeaeaeaeaeaeaeaeaeaeaeaeaeaeaeacacacacacacacacacabababababababaaaaaaaaaaaaaaaaaaaaaaaaaaaaaaaaaaaaaaaaaaaaaaaaaaaaaaaaaaaaaaaaaaaa
aaaaaaaaaaaaafafafaaafafafaaafafafaaafafafafafaaaaaaaaaaaaababababababaeaeaeaeaeaeaeaeaeaeaeaeaeaeaeababababababababababababaaaaaaaaaaaaaaaaaaaaaaaaaaaaaaaaaaaaaaaaaaaaaaaaaaaaaaaaaaaaaaaaaaaaaaaaaaaa
aaaaaaaaaaaaafafafaaafafafaaafafafaaafafafafafaaaaaaaaaaaaaaabababababaeaeaeaeaeaeaeaeaeaeaeaeaeaeaeadababababababababaaaaaaaaaaaaaaaaaaaaaaaaaaaaaaaaaaaaaaaaaaaaaaaaaaaaaaaaaaaaaaaaaaaaaaaaaaaaaaaaaa
aaaaaaaaaaaaafafafaaafafafaaafafafaaaaaaaaaaaaaaaaaaaaaaaaaaabababababaeaeaeaeaeaeaeaeaeaeaeaeaeaeaeababababababababaaaaaaaaaaaaaaaaaaaaaaaaaaaaaaaaaaaaaaaaaaaaaaaaaaaaaaaaaaaaaaaaaaaaaaaaaaaaaaaaaaaa
aaaaaaaaaaaaaaaaaaaaaaaaaaaaaaaaaaaaaaaaaaaaaaaaaaaaaaaaaaaaaaababababaeaeaeaeaeaeaeaeaeaeaeaeaeaeaeatababababababababaaaaaaaaaaaaaaaaaaaaaaaaaaaaaaaaaaaaaaaaaaaaaaaaaaaaaaaaaaaaaaaaaaaaaaaaaaaaaaaaaa
aaaaaaaaaaaaaaaaaaaaaaaaaaaaaaaaaaaaaaaaaaaaaaaaaaaaaaaaaaaaaaababababaeaeaeaeaeaeaeaeaeaeaeaeaeaeaeatatababababababababaaaaaaaaaaaaaaaaaaaaaaaaaaaaaaaaaaaaaaaaaaaaaaaaaaaaaaaaaaaaaaaaaaaaaaaaaaaaaaaa
aaaaaaaaaaaaaaaaaaaaaaaaaaaaaaaaaaaaaaaaaaaaaaaaaaaaaaaaaaaaaaababababaeaeaeaeaeaeaeaeaeaeaeaeaeaeaeatatatababababababababaaaaaaaaaaaaaaaaaaaaaaaaaaaaaaaaaaaaaaaaaaaaaaaaaaaaaaaaaaaaaaaaaaaaaaaaaaaaaa
aaaaaaaaaaaaaaaaaaaaaaaaaaaaaaaaaaaaaaaaaaaaaaaaaaaaaaaaaaaaaaababababaeaeaeaeaeaeaeaeaeaeaeaeaeaeaeatatatatatatatatatataaaaaaaaaaaaaaaaaaaaaaaaaaaaaaaaaaaaaaaaaaaaaaaaaaaaaaaaaaaaaaaaaaaaaaaaaaaaaaaa
aaaaaaaaaaaaaaaaaaaaaaaaaaaaaaaaaaaaaaaaaaaaaaaaaaaaaaaaaaaaaaaaabababaeaeaeaeaeaeaeaeaeaeaeaeaeaeaeatatatababababababababaaaaaaaaaaaaaaaaaaaaaaaaaaaaaaaaaaaaaaaaaaaaaaaaaaaaaaaaaaaaaaaaaaaaaaaaaaaaaa
aaaaaaaaaaaaaaaaaaaaaaaaaaaaaaaaaaaaaaaaaaaaaaaaaaaaaaaaaaaaaaaaabababaeaeaeaeaeaeaeaeaeaeaeaeaeaeaeatatababababababababaaaaaaaaaaaaaaaaaaaaaaaaaaaaaaaaaaaaaaaaaaaaaaaaaaaaaaaaaaaaaaaaaaaaaaaaaaaaaaaa
aaaaaaaaaaaaaaaaaaaaaaaaaaaaaaaaaaaaaaaaaaaaaaaaaaaaaaaaaaaaaaaaaaabababadabadabadaeaeaeadabadabadabatababababababababaaaaaaaaaaaaaaaaaaaaaaaaaaaaaaaaaaaaaaaaaaaaaaaaaaaaaaaaaaaaaaaaaaaaaaaaaaaaaaaaaa
aaaaaaaaaaaaaaaaaaaaaaaaaaaaaaaaaaaaaaaaaaaaaaaaaaaaaaaaaaaaaaaaaaabababababababababacabababababababababababababababaaaaaaaaaaaaaaaaaaaaaaaaaaaaaaaaaaaaaaaaaaaaaaaaaaaaaaaaaaaaaaaaaaaaaaaaaaaaaaaaaaaa
aaaaaaaaaaaaaaaaaaaaaaaaaaaaaaaaaaaaaaaaaaaaaaaaaaaaaaaaaaaaaaaaaaaaabababacacacacacacacacacacacacacacababababababababaaaaaaaaaaaaaaaaaaaaaaaaaaaaaaaaaaaaaaaaaaaaaaaaaaaaaaaaaaaaaaaaaaaaaaaaaaaaaaaaaa
aaaaaaaaaaaaaaaaaaaaaaaaaaaaaaaaaaaaaaaaaaaaaaaaaaaaaaaaaaaaaaaaaaaaabababacacacacacacacacacacacacacababababababababaaaaaaaaaaaaaaaaaaaaaaaaaaaaaaaaaaaaaaaaaaaaaaaaaaaaaaaaaaaaaaaaaaaaaaaaaaaaaaaaaaaa
aaaaaaaaaaaaaaaaaaaaaaaaaaaaaaaaaaaaaaaaaaaaaaaaaaaaaaaaaaaaaaaaaaaaaaabababacacacacacacacacacacacacacababababababababaaaaaaaaaaaaaaaaaaaaaaaaaaaaaaaaaaaaaaaaaaaaaaaaaaaaaaaaaaaaaaaaaaaaaaaaaaaaaaaaaa
aaaaaaaaaaaaaaaaaaaaaaaaaaaaaaaaaaaaaaaaaaaaaaaaaaaaaaaaaaaaaaaaaaaaaaaaabababababababababababababababababababababaaaaaaaaaaaaaaaaaaaaaaaaaaaaaaaaaaaaaaaaaaaaaaaaaaaaaaaaaaaaaaaaaaaaaaaaaaaaaaaaaaaaaa
aaaaaaaaaaaaaaaaaaaaaaaaaaaaaaaaaaaaaaaaaaaaaaaaaaaaaaaaaaaaaaaaaaaaaaaaaaaaababababababababababababababababaaaaaaaaaaaaaaaaaaaaaaaaaaaaaaaaaaaaaaaaaaaaaaaaaaaaaaaaaaaaaaaaaaaaaaaaaaaaaaaaaaaaaaaaaaaa
aaaaaaaaaaaaaaaaaaaaaaaaaaaaaaaaaaaaaaaaaaaaaaaaaaaaaaaaaaaaaaaaaaaaaaaaaaaaaaaaaaaaababababababababaaaaaaaaaaaaaaaaaaaaaaaaaaaaaaaaaaaaaaaaaaaaaaaaaaaaaaaaaaaaaaaaaaaaaaaaaaaaaaaaaaaaaaaaaaaaaaaaaaaa
aaaaaaaaaaaaaaaaaaaaaaaaaaaaaaaaaaaaaaaaaaaaaaaaaaaaaaaaaaaaaaaaaaaaaaaaaaaaaaaaaaaaaaaaaaaaaaaaaaaaaaaaaaaaaaaaaaaaaaaaaaaaaaaaaaaaaaaaaaaaaaaaaaaaaaaaaaaaaaaaaaaaaaaaaaaaaaaaaaaaaaaaaaaaaaaaaaaaaaaa
"}
