//MAP CONVERTED BY dmm2tgm.py THIS HEADER COMMENT PREVENTS RECONVERSION, DO NOT REMOVE
"a" = (
/obj/structure/railing/mapped,
/obj/effect/floor_decal/industrial/warning/dust,
/obj/effect/decal/cleanable/dirt,
/turf/simulated/floor/exoplanet/concrete,
/area/map_template/icarus)
"b" = (
/turf/simulated/floor/tiled/techfloor,
/area/map_template/icarus)
"c" = (
/obj/effect/wallframe_spawn/reinforced_phoron,
/turf/simulated/wall/r_wall,
/area/map_template/icarus)
"e" = (
/obj/machinery/mining/brace,
/turf/template_noop,
/area/map_template/icarus)
"f" = (
/obj/structure/grille,
/obj/structure/rubble/war,
/turf/simulated/floor/exoplanet/concrete,
/area/map_template/icarus)
"g" = (
/obj/structure/railing/mapped{
	dir = 8;
	icon_state = "railing0-1"
	},
/obj/machinery/computer/mining,
/obj/structure/table/steel_reinforced,
/obj/effect/decal/cleanable/dirt,
/obj/effect/decal/cleanable/dirt,
/turf/simulated/floor/exoplanet/concrete,
/area/map_template/icarus)
"h" = (
/obj/structure/railing/mapped{
	dir = 8;
	icon_state = "railing0-1"
	},
/turf/simulated/floor/tiled/techfloor,
/area/map_template/icarus)
"i" = (
/obj/structure/table/steel_reinforced,
/turf/simulated/floor/bluegrid,
/area/map_template/icarus)
"j" = (
/obj/machinery/door/airlock/hatch,
/turf/simulated/floor/exoplanet/concrete,
/area/map_template/icarus)
"k" = (
/obj/machinery/light/spot,
/turf/simulated/floor/tiled/techfloor,
/area/map_template/icarus)
"l" = (
/obj/structure/railing/mapped,
/turf/simulated/floor/bluegrid,
/area/map_template/icarus)
"m" = (
/obj/machinery/mining/drill,
/obj/machinery/mining/brace,
/turf/template_noop,
/area/map_template/icarus)
"n" = (
/obj/machinery/computer/mining,
/obj/structure/table/steel_reinforced,
/obj/effect/decal/cleanable/dirt,
/obj/structure/railing/mapped{
	dir = 8;
	icon_state = "railing0-1"
	},
/turf/simulated/floor/exoplanet/concrete,
/area/map_template/icarus)
"o" = (
/obj/structure/grille,
/obj/structure/grille,
/obj/structure/rubble/war,
/turf/simulated/floor/exoplanet/concrete,
/area/map_template/icarus)
"p" = (
/obj/structure/railing/mapped,
/obj/structure/table/steel_reinforced,
/turf/simulated/floor/bluegrid,
/area/map_template/icarus)
"q" = (
/obj/machinery/portable_atmospherics/canister/oxygen,
/obj/structure/railing/mapped{
	dir = 8;
	icon_state = "railing0-1"
	},
/obj/structure/railing/mapped,
/turf/simulated/floor/exoplanet/concrete,
/area/map_template/icarus)
"r" = (
/obj/structure/grille,
/turf/simulated/floor/exoplanet/concrete,
/area/map_template/icarus)
"s" = (
/turf/simulated/wall/r_wall,
/area/map_template/icarus)
"t" = (
/obj/structure/railing/mapped{
	dir = 8;
	icon_state = "railing0-1"
	},
/obj/machinery/conveyor_switch{
	id = "colonymine"
	},
/obj/effect/floor_decal/industrial/outline/yellow,
/obj/effect/decal/cleanable/dirt,
/turf/simulated/floor/tiled/steel_ridged,
/area/map_template/icarus)
"u" = (
/obj/structure/railing/mapped,
/obj/effect/floor_decal/industrial/warning/dust,
/obj/effect/floor_decal/industrial/outline/yellow,
/obj/effect/floor_decal/industrial/loading{
	dir = 1
	},
/obj/effect/decal/cleanable/dirt,
/turf/simulated/floor/exoplanet/concrete,
/area/map_template/icarus)
"v" = (
/obj/machinery/mineral/stacking_machine{
	input_turf = 8;
	output_turf = 4
	},
/obj/effect/floor_decal/industrial/outline/yellow,
/turf/simulated/floor/tiled/steel_ridged,
/area/map_template/icarus)
"w" = (
/obj/machinery/computer/rcon,
/turf/simulated/floor/bluegrid,
/area/map_template/icarus)
"x" = (
/obj/structure/bed/chair{
	dir = 8
	},
/turf/simulated/floor/bluegrid,
/area/map_template/icarus)
"y" = (
/obj/machinery/light/spot{
	dir = 1
	},
/turf/simulated/floor/tiled/techfloor,
/area/map_template/icarus)
"z" = (
/obj/machinery/mining/drill,
/turf/template_noop,
/area/map_template/icarus)
"A" = (
/obj/machinery/power/apc/debug,
/turf/simulated/floor/tiled/techfloor,
/area/map_template/icarus)
"B" = (
/obj/machinery/light/spot{
	dir = 1
	},
/obj/structure/table/steel_reinforced,
/turf/simulated/floor/tiled/techfloor,
/area/map_template/icarus)
"C" = (
/obj/effect/decal/cleanable/dirt,
/obj/structure/railing/mapped,
/obj/structure/railing/mapped{
	dir = 8;
	icon_state = "railing0-1"
	},
/obj/machinery/recharge_station,
/turf/simulated/floor/exoplanet/concrete,
/area/map_template/icarus)
"D" = (
/obj/structure/ore_box,
/turf/template_noop,
/area/map_template/icarus)
"E" = (
/turf/simulated/floor/exoplanet/concrete,
/area/map_template/icarus)
"F" = (
/obj/structure/railing/mapped,
/obj/effect/floor_decal/industrial/warning/dust,
/obj/effect/decal/cleanable/dirt,
/obj/effect/decal/cleanable/dirt,
/obj/structure/ore_box,
/obj/item/ore/iron,
/obj/item/ore/iron,
/obj/item/ore/iron,
/obj/item/ore/iron,
/obj/item/ore/iron,
/obj/item/ore/iron,
/obj/item/ore/iron,
/obj/item/ore/iron,
/obj/item/ore/iron,
/obj/item/ore/iron,
/obj/item/ore/iron,
/obj/item/ore/iron,
/obj/item/ore/iron,
/obj/item/ore/iron,
/obj/item/ore/iron,
/obj/item/ore/iron,
/obj/item/ore/iron,
/obj/item/ore/iron,
/obj/item/ore/iron,
/obj/item/ore/iron,
/obj/item/ore/iron,
/obj/item/ore/iron,
/obj/item/ore/iron,
/obj/item/ore/iron,
/obj/item/ore/iron,
/obj/item/ore/iron,
/obj/item/ore/iron,
/obj/item/ore/iron,
/obj/item/ore/iron,
/obj/item/ore/iron,
/turf/simulated/floor/exoplanet/concrete,
/area/map_template/icarus)
"G" = (
/obj/effect/decal/cleanable/dirt,
/obj/effect/decal/cleanable/dirt,
/turf/simulated/floor/exoplanet/concrete,
/area/map_template/icarus)
"H" = (
/obj/machinery/mineral/processing_unit{
	input_turf = 2;
	output_turf = 1
	},
/obj/effect/floor_decal/industrial/outline/yellow,
/turf/simulated/floor/tiled/steel_ridged,
/area/map_template/icarus)
"I" = (
/obj/structure/railing/mapped,
/turf/simulated/floor/tiled/techfloor,
/area/map_template/icarus)
"J" = (
/turf/simulated/floor/bluegrid,
/area/map_template/icarus)
"K" = (
/obj/structure/grille,
/obj/structure/grille,
/turf/simulated/floor/exoplanet/concrete,
/area/map_template/icarus)
"L" = (
/obj/effect/decal/cleanable/dirt,
/obj/effect/decal/cleanable/dirt,
/obj/structure/ore_box,
/obj/item/ore/rutile,
/obj/item/ore/rutile,
/obj/item/ore/rutile,
/obj/item/ore/rutile,
/obj/item/ore/rutile,
/obj/item/ore/rutile,
/obj/item/ore/rutile,
/obj/item/ore/rutile,
/obj/item/ore/rutile,
/obj/item/ore/rutile,
/obj/item/ore/rutile,
/obj/item/ore/rutile,
/obj/item/ore/rutile,
/obj/item/ore/rutile,
/obj/item/ore/rutile,
/obj/item/ore/rutile,
/obj/item/ore/rutile,
/obj/item/ore/rutile,
/obj/item/ore/rutile,
/obj/item/ore/rutile,
/obj/item/ore/rutile,
/obj/item/ore/rutile,
/obj/item/ore/rutile,
/obj/item/ore/rutile,
/obj/item/ore/rutile,
/obj/item/ore/rutile,
/obj/item/ore/rutile,
/obj/item/ore/rutile,
/obj/item/ore/rutile,
/obj/item/ore/rutile,
/obj/item/ore/rutile,
/obj/item/ore/rutile,
/obj/item/ore/rutile,
/obj/item/ore/rutile,
/obj/item/ore/rutile,
/obj/item/ore/rutile,
/obj/item/ore/rutile,
/obj/item/ore/rutile,
/obj/item/ore/rutile,
/obj/item/ore/rutile,
/obj/item/ore/rutile,
/obj/item/ore/rutile,
/obj/item/ore/rutile,
/obj/item/ore/rutile,
/obj/item/ore/rutile,
/obj/item/ore/rutile,
/obj/item/ore/rutile,
/obj/item/ore/rutile,
/obj/item/ore/rutile,
/obj/item/ore/rutile,
/obj/item/ore/rutile,
/obj/item/ore/rutile,
/obj/item/ore/rutile,
/obj/item/ore/rutile,
/obj/item/ore/rutile,
/obj/item/ore/rutile,
/obj/item/ore/iron,
/obj/item/ore/iron,
/obj/item/ore/iron,
/obj/item/ore/iron,
/obj/item/ore/iron,
/obj/item/ore/iron,
/obj/item/ore/iron,
/obj/item/ore/iron,
/obj/item/ore/iron,
/obj/item/ore/iron,
/obj/item/ore/iron,
/obj/item/ore/iron,
/turf/simulated/floor/exoplanet/concrete,
/area/map_template/icarus)
"M" = (
/obj/structure/ore_box,
/obj/structure/ore_box,
/turf/template_noop,
/area/map_template/icarus)
"N" = (
/obj/machinery/computer/rcon{
	dir = 8
	},
/turf/simulated/floor/bluegrid,
/area/map_template/icarus)
"O" = (
/obj/structure/rubble/war,
/turf/simulated/wall/r_wall,
/area/map_template/icarus)
"P" = (
/obj/effect/decal/cleanable/dirt,
/turf/simulated/floor/exoplanet/concrete,
/area/map_template/icarus)
"Q" = (
/turf/template_noop,
/area/map_template/icarus)
"R" = (
/obj/machinery/mining/brace,
/obj/machinery/mining/brace,
/turf/template_noop,
/area/map_template/icarus)
"S" = (
/obj/structure/table/steel_reinforced,
/turf/simulated/floor/tiled/techfloor,
/area/map_template/icarus)
"T" = (
/obj/machinery/light/spot,
/obj/structure/table/steel_reinforced,
/turf/simulated/floor/tiled/techfloor,
/area/map_template/icarus)
"U" = (
/obj/effect/floor_decal/industrial/outline/yellow,
/obj/effect/floor_decal/industrial/loading{
	dir = 4
	},
/obj/effect/decal/cleanable/dirt,
/turf/simulated/floor/exoplanet/concrete,
/area/map_template/icarus)
"V" = (
/obj/machinery/mineral/unloading_machine{
	input_turf = 2;
	output_turf = 1
	},
/obj/effect/floor_decal/industrial/outline/yellow,
/turf/simulated/floor/tiled/steel_ridged,
/area/map_template/icarus)
"W" = (
/obj/structure/rubble/war,
/turf/simulated/floor/exoplanet/concrete,
/area/map_template/icarus)
"X" = (
/obj/structure/bed/chair{
	dir = 8
	},
/turf/simulated/floor/tiled/techfloor,
/area/map_template/icarus)
"Y" = (
/obj/machinery/door/airlock/hatch,
/turf/simulated/floor/tiled/techfloor,
/area/map_template/icarus)
"Z" = (
/obj/machinery/conveyor{
	id = "colonymine"
	},
/turf/simulated/floor/tiled/steel_ridged,
/area/map_template/icarus)

(1,1,1) = {"
r
r
r
r
r
r
r
r
r
r
r
r
r
r
r
r
r
r
r
r
"}
(2,1,1) = {"
r
E
E
E
E
E
E
E
E
E
E
E
E
E
E
E
E
E
E
r
"}
(3,1,1) = {"
r
E
s
s
c
c
c
s
s
Q
Q
Z
Z
Z
H
Z
V
u
W
r
"}
(4,1,1) = {"
r
E
j
b
X
b
X
b
j
Q
Q
v
n
t
g
q
C
a
W
f
"}
(5,1,1) = {"
r
E
s
B
S
b
S
T
s
Q
Q
U
G
G
G
G
P
a
W
f
"}
(6,1,1) = {"
r
E
s
c
c
s
c
c
s
Q
Q
Z
Z
Z
H
Z
V
u
W
f
"}
(7,1,1) = {"
E
P
P
P
E
E
E
E
E
E
E
v
n
t
g
q
C
a
W
f
"}
(8,1,1) = {"
E
E
E
E
E
E
E
E
E
E
E
U
G
G
G
G
P
a
W
r
"}
(9,1,1) = {"
r
E
s
E
E
s
s
s
Q
Q
Q
Z
Z
Z
H
Z
V
u
E
r
"}
(10,1,1) = {"
r
E
s
Y
Y
s
A
s
D
D
Q
v
n
t
g
q
C
a
E
K
"}
(11,1,1) = {"
r
E
s
b
b
b
b
s
D
M
Q
U
G
G
G
G
P
a
E
r
"}
(12,1,1) = {"
r
E
s
b
b
b
b
s
s
Q
Q
P
P
P
P
G
L
F
E
K
"}
(13,1,1) = {"
r
E
s
y
b
b
b
k
s
Q
Q
e
Q
e
Q
e
Q
e
E
r
"}
(14,1,1) = {"
r
E
s
I
J
J
l
b
s
Q
Q
z
Q
z
Q
m
Q
m
E
K
"}
(15,1,1) = {"
r
E
s
I
w
x
l
b
s
Q
Q
e
Q
e
Q
e
Q
R
E
r
"}
(16,1,1) = {"
r
E
s
I
i
N
p
b
s
Q
Q
e
Q
e
Q
e
Q
e
E
K
"}
(17,1,1) = {"
f
W
s
y
h
h
h
k
s
Q
Q
z
Q
z
Q
z
Q
m
E
r
"}
(18,1,1) = {"
f
W
O
s
s
s
s
s
s
Q
Q
e
Q
e
Q
e
Q
e
E
f
"}
(19,1,1) = {"
r
W
W
W
W
E
E
E
E
E
E
E
E
E
E
E
E
W
W
f
"}
(20,1,1) = {"
K
r
r
r
f
r
r
r
r
r
r
r
r
r
r
r
f
f
f
o
"}
