"aa" = (/turf/space,/area/space)
"ab" = (/turf/simulated/wall/r_wall,/area/om_ships/hum_ert)
"ac" = (/turf/simulated/floor/plating,/area/om_ships/hum_ert)
"ad" = (/obj/machinery/fusion_thruster/fueled{tag = "icon-nozzle1 (WEST)"; icon_state = "nozzle1"; dir = 8},/turf/simulated/floor/plating,/area/om_ships/hum_ert)
"ae" = (/obj/effect/hull_segment,/turf/simulated/wall/r_wall,/area/om_ships/hum_ert)
"af" = (/obj/machinery/light/spot{dir = 1},/turf/simulated/floor/plating,/area/om_ships/hum_ert)
"ag" = (/obj/machinery/door/airlock/halo_maint,/turf/simulated/floor/tiled,/area/om_ships/hum_ert)
"ah" = (/obj/structure/bed/chair,/turf/simulated/floor/tiled,/area/om_ships/hum_ert)
"ai" = (/obj/structure/bed/chair,/obj/machinery/light/spot{dir = 1},/turf/simulated/floor/tiled,/area/om_ships/hum_ert)
"aj" = (/turf/simulated/floor/tiled,/area/om_ships/hum_ert)
"ak" = (/obj/machinery/light/spot{dir = 1},/obj/effect/floor_decal/industrial/warning/dust/corner,/turf/simulated/floor/tiled,/area/om_ships/hum_ert)
"al" = (/obj/effect/floor_decal/industrial/warning/dust,/turf/simulated/floor/tiled,/area/om_ships/hum_ert)
"am" = (/obj/machinery/light/spot{dir = 1},/obj/effect/floor_decal/industrial/warning/dust,/turf/simulated/floor/tiled,/area/om_ships/hum_ert)
"an" = (/obj/effect/floor_decal/industrial/warning/dust,/obj/machinery/light/spot{dir = 1},/turf/simulated/floor/tiled,/area/om_ships/hum_ert)
"ao" = (/obj/effect/floor_decal/industrial/warning/dust/corner{tag = "icon-warningcorner_dust (WEST)"; icon_state = "warningcorner_dust"; dir = 8},/turf/simulated/floor/tiled,/area/om_ships/hum_ert)
"ap" = (/obj/structure/window/reinforced/treated{tag = "icon-fwindow (SOUTHWEST)"; icon_state = "fwindow"; dir = 10},/obj/structure/grille,/turf/simulated/floor/plating,/area/om_ships/hum_ert)
"aq" = (/obj/machinery/telecomms/relay/long_range_emergency,/turf/simulated/floor/tiled,/area/om_ships/hum_ert)
"ar" = (/obj/machinery/telecomms/relay/ship_relay,/turf/simulated/floor/tiled,/area/om_ships/hum_ert)
"as" = (/obj/machinery/overmap_comms/receiver,/turf/simulated/floor/tiled,/area/om_ships/hum_ert)
"at" = (/obj/effect/floor_decal/industrial/warning/dust{tag = "icon-warning_dust (EAST)"; icon_state = "warning_dust"; dir = 4},/turf/simulated/floor/tiled,/area/om_ships/hum_ert)
"au" = (/obj/structure/sign/warning/fall,/turf/simulated/wall/r_wall,/area/om_ships/hum_ert)
"av" = (/obj/structure/window/reinforced/projresist{dir = 1; icon_state = "rwindow"; tag = "icon-rwindow (WEST)"},/obj/machinery/light/spot{dir = 8},/turf/simulated/floor/tiled/dark,/area/om_ships/hum_ert)
"ax" = (/obj/structure/window/reinforced/projresist{dir = 1; icon_state = "rwindow"; tag = "icon-rwindow (WEST)"},/turf/simulated/floor/tiled/dark,/area/om_ships/hum_ert)
"ay" = (/obj/structure/window/reinforced/projresist{dir = 1; icon_state = "rwindow"; tag = "icon-rwindow (WEST)"},/obj/structure/window/reinforced/projresist{dir = 8; icon_state = "rwindow"; tag = "icon-rwindow (WEST)"},/obj/structure/window/reinforced/projresist{dir = 4; icon_state = "rwindow"; tag = "icon-rwindow (WEST)"},/obj/machinery/vending/armory/commandovend,/turf/simulated/floor/tiled/dark,/area/om_ships/hum_ert)
"az" = (/obj/structure/window/reinforced/projresist{dir = 1; icon_state = "rwindow"; tag = "icon-rwindow (WEST)"},/obj/structure/window/reinforced/projresist{dir = 8; icon_state = "rwindow"; tag = "icon-rwindow (WEST)"},/obj/structure/window/reinforced/projresist{dir = 4; icon_state = "rwindow"; tag = "icon-rwindow (WEST)"},/obj/machinery/vending/armory/commandovend/armour,/turf/simulated/floor/tiled/dark,/area/om_ships/hum_ert)
"aB" = (/obj/structure/window/reinforced/projresist{dir = 1; icon_state = "rwindow"; tag = "icon-rwindow (WEST)"},/obj/structure/window/reinforced/projresist{dir = 8; icon_state = "rwindow"; tag = "icon-rwindow (WEST)"},/obj/structure/window/reinforced/projresist{dir = 4; icon_state = "rwindow"; tag = "icon-rwindow (WEST)"},/obj/machinery/vending/armory/police,/turf/simulated/floor/tiled/dark,/area/om_ships/hum_ert)
"aC" = (/obj/structure/window/reinforced/projresist{dir = 1; icon_state = "rwindow"; tag = "icon-rwindow (WEST)"},/obj/structure/window/reinforced/projresist{dir = 8; icon_state = "rwindow"; tag = "icon-rwindow (WEST)"},/obj/structure/window/reinforced/projresist{dir = 4; icon_state = "rwindow"; tag = "icon-rwindow (WEST)"},/obj/machinery/vending/armory/odstvend/vend_2{req_access = newlist()},/turf/simulated/floor/tiled/dark,/area/om_ships/hum_ert)
"aD" = (/obj/structure/window/reinforced/projresist{dir = 1; icon_state = "rwindow"; tag = "icon-rwindow (WEST)"},/obj/structure/window/reinforced/projresist{dir = 8; icon_state = "rwindow"; tag = "icon-rwindow (WEST)"},/obj/structure/window/reinforced/projresist{dir = 4; icon_state = "rwindow"; tag = "icon-rwindow (WEST)"},/obj/machinery/vending/armory/heavy{req_access = newlist()},/turf/simulated/floor/tiled/dark,/area/om_ships/hum_ert)
"aE" = (/obj/structure/window/reinforced/projresist{dir = 1; icon_state = "rwindow"; tag = "icon-rwindow (WEST)"},/obj/machinery/light/spot{dir = 4},/turf/simulated/floor/tiled/dark,/area/om_ships/hum_ert)
"aF" = (/obj/structure/sign/warning/moving_parts,/turf/simulated/wall/r_wall,/area/om_ships/hum_ert)
"aG" = (/obj/effect/floor_decal/industrial/warning/dust{tag = "icon-warning_dust (WEST)"; icon_state = "warning_dust"; dir = 8},/obj/structure/window/reinforced/projresist{dir = 1; icon_state = "rwindow"; tag = "icon-rwindow (WEST)"},/obj/structure/window/reinforced/projresist{dir = 2; icon_state = "rwindow"; tag = "icon-rwindow (WEST)"},/obj/structure/window/reinforced/projresist{dir = 8; icon_state = "rwindow"; tag = "icon-rwindow (WEST)"},/obj/structure/grille,/turf/simulated/floor/tiled,/area/om_ships/hum_ert)
"aH" = (/obj/structure/window/reinforced/projresist{dir = 1; icon_state = "rwindow"; tag = "icon-rwindow (WEST)"},/obj/structure/window/reinforced/projresist{dir = 4; icon_state = "rwindow"; tag = "icon-rwindow (WEST)"},/obj/structure/window/reinforced/projresist{dir = 2; icon_state = "rwindow"; tag = "icon-rwindow (WEST)"},/obj/structure/grille,/turf/simulated/floor/tiled,/area/om_ships/hum_ert)
"aI" = (/obj/machinery/light/spot{dir = 1},/obj/structure/window/reinforced/projresist{dir = 4; icon_state = "rwindow"; tag = "icon-rwindow (WEST)"},/obj/structure/window/reinforced/projresist{dir = 8; icon_state = "rwindow"; tag = "icon-rwindow (WEST)"},/obj/structure/window/reinforced/projresist{dir = 1; icon_state = "rwindow"; tag = "icon-rwindow (WEST)"},/obj/structure/window/reinforced/projresist{dir = 2; icon_state = "rwindow"; tag = "icon-rwindow (WEST)"},/obj/structure/grille,/turf/simulated/floor/tiled,/area/om_ships/hum_ert)
"aJ" = (/obj/machinery/computer/navigation{tag = "icon-engine (WEST)"; icon = 'code/modules/halo/icons/machinery/computer.dmi'; icon_state = "engine"; dir = 8},/obj/structure/computerframe{anchored = 1; dir = 8; icon = 'code/modules/halo/icons/machinery/computer.dmi'; icon_state = "computer"; layer = 2; level = 1; tag = "icon-computer (WEST)"},/turf/simulated/floor/tiled,/area/om_ships/hum_ert)
"aK" = (/obj/structure/bed/chair/comfy/captain{tag = "icon-capchair_preview (WEST)"; icon_state = "capchair_preview"; dir = 8},/turf/simulated/floor/tiled,/area/om_ships/hum_ert)
"aL" = (/obj/machinery/light/spot{dir = 1},/turf/simulated/floor/tiled,/area/om_ships/hum_ert)
"aM" = (/obj/machinery/light/spot{dir = 4},/turf/simulated/floor/tiled,/area/om_ships/hum_ert)
"aN" = (/obj/structure/window/reinforced/projresist{tag = "icon-rwindow (WEST)"; icon_state = "rwindow"; dir = 8},/obj/machinery/light/spot{dir = 1},/turf/simulated/floor/tiled/dark,/area/om_ships/hum_ert)
"aO" = (/turf/simulated/floor/tiled/dark,/area/om_ships/hum_ert)
"aP" = (/obj/machinery/light/spot{dir = 1},/turf/simulated/floor/tiled/dark,/area/om_ships/hum_ert)
"aQ" = (/obj/effect/floor_decal/industrial/warning/dust{tag = "icon-warning_dust (WEST)"; icon_state = "warning_dust"; dir = 8},/obj/structure/window/reinforced/projresist{dir = 1; icon_state = "rwindow"; tag = "icon-rwindow (WEST)"},/obj/structure/window/reinforced/projresist{dir = 2; icon_state = "rwindow"; tag = "icon-rwindow (WEST)"},/turf/simulated/floor/tiled,/area/om_ships/hum_ert)
"aR" = (/obj/structure/window/reinforced/projresist{dir = 2; icon_state = "rwindow"; tag = "icon-rwindow (WEST)"},/obj/structure/window/reinforced/projresist{dir = 1; icon_state = "rwindow"; tag = "icon-rwindow (WEST)"},/turf/simulated/floor/tiled,/area/om_ships/hum_ert)
"aS" = (/obj/structure/window/reinforced/projresist{dir = 1; icon_state = "rwindow"; tag = "icon-rwindow (WEST)"},/obj/structure/window/reinforced/projresist{dir = 2; icon_state = "rwindow"; tag = "icon-rwindow (WEST)"},/turf/simulated/floor/tiled,/area/om_ships/hum_ert)
"aT" = (/obj/machinery/computer/helm{tag = "icon-nav (WEST)"; icon = 'code/modules/halo/icons/machinery/computer.dmi'; icon_state = "nav"; dir = 8; icon_keyboard = ""; icon_screen = "covie_console_overlay"},/obj/structure/computerframe{anchored = 1; dir = 8; icon = 'code/modules/halo/icons/machinery/computer.dmi'; icon_state = "computer"; layer = 2; level = 1; tag = "icon-computer (WEST)"},/turf/simulated/floor/tiled,/area/om_ships/hum_ert)
"aU" = (/obj/machinery/door/airlock/halo{name = "Bridge"},/turf/simulated/floor/tech,/area/om_ships/hum_ert)
"aV" = (/obj/structure/window/reinforced/projresist{dir = 2; icon_state = "rwindow"; tag = "icon-rwindow (WEST)"},/obj/structure/window/reinforced/projresist{dir = 1; icon_state = "rwindow"; tag = "icon-rwindow (WEST)"},/turf/simulated/floor/tiled/dark,/area/om_ships/hum_ert)
"aW" = (/obj/effect/floor_decal/industrial/warning/dust{tag = "icon-warning_dust (WEST)"; icon_state = "warning_dust"; dir = 8},/obj/structure/window/reinforced/projresist{dir = 8; icon_state = "rwindow"; tag = "icon-rwindow (WEST)"},/obj/structure/window/reinforced/projresist{dir = 1; icon_state = "rwindow"; tag = "icon-rwindow (WEST)"},/obj/structure/window/reinforced/projresist{dir = 2; icon_state = "rwindow"; tag = "icon-rwindow (WEST)"},/obj/structure/grille,/turf/simulated/floor/tiled,/area/om_ships/hum_ert)
"aX" = (/obj/structure/window/reinforced/projresist{dir = 4; icon_state = "rwindow"; tag = "icon-rwindow (WEST)"},/obj/structure/window/reinforced/projresist{dir = 1; icon_state = "rwindow"; tag = "icon-rwindow (WEST)"},/obj/structure/window/reinforced/projresist{dir = 2; icon_state = "rwindow"; tag = "icon-rwindow (WEST)"},/obj/structure/grille,/turf/simulated/floor/tiled,/area/om_ships/hum_ert)
"aY" = (/obj/structure/window/reinforced/projresist{dir = 8; icon_state = "rwindow"; tag = "icon-rwindow (WEST)"},/obj/structure/window/reinforced/projresist{dir = 4; icon_state = "rwindow"; tag = "icon-rwindow (WEST)"},/obj/structure/window/reinforced/projresist{dir = 2; icon_state = "rwindow"; tag = "icon-rwindow (WEST)"},/obj/structure/window/reinforced/projresist{dir = 1; icon_state = "rwindow"; tag = "icon-rwindow (WEST)"},/obj/structure/grille,/turf/simulated/floor/tiled,/area/om_ships/hum_ert)
"aZ" = (/obj/machinery/computer/engines{dir = 8; icon = 'code/modules/halo/icons/machinery/computer.dmi'; icon_state = "nav"; tag = "icon-nav (NORTH)"},/obj/structure/computerframe{anchored = 1; dir = 8; icon = 'code/modules/halo/icons/machinery/computer.dmi'; icon_state = "computer"; layer = 2; level = 1; tag = "icon-computer (WEST)"},/turf/simulated/floor/tiled,/area/om_ships/hum_ert)
"ba" = (/obj/machinery/light/spot,/turf/simulated/floor/tiled,/area/om_ships/hum_ert)
"bb" = (/obj/structure/window/reinforced/projresist{tag = "icon-rwindow (WEST)"; icon_state = "rwindow"; dir = 8},/obj/machinery/door/window/northleft,/turf/simulated/floor/tiled,/area/om_ships/hum_ert)
"bc" = (/obj/machinery/power/apc/infinite{dir = 4; icon_state = "apc0"; pixel_x = 32; tag = "icon-apc0 (EAST)"},/obj/machinery/light/spot{dir = 4},/obj/structure/window/reinforced/projresist{tag = "icon-rwindow (EAST)"; icon_state = "rwindow"; dir = 4},/obj/machinery/door/window/northright,/turf/simulated/floor/tiled,/area/om_ships/hum_ert)
"bd" = (/obj/structure/window/reinforced/projresist{tag = "icon-rwindow (WEST)"; icon_state = "rwindow"; dir = 8},/obj/machinery/light/spot{dir = 2},/turf/simulated/floor/tiled/dark,/area/om_ships/hum_ert)
"be" = (/obj/machinery/light/spot{dir = 2},/turf/simulated/floor/tiled/dark,/area/om_ships/hum_ert)
"bf" = (/obj/docking_umbilical/east{pixel_x = 0},/turf/simulated/wall/r_wall,/area/om_ships/hum_ert)
"bg" = (/obj/machinery/nav_computer/npc/unsc,/turf/simulated/floor/tiled,/area/om_ships/hum_ert)
"bh" = (/obj/machinery/slipspace_engine/human,/obj/structure/window/reinforced/projresist,/obj/structure/window/reinforced/projresist{tag = "icon-rwindow (WEST)"; icon_state = "rwindow"; dir = 8},/turf/simulated/floor/tiled,/area/om_ships/hum_ert)
"bi" = (/obj/structure/window/reinforced/projresist,/obj/structure/window/reinforced/projresist{tag = "icon-rwindow (EAST)"; icon_state = "rwindow"; dir = 4},/turf/simulated/floor/tiled,/area/om_ships/hum_ert)
"bj" = (/obj/structure/window/reinforced/projresist{dir = 2; icon_state = "rwindow"; tag = "icon-rwindow (WEST)"},/obj/machinery/light/spot{dir = 8},/turf/simulated/floor/tiled/dark,/area/om_ships/hum_ert)
"bk" = (/obj/structure/window/reinforced/projresist{dir = 2; icon_state = "rwindow"; tag = "icon-rwindow (WEST)"},/obj/structure/window/reinforced/projresist{dir = 4; icon_state = "rwindow"; tag = "icon-rwindow (WEST)"},/obj/structure/window/reinforced/projresist{dir = 8; icon_state = "rwindow"; tag = "icon-rwindow (WEST)"},/obj/machinery/vending/armory/armor{req_access = newlist()},/turf/simulated/floor/tiled/dark,/area/om_ships/hum_ert)
"bl" = (/obj/structure/window/reinforced/projresist{dir = 2; icon_state = "rwindow"; tag = "icon-rwindow (WEST)"},/turf/simulated/floor/tiled/dark,/area/om_ships/hum_ert)
"bp" = (/obj/structure/window/reinforced/projresist{dir = 2; icon_state = "rwindow"; tag = "icon-rwindow (WEST)"},/obj/structure/window/reinforced/projresist{dir = 4; icon_state = "rwindow"; tag = "icon-rwindow (WEST)"},/obj/structure/window/reinforced/projresist{dir = 8; icon_state = "rwindow"; tag = "icon-rwindow (WEST)"},/obj/machinery/vending/armory/police{req_access = newlist()},/turf/simulated/floor/tiled/dark,/area/om_ships/hum_ert)
"bq" = (/obj/structure/window/reinforced/projresist{dir = 2; icon_state = "rwindow"; tag = "icon-rwindow (WEST)"},/obj/structure/window/reinforced/projresist{dir = 4; icon_state = "rwindow"; tag = "icon-rwindow (WEST)"},/obj/structure/window/reinforced/projresist{dir = 8; icon_state = "rwindow"; tag = "icon-rwindow (WEST)"},/obj/machinery/vending/armory/odstvend{req_access = newlist()},/turf/simulated/floor/tiled/dark,/area/om_ships/hum_ert)
"br" = (/obj/structure/window/reinforced/projresist{dir = 2; icon_state = "rwindow"; tag = "icon-rwindow (WEST)"},/obj/structure/window/reinforced/projresist{dir = 4; icon_state = "rwindow"; tag = "icon-rwindow (WEST)"},/obj/structure/window/reinforced/projresist{dir = 8; icon_state = "rwindow"; tag = "icon-rwindow (WEST)"},/obj/machinery/vending/armory/hybrid{req_access = newlist()},/turf/simulated/floor/tiled/dark,/area/om_ships/hum_ert)
"bs" = (/obj/structure/window/reinforced/projresist{dir = 2; icon_state = "rwindow"; tag = "icon-rwindow (WEST)"},/obj/structure/window/reinforced/projresist{dir = 4; icon_state = "rwindow"; tag = "icon-rwindow (WEST)"},/obj/structure/window/reinforced/projresist{dir = 8; icon_state = "rwindow"; tag = "icon-rwindow (WEST)"},/obj/machinery/vending/armory/attachment{req_access = newlist()},/turf/simulated/floor/tiled/dark,/area/om_ships/hum_ert)
"bt" = (/obj/structure/window/reinforced/projresist{dir = 2; icon_state = "rwindow"; tag = "icon-rwindow (WEST)"},/obj/structure/window/reinforced/projresist{dir = 8; icon_state = "rwindow"; tag = "icon-rwindow (WEST)"},/obj/structure/window/reinforced/projresist{dir = 4; icon_state = "rwindow"; tag = "icon-rwindow (WEST)"},/obj/machinery/vending/armory/armor{req_access = newlist()},/turf/simulated/floor/tiled/dark,/area/om_ships/hum_ert)
"bu" = (/obj/structure/window/reinforced/projresist{dir = 2; icon_state = "rwindow"; tag = "icon-rwindow (WEST)"},/obj/machinery/light/spot{dir = 4},/turf/simulated/floor/tiled/dark,/area/om_ships/hum_ert)
"bv" = (/obj/effect/floor_decal/industrial/warning/dust{tag = "icon-warning_dust (WEST)"; icon_state = "warning_dust"; dir = 8},/obj/structure/window/reinforced/projresist{dir = 8; icon_state = "rwindow"; tag = "icon-rwindow (WEST)"},/obj/structure/window/reinforced/projresist{dir = 2; icon_state = "rwindow"; tag = "icon-rwindow (WEST)"},/obj/structure/window/reinforced/projresist{dir = 1; icon_state = "rwindow"; tag = "icon-rwindow (WEST)"},/obj/structure/grille,/turf/simulated/floor/tiled,/area/om_ships/hum_ert)
"bw" = (/obj/structure/window/reinforced/projresist{dir = 4; icon_state = "rwindow"; tag = "icon-rwindow (WEST)"},/obj/structure/window/reinforced/projresist{dir = 2; icon_state = "rwindow"; tag = "icon-rwindow (WEST)"},/obj/structure/window/reinforced/projresist{dir = 1; icon_state = "rwindow"; tag = "icon-rwindow (WEST)"},/obj/structure/window/reinforced/projresist{dir = 4; icon_state = "rwindow"; tag = "icon-rwindow (WEST)"},/obj/structure/grille,/turf/simulated/floor/tiled,/area/om_ships/hum_ert)
"bx" = (/obj/machinery/light/spot,/obj/structure/window/reinforced/projresist{dir = 4; icon_state = "rwindow"; tag = "icon-rwindow (WEST)"},/obj/structure/window/reinforced/projresist{dir = 8; icon_state = "rwindow"; tag = "icon-rwindow (WEST)"},/obj/structure/window/reinforced/projresist{dir = 2; icon_state = "rwindow"; tag = "icon-rwindow (WEST)"},/obj/structure/window/reinforced/projresist{dir = 1; icon_state = "rwindow"; tag = "icon-rwindow (WEST)"},/obj/structure/grille,/turf/simulated/floor/tiled,/area/om_ships/hum_ert)
"by" = (/obj/machinery/light/spot,/obj/effect/floor_decal/industrial/warning/dust/corner{tag = "icon-warningcorner_dust (EAST)"; icon_state = "warningcorner_dust"; dir = 4},/turf/simulated/floor/tiled,/area/om_ships/hum_ert)
"bz" = (/obj/effect/floor_decal/industrial/warning/dust{tag = "icon-warning_dust (NORTH)"; icon_state = "warning_dust"; dir = 1},/turf/simulated/floor/tiled,/area/om_ships/hum_ert)
"bA" = (/obj/machinery/light/spot,/obj/effect/floor_decal/industrial/warning/dust{tag = "icon-warning_dust (NORTH)"; icon_state = "warning_dust"; dir = 1},/turf/simulated/floor/tiled,/area/om_ships/hum_ert)
"bB" = (/obj/effect/floor_decal/industrial/warning/dust{tag = "icon-warning_dust (NORTH)"; icon_state = "warning_dust"; dir = 1},/obj/machinery/light/spot,/turf/simulated/floor/tiled,/area/om_ships/hum_ert)
"bC" = (/obj/effect/floor_decal/industrial/warning/dust/corner{tag = "icon-warningcorner_dust (NORTH)"; icon_state = "warningcorner_dust"; dir = 1},/turf/simulated/floor/tiled,/area/om_ships/hum_ert)
"bD" = (/obj/structure/bed/chair{tag = "icon-chair_preview (NORTH)"; icon_state = "chair_preview"; dir = 1},/turf/simulated/floor/tiled,/area/om_ships/hum_ert)
"bE" = (/obj/structure/bed/chair{tag = "icon-chair_preview (NORTH)"; icon_state = "chair_preview"; dir = 1},/obj/machinery/light/spot,/turf/simulated/floor/tiled,/area/om_ships/hum_ert)
"bF" = (/obj/machinery/light/spot,/turf/simulated/floor/plating,/area/om_ships/hum_ert)

(1,1,1) = {"
aaaaaaaaaaaaaaaaaaaaaaaaaaaaaaaaaaaaaaaaaaaaaaaaaaaaaaaaaaaaaaaaaaaaaaaaaaaaaaaaaaaaaaaaaaaaaaaaaaaa
aaaaaaaaaaaaaaaaaaaaaaaaaaaaaaaaaaaaaaaaaaaaaaaaaaaaaaaaaaaaaaaaaaaaaaaaaaaaaaaaaaaaaaaaaaaaaaaaaaaa
aaaaaaaaaaaaaaaaaaaaaaaaaaaaaaaaaaaaaaaaaaaaaaaaaaaaaaaaaaaaaaaaaaaaaaaaaaaaaaaaaaaaaaaaaaaaaaaaaaaa
aaaaaaaaaaaaaaaaaaaaaaaaaaaaaaaaaaaaaaaaaaaaaaaaaaaaaaaaaaaaaaaaaaaaaaaaaaaaaaaaaaaaaaaaaaaaaaaaaaaa
aaaaaaaaaaaaaaaaaaaaaaaaaaaaaaaaaaaaaaaaaaaaaaaaababababababababaaaaaaababababababababababaaaaaaaaaa
aaaaaaaaaaaaaaaaaaaaaaaaaaaaaaababababaaaaaaababababababababababaaaaabababababababababababaaaaaaaaaa
aaaaaaaaaaaaaaaaaaaaaaaaaaaaababacacadaaaaabababababababababababaaaaabaeafacacacacacafacadaaaaaaaaaa
aaaaaaaaaaaaaaaaaaaaaaaaaaaaabafacacadaaaaabababababababababababaaaaababacacacacacacacacadaaaaaaaaaa
aaaaaaaaaaaaaaaaaaaaabababababacababababababababababababababababababababacacabababababababaaaaaaaaaa
aaaaaaaaaaaaaaababababababaeabagababababababahahahahaiahahahahabababababagabababaaaaaaaaaaaaaaaaaaaa
aaaaaaaaaaaaababababababajajakalamalalalalanalalalalalalalalalanalalalanaoajababababaaaaaaaaaaaaaaaa
aaaaaaaaapapababaqarasabajajatauavaDaxayaxazaxaCaxaBaxaCaxazaxayaxaDaEaFaGaHabaIajababaaaaaaaaaaaaaa
aaaaaaapapaJaKaLajajaMabajajataNaOaOaOaOaOaOaOaOaOaOaOaOaOaOaOaOaOaOaOaPaQaRagaSajababaaaaaaaaaaaaaa
aaaaaaapapaTajajajajajaUajajataVaOaOaOaOaOaOaOaOaOaOaOaOaOaOaOaOaOaOaOaOaWaXabaYajababaaaaaaaaaaaaaa
aaaaaaapapaZaKbaajbbbcabajajatbdaOaOaOaOaOaOaOaOaOaOaOaOaOaOaOaOaOaOaObeaQaRagaSajbfabaaaaaaaaaaaaaa
aaaaaaaaapapababbgbhbiabajajataFbjbkblbsblbrblbqblbpblbqblbrblbsblbtbuaubvbwabbxajababaaaaaaaaaaaaaa
aaaaaaaaaaaaababababababajajbybzbAbzbzbzbzbBbzbzbzbzbzbzbzbzbzbBbzbzbzbBbCajababababaaaaaaaaaaaaaaaa
aaaaaaaaaaaaaaababababababaeabagababababababbDbDbDbDbEbDbDbDbDabababababagabababaaaaaaaaaaaaaaaaaaaa
aaaaaaaaaaaaaaaaaaaaabababababacababababababababababababababababababababacacabababababababaaaaaaaaaa
aaaaaaaaaaaaaaaaaaaaaaaaaaaaabbFacacadaaaaabababababababababababaaaaababacacacacacacacacadaaaaaaaaaa
aaaaaaaaaaaaaaaaaaaaaaaaaaaaababacacadaaaaabababababababababababaaaaabaebFacacacacacbFacadaaaaaaaaaa
aaaaaaaaaaaaaaaaaaaaaaaaaaaaaaababababaaaaaaababababababababababaaaaabababababababababababaaaaaaaaaa
aaaaaaaaaaaaaaaaaaaaaaaaaaaaaaaaaaaaaaaaaaaaaaaaababababababababaaaaaaababababababababababaaaaaaaaaa
aaaaaaaaaaaaaaaaaaaaaaaaaaaaaaaaaaaaaaaaaaaaaaaaaaaaaaaaaaaaaaaaaaaaaaaaaaaaaaaaaaaaaaaaaaaaaaaaaaaa
aaaaaaaaaaaaaaaaaaaaaaaaaaaaaaaaaaaaaaaaaaaaaaaaaaaaaaaaaaaaaaaaaaaaaaaaaaaaaaaaaaaaaaaaaaaaaaaaaaaa
aaaaaaaaaaaaaaaaaaaaaaaaaaaaaaaaaaaaaaaaaaaaaaaaaaaaaaaaaaaaaaaaaaaaaaaaaaaaaaaaaaaaaaaaaaaaaaaaaaaa
aaaaaaaaaaaaaaaaaaaaaaaaaaaaaaaaaaaaaaaaaaaaaaaaaaaaaaaaaaaaaaaaaaaaaaaaaaaaaaaaaaaaaaaaaaaaaaaaaaaa
aaaaaaaaaaaaaaaaaaaaaaaaaaaaaaaaaaaaaaaaaaaaaaaaaaaaaaaaaaaaaaaaaaaaaaaaaaaaaaaaaaaaaaaaaaaaaaaaaaaa
aaaaaaaaaaaaaaaaaaaaaaaaaaaaaaaaaaaaaaaaaaaaaaaaaaaaaaaaaaaaaaaaaaaaaaaaaaaaaaaaaaaaaaaaaaaaaaaaaaaa
aaaaaaaaaaaaaaaaaaaaaaaaaaaaaaaaaaaaaaaaaaaaaaaaaaaaaaaaaaaaaaaaaaaaaaaaaaaaaaaaaaaaaaaaaaaaaaaaaaaa
"}
