"aa" = (/turf/space,/area/space)
"aG" = (/obj/structure/table/steel,/turf/simulated/floor/shuttle/blue,/area/om_ships/comms_station/station1)
"aP" = (/obj/docking_umbilical/south,/turf/simulated/floor/shuttle/black,/area/om_ships/comms_station/station1)
"bw" = (/obj/structure/closet/secure_closet/miner,/turf/simulated/floor/shuttle/yellow,/area/om_ships/comms_station/station1)
"bC" = (/turf/simulated/floor/shuttle/white,/area/om_ships/comms_station/station1)
"bO" = (/mob/living/simple_animal/hostile/russian,/turf/simulated/floor/shuttle/yellow,/area/om_ships/comms_station/station1)
"cI" = (/obj/structure/barricadeunsc,/obj/machinery/light/spot{dir = 8},/turf/simulated/floor/shuttle/black,/area/om_ships/comms_station/station1)
"eJ" = (/obj/machinery/light/spot{dir = 8},/turf/simulated/floor/asteroid,/area/space)
"fd" = (/obj/structure/window/reinforced/projresist{dir = 8},/obj/structure/window/reinforced/projresist{dir = 4},/obj/structure/window/reinforced/projresist{dir = 2},/obj/structure/grille,/turf/simulated/floor/plating,/area/om_ships/comms_station/station1)
"ft" = (/obj/machinery/door/airlock/glass,/turf/simulated/floor/shuttle/black,/area/om_ships/comms_station/station1)
"fu" = (/obj/structure/closet/wardrobe/xenos,/turf/simulated/floor/shuttle/yellow,/area/om_ships/comms_station/station1)
"hV" = (/obj/machinery/light/invis,/turf/simulated/floor/shuttle/yellow,/area/om_ships/comms_station/station1)
"iH" = (/obj/machinery/light/spot{dir = 4},/turf/simulated/floor/shuttle/black,/area/om_ships/comms_station/station1)
"kp" = (/obj/machinery/light/spot,/turf/simulated/floor/shuttle/yellow,/area/om_ships/comms_station/station1)
"mM" = (/turf/simulated/mineral,/area/space)
"nz" = (/obj/structure/tanktrap,/turf/simulated/floor/shuttle/black,/area/om_ships/comms_station/station1)
"pC" = (/obj/machinery/light/spot{dir = 4},/turf/simulated/floor/water/shallow,/area/om_ships/comms_station/station1)
"rf" = (/obj/machinery/light/spot,/turf/simulated/floor/shuttle/blue,/area/om_ships/comms_station/station1)
"sh" = (/turf/simulated/floor/beach/sand/desert,/area/space)
"so" = (/obj/machinery/light/spot{dir = 4},/turf/simulated/floor/asteroid,/area/space)
"tu" = (/obj/structure/table/steel,/obj/item/comms_bypass_key,/turf/simulated/floor/shuttle/blue,/area/om_ships/comms_station/station1)
"tS" = (/obj/structure/window/basic{dir = 8},/turf/simulated/floor/water/shallow,/area/om_ships/comms_station/station1)
"uk" = (/obj/machinery/light/spot{dir = 4},/turf/simulated/floor/shuttle/blue,/area/om_ships/comms_station/station1)
"ut" = (/obj/structure/closet/wardrobe/lawyer_black,/turf/simulated/floor/shuttle/yellow,/area/om_ships/comms_station/station1)
"uv" = (/obj/machinery/door/airlock/maintenance_hatch/bolted,/turf/simulated/floor/shuttle/white,/area/om_ships/comms_station/station1)
"wq" = (/obj/structure/bed,/mob/living/simple_animal/hostile/russian,/turf/simulated/floor/shuttle/yellow,/area/om_ships/comms_station/station1)
"wv" = (/obj/machinery/light/spot{dir = 8},/turf/simulated/floor/shuttle/yellow,/area/om_ships/comms_station/station1)
"xj" = (/mob/living/simple_animal/hostile/russian/ranged,/turf/simulated/floor/shuttle/yellow,/area/om_ships/comms_station/station1)
"zf" = (/turf/simulated/floor/water,/area/om_ships/comms_station/station1)
"AB" = (/obj/structure/table/steel,/obj/structure/table/steel,/turf/simulated/floor/shuttle/blue,/area/om_ships/comms_station/station1)
"CK" = (/turf/simulated/floor/shuttle/blue,/area/om_ships/comms_station/station1)
"Ea" = (/obj/structure/closet/wardrobe/engineering_yellow,/turf/simulated/floor/shuttle/yellow,/area/om_ships/comms_station/station1)
"FV" = (/turf/simulated/floor/water/shallow,/area/om_ships/comms_station/station1)
"Gi" = (/obj/structure/curtain/open,/turf/simulated/floor/shuttle/yellow,/area/om_ships/comms_station/station1)
"Gr" = (/obj/structure/barricadeunsc{dir = 4},/turf/simulated/floor/shuttle/black,/area/om_ships/comms_station/station1)
"Hc" = (/obj/structure/bed,/turf/simulated/floor/shuttle/yellow,/area/om_ships/comms_station/station1)
"Hl" = (/obj/machinery/telecomms/relay/ship_relay,/turf/simulated/floor/shuttle/blue,/area/om_ships/comms_station/station1)
"Ht" = (/obj/structure/closet/wardrobe/mixed,/turf/simulated/floor/shuttle/yellow,/area/om_ships/comms_station/station1)
"Hx" = (/turf/simulated/mineral,/area/om_ships/comms_station/station1)
"II" = (/obj/machinery/light/spot{dir = 8},/turf/simulated/floor/shuttle/black,/area/om_ships/comms_station/station1)
"IZ" = (/obj/machinery/telecomms/receiver,/turf/simulated/floor/shuttle/blue,/area/om_ships/comms_station/station1)
"JA" = (/turf/simulated/floor/asteroid,/area/space)
"KM" = (/obj/machinery/light/spot{dir = 1},/turf/simulated/floor/shuttle/blue,/area/om_ships/comms_station/station1)
"Ln" = (/obj/machinery/telecomms/relay/long_range_emergency,/turf/simulated/floor/shuttle/blue,/area/om_ships/comms_station/station1)
"Nf" = (/turf/simulated/wall,/area/om_ships/comms_station/station1)
"NH" = (/obj/structure/window/basic{dir = 8},/obj/machinery/light/spot{dir = 8},/turf/simulated/floor/water/shallow,/area/om_ships/comms_station/station1)
"Or" = (/obj/structure/window/reinforced/projresist{dir = 8},/obj/structure/window/reinforced/projresist{dir = 4},/obj/structure/window/reinforced/projresist{dir = 1},/obj/structure/grille,/turf/simulated/floor/plating,/area/om_ships/comms_station/station1)
"Pr" = (/obj/machinery/telecomms/allinone,/obj/machinery/light/spot{dir = 8},/turf/simulated/floor/shuttle/blue,/area/om_ships/comms_station/station1)
"Rp" = (/obj/structure/barricadeunsc,/turf/simulated/floor/shuttle/black,/area/om_ships/comms_station/station1)
"Rz" = (/turf/simulated/floor/shuttle/black,/area/om_ships/comms_station/station1)
"SG" = (/mob/living/simple_animal/hostile/russian/ranged,/turf/simulated/floor/shuttle/black,/area/om_ships/comms_station/station1)
"SY" = (/mob/living/simple_animal/hostile/russian,/turf/simulated/floor/shuttle/black,/area/om_ships/comms_station/station1)
"TO" = (/obj/machinery/light/spot{dir = 1},/turf/simulated/floor/shuttle/yellow,/area/om_ships/comms_station/station1)
"Ua" = (/obj/structure/curtain,/turf/simulated/floor/shuttle/yellow,/area/om_ships/comms_station/station1)
"Ud" = (/obj/machinery/light/spot,/turf/simulated/floor/shuttle/black,/area/om_ships/comms_station/station1)
"Vp" = (/obj/structure/closet/secure_closet/cargotech,/turf/simulated/floor/shuttle/yellow,/area/om_ships/comms_station/station1)
"Wo" = (/obj/structure/window/reinforced/projresist{dir = 8},/obj/structure/window/reinforced/projresist{dir = 4},/obj/structure/grille,/turf/simulated/floor/plating,/area/om_ships/comms_station/station1)
"YX" = (/obj/structure/bookcase,/turf/simulated/floor/shuttle/yellow,/area/om_ships/comms_station/station1)
"Zi" = (/turf/simulated/floor/shuttle/yellow,/area/om_ships/comms_station/station1)
"Zo" = (/obj/machinery/light/spot{dir = 1},/turf/simulated/floor/shuttle/black,/area/om_ships/comms_station/station1)
"ZZ" = (/turf/simulated/wall/r_wall,/area/om_ships/comms_station/station1)

(1,1,1) = {"
aaaaaaaaaaaaaaaaaaaaaaaaaaaaaaaaaaaaaaaaaaaaaaaaaaaaaaaaaaaaaaaaaaaaaaaaaaaaaaaaaaaaaaaaaaaaaaaaaaaaaaaaaaaaaaaaaaaaaaaaaaaaaaaaaaaaaaaaaaaaaaaaaaaaaa
aaaaaaaaaaaaaaaaaaaaaaaaaaaaaaaaaaaaaaaaaaaaaaaaaaaaaaaaaaaaaaaaaaaaaaaaaaaaaaaaaaaaaaaaaaaaaaaaaaaaaaaaaaaaaaaaaaaaaaaaaaaaaaaaaaaaaaaaaaaaaaaaaaaaaa
aaaaaaaaaaaaaaaaaaaaaaaaaaaaaaaaaaaaaaaaaaaaaaaaaaaaaaaaaaaaaaaaaaaaaaaaaaaaaaaaaaaaaaaaaaaaaaaaaaaaaaaaaaaaaaaaaaaaaaaaaaaaaaaaaaaaaaaaaaaaaaaaaaaaaa
aaaaaaaaaaaaaaaaaaaaaaaaaaaaaaaaaaaaaaaaaaaaaaaaaaaaaaaaaaaaaaaaaaaaaaaaaaaaaaaaaaaaaaaaaaaaaaaaaaaaaaaaaaaaaaaaaaaaaaaaaaaaaaaaaaaaaaaaaaaaaaaaaaaaaa
aaaaaaaaaaaaaaaaaaaaaaaaaaaaaaaaaaaaaaaaaaaaaaaaaaaaaaaaaaaaaaaaaaaaaaaaaaaaaaaaaaaaaaaaaaaaaaaaaaaaaaaaaaaaaaaaaaaaaaaaaaaaaaaaaaaaaaaaaaaaaaaaaaaaaa
aaaaaaaaaaaaaaaaaaaaaaaaaaaaaaaaaaaaaaaaaaaaaaaaaaaaaaaaaaaaaaaaaaaaaaaaaaaaaaaaaaaaaaaaaaaaaaaaaaaaaaaaaaaaaaaaaaaaaaaaaaaaaaaaaaaaaaaaaaaaaaaaaaaaaa
aaaaaaaaaaaaaaaaaaaaaaaaaaaaaaaaaaaaaaaaaaaaaaaaaaaaaaaaaaaaaaaaaaaaaaaaaaaaaaaaaaaaaaaaaaaaaaaaaaaaaaaaaaaaaaaaaaaaaaaaaaaaaaaaaaaaaaaaaaaaaaaaaaaaaa
aaaaaaaaaaaaaaaaaaaaaaaaaaaaaaaaaaaaaaaaaaaaaaaaaaaaaaaaaaaaaaaaaaaaaaaaaaaaaaaaaaaaaaaaaaaaaaaaaaaaaaaaaaaaaaaaaaaaaaaaaaaaaaaaaaaaaaaaaaaaaaaaaaaaaa
aaaaaaaaaaaaaaaaaaaaaaaaaaaaaaaaaaaaaaaaaaaaaaaaaaaaaaaaaaaaaaaaaaaaaaaaaaaaaaaaaaaaaaaaaaaaaaaamMmMmMaaaaaaaaaaaaaaaaaaaaaaaaaaaaaaaaaaaaaaaaaaaaaaaa
aaaaaaaaaaaaaaaaaaaaaaaaaaaaaaaaaaaaaaaaaaaaaaaaaaaaaaaaaaaaaaaaaaaaaaaaaaaaaaaamMmMmMmMmMmMmMmMmMmMmMmMmMmMaaaaaaaaaaaaaaaaaaaaaaaaaaaaaaaaaaaaaaaaaa
aaaaaaaaaaaaaaaaaaaaaaaaaaaaaaaaaaaaaaaaaaaaaaaaaaaamMmMmMmMmMmMmMmMmMmMmMmMmMmMmMmMmMmMmMmMmMmMmMmMmMmMmMmMaaaaaaaaaaaaaaaaaaaaaaaaaaaaaaaaaaaaaaaaaa
aaaaaaaaaaaaaaaaaaaaaaaaaaaaaaaaaaaaaaaaaaaaaaaaaamMmMmMmMmMmMmMmMmMmMmMmMmMmMmMmMmMmMmMmMmMmMmMmMmMmMmMmMmMaaaaaaaaaaaaaaaaaaaaaaaaaaaaaaaaaaaaaaaaaa
aaaaaaaaaaaaaaaaaaaaaaaaaaaaaaaaaaaamMmMmMmMmMmMmMmMmMmMmMmMmMmMmMmMmMmMmMmMmMmMmMmMmMmMmMmMmMmMmMmMmMmMmMmMmMaaaaaaaaaaaaaaaaaaaaaaaaaaaaaaaaaaaaaaaa
aaaaaaaaaaaaaaaaaaaaaaaaaaaaaaaaaamMmMmMmMmMmMmMmMmMmMmMmMmMmMmMmMmMmMmMmMmMmMmMmMmMmMmMmMmMmMmMmMmMmMmMmMmMmMaaaaaaaaaaaaaaaaaaaaaaaaaaaaaaaaaaaaaaaa
aaaaaaaaaaaaaaaaaaaaaaaaaaaamMmMmMmMmMmMmMmMmMmMmMmMmMmMmMmMmMmMmMmMmMmMmMmMmMmMmMmMmMmMmMmMmMmMmMmMmMmMmMmMmMmMaaaaaaaaaaaaaaaaaaaaaaaaaaaaaaaaaaaaaa
aaaaaaaaaaaaaaaaaaaaaaaaaamMmMmMmMmMmMmMmMmMmMmMmMmMmMmMmMmMmMmMmMmMmMmMmMmMmMmMmMmMmMmMmMmMmMmMmMmMmMmMmMmMmMmMmMaaaaaaaaaaaaaaaaaaaaaaaaaaaaaaaaaaaa
aaaaaaaaaaaaaaaaaaaaaaaamMmMmMmMmMmMmMmMmMmMmMmMmMmMmMmMmMmMmMmMmMmMmMmMmMmMmMmMmMmMmMmMmMmMmMmMmMmMmMmMmMmMmMmMmMmMaaaaaaaaaaaaaaaaaaaaaaaaaaaaaaaaaa
aaaaaaaaaaaaaaaaaaaaaaaamMmMmMmMmMmMmMmMmMmMmMmMmMmMmMmMmMmMmMmMmMmMmMmMmMmMmMmMmMmMmMmMmMmMmMmMmMmMmMmMmMmMmMmMmMmMmMaaaaaaaaaaaaaaaaaaaaaaaaaaaaaaaa
aaaaaaaaaaaaaaaaaaaaaaaamMmMmMmMmMmMmMmMmMmMmMmMmMmMmMmMmMmMmMmMmMmMmMmMmMmMmMmMmMmMmMmMmMmMmMmMmMmMmMmMmMmMmMmMmMmMmMaaaaaaaaaaaaaaaaaaaaaaaaaaaaaaaa
aaaaaaaaaaaaaaaaaaaaaamMmMmMmMmMmMmMmMmMmMmMmMmMmMmMmMmMmMmMmMmMmMmMmMmMmMmMmMmMmMmMmMmMmMmMmMmMmMmMmMmMmMmMmMmMmMmMmMmMaaaaaaaaaaaaaaaaaaaaaaaaaaaaaa
aaaaaaaaaaaaaaaaaaaaaamMmMmMmMmMmMmMmMmMmMmMmMmMmMmMmMmMmMmMmMmMmMmMmMmMmMmMmMmMmMmMmMmMmMmMmMmMmMmMmMmMmMmMmMmMmMmMmMmMaaaaaaaaaaaaaaaaaaaaaaaaaaaaaa
aaaaaaaaaaaaaaaaaaaaaamMmMmMmMmMmMmMmMmMmMmMmMmMmMmMmMmMmMmMmMmMmMmMmMmMmMmMmMmMmMmMmMmMmMmMmMmMmMmMmMmMmMmMmMmMmMmMmMmMmMaaaaaaaaaaaaaaaaaaaaaaaaaaaa
aaaaaaaaaaaaaaaaaaaaaamMmMmMmMmMmMmMmMmMmMmMmMmMmMmMmMmMmMmMmMmMmMmMmMmMmMmMmMmMmMmMmMmMmMmMmMmMmMmMmMmMmMmMmMmMmMmMmMmMmMaaaaaaaaaaaaaaaaaaaaaaaaaaaa
aaaaaaaaaaaaaaaaaaaaaamMmMmMmMmMmMmMmMmMmMmMmMmMNfNfNfNfNfNfNfNfNfNfNfNfNfNfNfNfNfNfNfNfNfNfNfNfNfNfNfNfNfNfNfNfNfNfNfNfmMaaaaaaaaaaaaaaaaaaaaaaaaaaaa
aaaaaaaaaaaaaaaaaaaaaamMmMmMmMmMmMmMmMmMmMmMmMmMNfRzRzSGGrRzRzRzRzZoRzRzRzRzRzRzZoSGGrRzRzRzRzRzRzRzRzNfbCtSzfzfzfFVFVNfmMaaaaaaaaaaaaaaaaaaaaaaaaaaaa
aaaaaaaaaaaaaaaaaaaaaamMmMmMmMmMmMmMmMmMmMmMmMmMNfIIRzSGRzRzRzRzRzRzRzRzRzRzGrRzRzSGGrRzRzRzRzRzRzRzSYftbCNHzfzfzfzfpCNfmMaaaaaaaaaaaaaaaaaaaaaaaaaaaa
aaaaaaaaaaaaaaaaaaaaaamMmMmMmMmMmMmMmMmMmMmMmMmMNfRzRzSGGrRzRzRzRzUdRzRzRzSGGrRzUdRznzRzRzRzRzUdRzRzRzNfbCtSFVzfzfzfzfNfmMmMaaaaaaaaaaaaaaaaaaaaaaaaaa
aaaaaaaaaaaaaaaaaaaaaamMmMmMmMmMmMmMmMmMmMmMmMmMZZZZRzRzZZZZZZZZZZZZZZZZNfNfNfNfNfNfNfNfNfNfNfNfcIRzRpNfNfNfNfNfNfNfNfNfmMaaaaaaaaaaaaaaaaaaaaaaaaaaaa
aaaaaaaaaaaaaaaaaaaaaamMmMmMmMmMmMmMmMmMmMmMmMmMZZCKCKCKCKCKKMCKCKCKCKZZZiZiZiZiZiTOZiZiZiZiZiNfRzRzRzNfYXYXYXTOUaUaNfmMmMaaaaaaaaaaaaaaaaaaaaaaaaaaaa
aaaaaaaaaaaaaaaaaaaaaamMmMmMmMmMmMmMmMmMmMmMmMmMZZCKCKCKCKCKCKCKCKCKCKuvZiZiZiZiZiZiZiZiZiZiZiNfRzRzRzftZiZiZiZiGiHcNfmMmMaaaaaaaaaaaaaaaaaaaaaaaaaaaa
aaaaaaaaaaaaaaaaaaaaaamMmMmMmMmMmMmMmMmMmMmMmMmMZZIZCKCKABaGaGaGaGCKCKZZZiZiNfZibOZiZixjNfZiZiNfIIRziHNfUaUaZiZiUaUaNfmMmMaaaaaaaaaaaaaaaaaaaaaaaaaaaa
aaaaaaaaaaaaaaaaaaaaaamMmMmMmMmMmMmMmMmMmMmMmMmMZZHlCKCKaGCKCKCKaGCKCKZZZiZiNfHtHtutEaEaNfZiZiNfRzRzRzNfwqUaZiZiGiwqNfmMmMaaaaaaaaaaaaaaaaaaaaaaaaaaaa
aaaaaaaaaaaaaaaaaaaamMmMmMmMmMmMmMmMmMmMmMmMmMmMZZPrCKCKaGCKtuCKaGCKukZZwvZiNfNfNfNfNfNfNfwvZiftSGSGRzNfUaUahVZiUaUaNfmMmMaaaaaaaaaaaaaaaaaaaaaaaaaaaa
aaaaaaaaaaaaaaaaaaaamMmMmMmMmMmMmMmMmMmMmMmMmMmMZZLnCKCKaGCKCKCKaGCKCKZZZiZiNfbwVpVpfufuNfZiZiNfRpRpRzNfHcGiZiZiUawqNfmMmMaaaaaaaaaaaaaaaaaaaaaaaaaaaa
aaaaaaaaaaaaaaaaaaaamMmMmMmMmMmMmMmMmMmMmMmMmMmMZZHxCKCKaGaGaGaGaGCKCKZZZiZiNfZixjZixjZiNfZiZiNfRzRzSGNfUaUaZiZiUaUaNfmMmMmMaaaaaaaaaaaaaaaaaaaaaaaaaa
aaaaaaaaaaaaaaaaaaaamMmMmMmMmMmMmMmMmMmMmMmMmMmMHxCKCKHxCKCKCKCKCKCKCKuvZiZiZiZiZiZiZiZiZiZiZiNfRzRpRpftZiZiZiZiGiwqNfmMmMmMaaaaaaaaaaaaaaaaaaaaaaaaaa
aaaaaaaaaaaaaaaaaaaamMmMmMmMmMmMmMmMmMmMmMmMmMmMHxHxCKCKCKCKrfCKCKCKCKZZZiZiZiZiZikpZiZiZiZiZiNfRzRzSYNfYXYXYXkpUaUaNfmMmMmMaaaaaaaaaaaaaaaaaaaaaaaaaa
aaaaaaaaaaaaaaaaaaaamMmMmMmMmMmMmMmMmMmMmMmMmMmMHxHxZZZZZZZZZZZZZZZZZZZZNfNfNfNfNfNfNfNfNfNfNfNfIISYiHNfNfNfNfNfNfNfNfmMmMmMaaaaaaaaaaaaaaaaaaaaaaaaaa
aaaaaaaaaaaaaaaaaaaamMmMmMmMmMmMmMmMmMmMmMmMmMmMmMmMmMmMmMmMmMmMmMmMmMmMmMmMmMmMmMmMmMJAJAmMJAOrRzRzRzNfJAJAJAmMmMmMmMmMmMshaaaaaaaaaaaaaaaaaaaaaaaaaa
aaaaaaaaaaaaaaaaaaaamMmMmMmMmMmMmMmMmMmMmMmMmMmMmMmMmMmMmMmMmMmMmMmMmMmMmMmMmMmMmMmMmMmMJAJAJAWoRzRzRzOrJAmMJAmMmMmMmMmMshshaaaaaaaaaaaaaaaaaaaaaaaaaa
aaaaaaaaaaaaaaaaaaaamMmMmMmMmMmMmMmMmMmMmMmMmMmMmMmMmMmMmMmMmMmMmMmMmMmMmMmMmMmMmMmMmMmMmMmMJAWoRzRzRzWoJAJAJAmMmMmMmMmMshaaaaaaaaaaaaaaaaaaaaaaaaaaaa
aaaaaaaaaaaaaaaaaaaamMmMmMmMmMmMmMmMmMmMmMmMmMmMmMmMmMmMmMmMmMmMmMmMmMmMmMmMmMmMmMmMmMmMmMmMJAWoRzRzRzWoJAmMmMmMmMmMmMshshaaaaaaaaaaaaaaaaaaaaaaaaaaaa
aaaaaaaaaaaaaaaaaaaamMmMmMmMmMmMmMmMmMmMmMmMmMmMmMmMmMmMmMmMmMmMmMmMmMmMmMmMmMmMmMmMJAJAmMmMeJWoRzRzRzWosomMmMmMmMmMmMshaaaaaaaaaaaaaaaaaaaaaaaaaaaaaa
aaaaaaaaaaaaaaaaaaaamMmMmMmMmMmMmMmMmMmMmMmMmMmMmMmMmMmMmMmMmMmMmMmMmMmMmMmMmMmMmMJAJAJAJAJAJAWoRzRzRzWoJAmMmMmMmMmMshshaaaaaaaaaaaaaaaaaaaaaaaaaaaaaa
aaaaaaaaaaaaaaaaaaaamMmMmMmMmMmMmMmMmMmMmMmMmMmMmMmMmMmMmMmMmMmMmMmMmMmMmMmMmMmMmMJAJAmMJAJAJAWoRzRzRzWoJAmMmMmMshshshaaaaaaaaaaaaaaaaaaaaaaaaaaaaaaaa
aaaaaaaaaaaaaaaaaaaamMmMmMmMmMmMmMmMmMmMmMmMmMmMmMmMmMmMmMmMmMmMmMmMmMmMmMmMmMmMmMJAJAmMJAJAJAfdRzRzRzfdJAmMshshshshshaaaaaaaaaaaaaaaaaaaaaaaaaaaaaaaa
aaaaaaaaaaaaaaaaaaaamMmMmMmMmMmMmMmMmMmMmMmMmMmMmMmMmMmMmMmMmMmMmMmMmMmMmMmMmMmMmMmMmMmMJAJAJAHxRzaPRzHxJAshshshshshshaaaaaaaaaaaaaaaaaaaaaaaaaaaaaaaa
aaaaaaaaaaaaaaaaaaaaaamMmMmMmMmMmMmMmMmMmMmMmMmMmMmMmMmMmMmMmMmMmMmMmMmMmMmMmMmMmMmMmMmMmMJAJAHxHxHxHxHxJAshshshshshaaaaaaaaaaaaaaaaaaaaaaaaaaaaaaaaaa
aaaaaaaaaaaaaaaaaaaaaamMmMmMmMmMmMmMmMmMmMmMmMmMmMmMmMmMmMmMmMmMmMmMmMmMmMmMmMmMmMmMmMmMJAJAJAJAJAJAJAshshshshshshaaaaaaaaaaaaaaaaaaaaaaaaaaaaaaaaaaaa
aaaaaaaaaaaaaaaaaaaaaamMmMmMmMmMmMmMmMmMmMmMmMmMmMmMmMmMmMmMmMmMmMmMmMmMmMmMmMmMmMmMmMmMmMJAJAJAJAJAshshshshshshshaaaaaaaaaaaaaaaaaaaaaaaaaaaaaaaaaaaa
aaaaaaaaaaaaaaaaaaaaaaaamMmMmMmMmMmMmMmMmMmMmMmMmMmMmMmMmMmMmMmMmMmMmMmMmMmMmMmMmMmMmMmMmMmMJAJAmMshshshshshshaaaaaaaaaaaaaaaaaaaaaaaaaaaaaaaaaaaaaaaa
aaaaaaaaaaaaaaaaaaaaaaaamMmMmMmMmMmMmMmMmMmMmMmMmMmMmMmMmMmMmMmMmMmMmMmMmMmMmMmMmMmMmMmMmMmMmMJAmMshshshshshaaaaaaaaaaaaaaaaaaaaaaaaaaaaaaaaaaaaaaaaaa
aaaaaaaaaaaaaaaaaaaaaaaamMmMmMmMmMmMmMmMmMmMmMmMmMmMmMmMmMmMmMmMmMmMmMmMmMmMmMmMmMmMmMmMmMmMmMmMshshshshshaaaaaaaaaaaaaaaaaaaaaaaaaaaaaaaaaaaaaaaaaaaa
aaaaaaaaaaaaaaaaaaaaaaaaaamMmMmMmMmMmMmMmMmMmMmMmMmMmMmMmMmMmMmMmMmMmMmMmMmMmMmMmMmMmMmMmMmMmMshshshshshshaaaaaaaaaaaaaaaaaaaaaaaaaaaaaaaaaaaaaaaaaaaa
aaaaaaaaaaaaaaaaaaaaaaaaaaaamMmMmMmMmMmMmMmMmMmMmMmMmMmMmMmMmMmMmMmMmMmMmMmMmMmMmMmMmMmMmMmMmMshshshshshaaaaaaaaaaaaaaaaaaaaaaaaaaaaaaaaaaaaaaaaaaaaaa
aaaaaaaaaaaaaaaaaaaaaaaaaaaaaamMmMmMmMmMmMmMmMmMmMmMmMmMmMmMmMmMmMmMmMmMmMmMmMmMmMmMmMmMmMmMmMshshshshshaaaaaaaaaaaaaaaaaaaaaaaaaaaaaaaaaaaaaaaaaaaaaa
aaaaaaaaaaaaaaaaaaaaaaaaaaaaaaaamMmMmMmMmMmMmMmMmMmMmMmMmMmMmMmMmMmMmMmMmMmMmMmMmMmMmMmMmMmMmMshshshshaaaaaaaaaaaaaaaaaaaaaaaaaaaaaaaaaaaaaaaaaaaaaaaa
aaaaaaaaaaaaaaaaaaaaaaaaaaaaaaaaaamMmMmMmMmMmMmMmMmMmMmMmMmMmMshshshshmMmMmMmMmMmMmMmMmMmMmMmMshshshshaaaaaaaaaaaaaaaaaaaaaaaaaaaaaaaaaaaaaaaaaaaaaaaa
aaaaaaaaaaaaaaaaaaaaaaaaaaaaaaaaaamMmMmMmMmMmMmMmMmMmMmMmMmMshshshshshshmMmMmMmMmMmMmMmMmMmMshshshshaaaaaaaaaaaaaaaaaaaaaaaaaaaaaaaaaaaaaaaaaaaaaaaaaa
aaaaaaaaaaaaaaaaaaaaaaaaaaaaaaaaaaaamMmMmMmMmMmMmMmMmMmMmMmMshshshshshshshmMmMmMmMmMmMmMmMmMshshshaaaaaaaaaaaaaaaaaaaaaaaaaaaaaaaaaaaaaaaaaaaaaaaaaaaa
aaaaaaaaaaaaaaaaaaaaaaaaaaaaaaaaaaaaaamMmMmMmMmMmMmMmMmMmMmMshshshshshshshshmMmMmMmMmMmMmMmMshshaaaaaaaaaaaaaaaaaaaaaaaaaaaaaaaaaaaaaaaaaaaaaaaaaaaaaa
aaaaaaaaaaaaaaaaaaaaaaaaaaaaaaaaaaaaaaaaaaaaaamMmMmMmMmMmMmMmMshshshshshshshshmMmMmMmMshshshshaaaaaaaaaaaaaaaaaaaaaaaaaaaaaaaaaaaaaaaaaaaaaaaaaaaaaaaa
aaaaaaaaaaaaaaaaaaaaaaaaaaaaaaaaaaaaaaaaaaaaaaaaaaaaaaaaaamMmMmMshshshshshshshshshshshshshshaaaaaaaaaaaaaaaaaaaaaaaaaaaaaaaaaaaaaaaaaaaaaaaaaaaaaaaaaa
aaaaaaaaaaaaaaaaaaaaaaaaaaaaaaaaaaaaaaaaaaaaaaaaaaaaaaaaaaaaaaaaaaaamMshshshshshshshshshshaaaaaaaaaaaaaaaaaaaaaaaaaaaaaaaaaaaaaaaaaaaaaaaaaaaaaaaaaaaa
aaaaaaaaaaaaaaaaaaaaaaaaaaaaaaaaaaaaaaaaaaaaaaaaaaaaaaaaaaaaaaaaaaaaaaaaaaaaaaaaaaaaaaaaaaaaaaaaaaaaaaaaaaaaaaaaaaaaaaaaaaaaaaaaaaaaaaaaaaaaaaaaaaaaaa
aaaaaaaaaaaaaaaaaaaaaaaaaaaaaaaaaaaaaaaaaaaaaaaaaaaaaaaaaaaaaaaaaaaaaaaaaaaaaaaaaaaaaaaaaaaaaaaaaaaaaaaaaaaaaaaaaaaaaaaaaaaaaaaaaaaaaaaaaaaaaaaaaaaaaa
aaaaaaaaaaaaaaaaaaaaaaaaaaaaaaaaaaaaaaaaaaaaaaaaaaaaaaaaaaaaaaaaaaaaaaaaaaaaaaaaaaaaaaaaaaaaaaaaaaaaaaaaaaaaaaaaaaaaaaaaaaaaaaaaaaaaaaaaaaaaaaaaaaaaaa
aaaaaaaaaaaaaaaaaaaaaaaaaaaaaaaaaaaaaaaaaaaaaaaaaaaaaaaaaaaaaaaaaaaaaaaaaaaaaaaaaaaaaaaaaaaaaaaaaaaaaaaaaaaaaaaaaaaaaaaaaaaaaaaaaaaaaaaaaaaaaaaaaaaaaa
aaaaaaaaaaaaaaaaaaaaaaaaaaaaaaaaaaaaaaaaaaaaaaaaaaaaaaaaaaaaaaaaaaaaaaaaaaaaaaaaaaaaaaaaaaaaaaaaaaaaaaaaaaaaaaaaaaaaaaaaaaaaaaaaaaaaaaaaaaaaaaaaaaaaaa
aaaaaaaaaaaaaaaaaaaaaaaaaaaaaaaaaaaaaaaaaaaaaaaaaaaaaaaaaaaaaaaaaaaaaaaaaaaaaaaaaaaaaaaaaaaaaaaaaaaaaaaaaaaaaaaaaaaaaaaaaaaaaaaaaaaaaaaaaaaaaaaaaaaaaa
aaaaaaaaaaaaaaaaaaaaaaaaaaaaaaaaaaaaaaaaaaaaaaaaaaaaaaaaaaaaaaaaaaaaaaaaaaaaaaaaaaaaaaaaaaaaaaaaaaaaaaaaaaaaaaaaaaaaaaaaaaaaaaaaaaaaaaaaaaaaaaaaaaaaaa
aaaaaaaaaaaaaaaaaaaaaaaaaaaaaaaaaaaaaaaaaaaaaaaaaaaaaaaaaaaaaaaaaaaaaaaaaaaaaaaaaaaaaaaaaaaaaaaaaaaaaaaaaaaaaaaaaaaaaaaaaaaaaaaaaaaaaaaaaaaaaaaaaaaaaa
aaaaaaaaaaaaaaaaaaaaaaaaaaaaaaaaaaaaaaaaaaaaaaaaaaaaaaaaaaaaaaaaaaaaaaaaaaaaaaaaaaaaaaaaaaaaaaaaaaaaaaaaaaaaaaaaaaaaaaaaaaaaaaaaaaaaaaaaaaaaaaaaaaaaaa
aaaaaaaaaaaaaaaaaaaaaaaaaaaaaaaaaaaaaaaaaaaaaaaaaaaaaaaaaaaaaaaaaaaaaaaaaaaaaaaaaaaaaaaaaaaaaaaaaaaaaaaaaaaaaaaaaaaaaaaaaaaaaaaaaaaaaaaaaaaaaaaaaaaaaa
aaaaaaaaaaaaaaaaaaaaaaaaaaaaaaaaaaaaaaaaaaaaaaaaaaaaaaaaaaaaaaaaaaaaaaaaaaaaaaaaaaaaaaaaaaaaaaaaaaaaaaaaaaaaaaaaaaaaaaaaaaaaaaaaaaaaaaaaaaaaaaaaaaaaaa
"}

