"az" = (/obj/machinery/light/covenant/south,/turf/simulated/floor/covenant{icon_state = "cov_floor"},/area/om_ships/cov_ert)
"aA" = (/obj/structure/bed/chair/covenant_stool,/turf/simulated/floor/covenant{icon_state = "cov_floor"},/area/om_ships/cov_ert)
"aI" = (/obj/machinery/door/airlock/covenant{name = "Engine Room 1"},/turf/simulated/floor/covenant{icon_state = "cov_floor"},/area/om_ships/cov_ert)
"cs" = (/obj/item/weapon/storage/belt/covenant_ammo,/obj/item/weapon/storage/belt/covenant_ammo,/obj/item/weapon/storage/belt/covenant_ammo,/obj/item/drop_pod_beacon/covenant,/obj/item/drop_pod_beacon/covenant,/obj/item/drop_pod_beacon/covenant,/obj/item/drop_pod_beacon/covenant,/obj/item/drop_pod_beacon/covenant,/obj/structure/closet/crate/covenant{name = "Misc Crate"},/turf/simulated/floor/covenant{tag = "icon-cov_floor"; icon_state = "cov_floor"},/area/om_ships/cov_ert)
"ct" = (/obj/machinery/light/invis,/turf/simulated/floor/covenant{icon_state = "cov_floor"},/area/om_ships/cov_ert)
"fI" = (/obj/machinery/light/covenant/south,/obj/structure/closet/crate/covenant{name = "Covenant Plasma Grenade Crate"},/obj/item/weapon/grenade/plasma,/obj/item/weapon/grenade/plasma,/obj/item/weapon/grenade/plasma,/obj/item/weapon/grenade/plasma,/obj/item/weapon/grenade/plasma,/obj/item/weapon/grenade/plasma,/turf/simulated/floor/covenant{tag = "icon-cov_floor"; icon_state = "cov_floor"},/area/om_ships/cov_ert)
"fS" = (/turf/simulated/wall/covenant,/area/om_ships/cov_ert)
"gR" = (/obj/machinery/slipspace_engine/covenant,/obj/structure/window/reinforced/projresist/covenant,/obj/machinery/door/window/westright,/turf/simulated/floor/covenant{icon_state = "cov_floor"},/area/om_ships/cov_ert)
"hj" = (/obj/structure/window/reinforced/projresist/covenant{tag = "icon-window (NORTH)"; icon_state = "window"; dir = 1},/obj/machinery/door/window/westleft,/turf/simulated/floor/covenant{icon_state = "cov_floor"},/area/om_ships/cov_ert)
"hB" = (/obj/item/weapon/wrench/covenant,/obj/item/weapon/wrench/covenant,/obj/item/weapon/wrench/covenant,/obj/structure/table/rack,/turf/simulated/floor/covenant{tag = "icon-cov_floor"; icon_state = "cov_floor"},/area/om_ships/cov_ert)
"ik" = (/obj/machinery/telecomms/relay/ship_relay{icon = 'code/modules/halo/icons/machinery/covenant/consoles.dmi'; icon_state = "covie_console_off"},/turf/simulated/floor/covenant{icon_state = "cov_floor"},/area/om_ships/cov_ert)
"iS" = (/obj/machinery/light/covenant/north,/turf/simulated/floor/covenant{icon_state = "cov_floor"},/area/om_ships/cov_ert)
"jS" = (/obj/item/weapon/gun/projectile/type51carbine,/obj/item/ammo_magazine/type51mag,/obj/item/ammo_magazine/type51mag,/obj/item/ammo_magazine/type51mag,/obj/item/ammo_magazine/type51mag,/obj/item/ammo_magazine/type51mag,/obj/item/weapon/gun/projectile/type51carbine,/obj/item/ammo_magazine/type51mag,/obj/item/ammo_magazine/type51mag,/obj/item/ammo_magazine/type51mag,/obj/item/ammo_magazine/type51mag,/obj/item/ammo_magazine/type51mag,/obj/item/weapon/gun/energy/beam_rifle,/obj/structure/closet/covenant{name = "Carbine Rack"},/obj/item/weapon/gun/projectile/type51carbine,/obj/item/ammo_magazine/type51mag,/obj/item/ammo_magazine/type51mag,/obj/item/ammo_magazine/type51mag,/obj/item/ammo_magazine/type51mag,/obj/item/ammo_magazine/type51mag,/obj/item/weapon/gun/energy/beam_rifle,/obj/item/weapon/gun/energy/beam_rifle,/turf/simulated/floor/covenant{tag = "icon-cov_floor"; icon_state = "cov_floor"},/area/om_ships/cov_ert)
"kr" = (/obj/docking_umbilical/covenant/south,/turf/simulated/wall/covenant,/area/om_ships/cov_ert)
"lc" = (/obj/machinery/computer/engines{icon = 'code/modules/halo/icons/machinery/covenant/consoles.dmi'; icon_keyboard = ""; icon_screen = "covie_console_overlay"; icon_state = "covie_console_off"},/turf/simulated/floor/covenant{icon_state = "cov_floor"},/area/om_ships/cov_ert)
"oO" = (/obj/structure/closet/crate/covenant{name = "Needler Crate"},/obj/item/weapon/gun/projectile/needler,/obj/item/weapon/gun/projectile/needler,/obj/item/weapon/gun/projectile/needler,/obj/item/ammo_magazine/needles,/obj/item/ammo_magazine/needles,/obj/item/ammo_magazine/needles,/obj/item/ammo_magazine/needles,/obj/item/ammo_magazine/needles,/obj/item/ammo_magazine/needles,/obj/item/ammo_magazine/needles,/obj/item/ammo_magazine/needles,/obj/item/ammo_magazine/needles,/obj/item/weapon/gun/projectile/needler,/obj/item/weapon/gun/projectile/needler,/obj/item/ammo_magazine/needles,/obj/item/ammo_magazine/needles,/obj/item/ammo_magazine/needles,/obj/item/ammo_magazine/needles,/obj/item/ammo_magazine/needles,/obj/item/ammo_magazine/needles,/obj/item/ammo_magazine/needles,/obj/item/ammo_magazine/needles,/turf/simulated/floor/covenant{tag = "icon-cov_floor"; icon_state = "cov_floor"},/area/om_ships/cov_ert)
"qn" = (/obj/machinery/light/covenant/north,/obj/structure/closet/crate/covenant{name = "Covenant Plasma Grenade Crate"},/obj/item/weapon/grenade/plasma,/obj/item/weapon/grenade/plasma,/obj/item/weapon/grenade/plasma,/obj/item/weapon/grenade/plasma,/obj/item/weapon/grenade/plasma,/obj/item/weapon/grenade/plasma,/turf/simulated/floor/covenant{tag = "icon-cov_floor"; icon_state = "cov_floor"},/area/om_ships/cov_ert)
"sW" = (/obj/machinery/light/covenant/west,/obj/structure/closet/crate/covenant,/obj/item/clothing/under/covenant/ranger_kigyar,/obj/item/clothing/under/covenant/ranger_kigyar,/obj/item/clothing/suit/armor/covenant/ranger_kigyar,/obj/item/clothing/suit/armor/covenant/ranger_kigyar,/obj/item/clothing/head/helmet/ranger_kigyar,/obj/item/clothing/head/helmet/ranger_kigyar,/obj/item/clothing/mask/breath,/obj/item/clothing/mask/breath,/turf/simulated/floor/covenant{tag = "icon-cov_floor"; icon_state = "cov_floor"},/area/om_ships/cov_ert)
"te" = (/obj/structure/window/reinforced/projresist/covenant{tag = "icon-window (EAST)"; icon_state = "window"; dir = 4},/obj/structure/window/reinforced/projresist/covenant{tag = "icon-window (NORTH)"; icon_state = "window"; dir = 1},/turf/simulated/floor/covenant{icon_state = "cov_floor"},/area/om_ships/cov_ert)
"tA" = (/obj/docking_umbilical/covenant/north,/turf/simulated/wall/covenant,/area/om_ships/cov_ert)
"uS" = (/obj/item/weapon/pickaxe/plasma_drill,/obj/item/weapon/plastique/covenant,/obj/item/weapon/plastique/covenant,/obj/item/weapon/plastique/covenant,/obj/item/weapon/plastique/covenant,/obj/item/weapon/pickaxe/plasma_drill,/obj/item/weapon/plastique/covenant,/obj/item/weapon/plastique/covenant,/obj/item/weapon/plastique/covenant,/obj/item/weapon/plastique/covenant,/obj/structure/closet/crate/covenant{name = "Breaching Crate"},/obj/item/weapon/pickaxe/plasma_drill,/obj/item/weapon/plastique/covenant,/obj/item/weapon/plastique/covenant,/obj/item/weapon/plastique/covenant,/obj/item/weapon/plastique/covenant,/turf/simulated/floor/covenant{icon_state = "cov_floor"},/area/om_ships/cov_ert)
"uX" = (/obj/structure/closet/crate/covenant{name = "Plasma Pistols Crate"},/obj/item/weapon/gun/energy/plasmapistol,/obj/item/weapon/gun/energy/plasmapistol,/obj/item/weapon/gun/energy/plasmapistol,/obj/item/weapon/gun/energy/plasmapistol,/obj/item/weapon/gun/energy/plasmapistol,/obj/item/weapon/gun/energy/plasmapistol,/obj/item/weapon/gun/energy/plasmapistol,/obj/item/weapon/gun/energy/plasmapistol,/obj/item/weapon/gun/energy/plasmapistol,/obj/item/weapon/gun/energy/plasmapistol,/turf/simulated/floor/covenant{tag = "icon-cov_floor"; icon_state = "cov_floor"},/area/om_ships/cov_ert)
"vH" = (/obj/machinery/computer/helm{icon = 'code/modules/halo/icons/machinery/covenant/consoles.dmi'; icon_keyboard = ""; icon_screen = "covie_console_overlay"; icon_state = "covie_console_off"},/turf/simulated/floor/covenant{icon_state = "cov_floor"},/area/om_ships/cov_ert)
"wW" = (/obj/item/device/multitool/covenant,/obj/item/device/multitool/covenant,/obj/item/device/multitool/covenant,/obj/structure/table/rack,/turf/simulated/floor/covenant{tag = "icon-cov_floor"; icon_state = "cov_floor"},/area/om_ships/cov_ert)
"xJ" = (/obj/structure/closet/crate/covenant,/turf/simulated/floor/covenant{icon_state = "cov_floor"},/area/om_ships/cov_ert)
"Bg" = (/obj/machinery/repulsor_engine{dir = 8},/turf/simulated/floor/covenant{icon_state = "cov_floor"},/area/om_ships/cov_ert)
"Bk" = (/obj/structure/bed/chair/covenant_stool,/obj/machinery/light/covenant/west,/turf/simulated/floor/covenant{icon_state = "cov_floor"},/area/om_ships/cov_ert)
"Bz" = (/obj/structure/window/reinforced/projresist/covenant{tag = "icon-window (EAST)"; icon_state = "window"; dir = 4},/turf/simulated/floor/covenant{icon_state = "cov_floor"},/area/om_ships/cov_ert)
"BE" = (/obj/structure/closet/crate/covenant{name = "Mauler Crate"},/obj/item/weapon/gun/projectile/mauler,/obj/item/weapon/gun/projectile/mauler,/obj/item/weapon/gun/projectile/mauler,/obj/item/ammo_magazine/mauler,/obj/item/ammo_magazine/mauler,/obj/item/ammo_magazine/mauler,/obj/item/ammo_magazine/mauler,/obj/item/ammo_magazine/mauler,/obj/item/ammo_magazine/mauler,/obj/item/ammo_magazine/mauler,/obj/item/ammo_magazine/mauler,/obj/item/ammo_magazine/mauler,/obj/item/ammo_magazine/mauler,/obj/item/ammo_magazine/mauler,/obj/item/ammo_magazine/mauler,/obj/item/ammo_magazine/mauler,/obj/item/ammo_magazine/mauler,/obj/item/ammo_magazine/mauler,/turf/simulated/floor/covenant{icon_state = "cov_floor"},/area/om_ships/cov_ert)
"Ch" = (/obj/machinery/telecomms/allinone{tag = "icon-covie_console_off"; name = "Battlenet Server Hub"; icon = 'code/modules/halo/icons/machinery/covenant/consoles.dmi'; icon_state = "covie_console_off"},/turf/simulated/floor/covenant{icon_state = "cov_floor"},/area/om_ships/cov_ert)
"Du" = (/obj/item/weapon/weldingtool/covenant,/obj/item/weapon/weldingtool/covenant,/obj/item/weapon/weldingtool/covenant,/obj/structure/table/rack,/turf/simulated/floor/covenant{tag = "icon-cov_floor"; icon_state = "cov_floor"},/area/om_ships/cov_ert)
"EI" = (/obj/item/weapon/screwdriver/covenant,/obj/item/weapon/screwdriver/covenant,/obj/item/weapon/screwdriver/covenant,/obj/structure/table/rack,/turf/simulated/floor/covenant{icon_state = "cov_floor"},/area/om_ships/cov_ert)
"Gn" = (/obj/effect/hull_segment,/turf/simulated/wall/covenant,/area/om_ships/cov_ert)
"GR" = (/obj/structure/window/reinforced/projresist/covenant,/obj/structure/window/reinforced/projresist/covenant{tag = "icon-window (EAST)"; icon_state = "window"; dir = 4},/turf/simulated/floor/covenant{icon_state = "cov_floor"},/area/om_ships/cov_ert)
"If" = (/obj/machinery/light/covenant/south,/obj/machinery/nav_computer/npc/covenant,/turf/simulated/floor/covenant{icon_state = "cov_floor"},/area/om_ships/cov_ert)
"Il" = (/obj/machinery/light/invis,/obj/item/weapon/gun/projectile/type31needlerifle,/obj/item/ammo_magazine/rifleneedlepack,/obj/item/ammo_magazine/rifleneedlepack,/obj/item/ammo_magazine/rifleneedlepack,/obj/item/ammo_magazine/rifleneedlepack,/obj/item/ammo_magazine/rifleneedlepack,/obj/item/ammo_magazine/rifleneedlepack,/obj/item/weapon/gun/energy/beam_rifle,/obj/item/weapon/gun/projectile/type31needlerifle,/obj/item/ammo_magazine/rifleneedlepack,/obj/item/ammo_magazine/rifleneedlepack,/obj/item/ammo_magazine/rifleneedlepack,/obj/item/ammo_magazine/rifleneedlepack,/obj/item/ammo_magazine/rifleneedlepack,/obj/item/ammo_magazine/rifleneedlepack,/obj/item/weapon/gun/energy/beam_rifle,/obj/structure/closet/covenant{name = "Needle Rifle Rack"},/obj/item/weapon/gun/projectile/type31needlerifle,/obj/item/ammo_magazine/rifleneedlepack,/obj/item/ammo_magazine/rifleneedlepack,/obj/item/ammo_magazine/rifleneedlepack,/obj/item/ammo_magazine/rifleneedlepack,/obj/item/ammo_magazine/rifleneedlepack,/obj/item/ammo_magazine/rifleneedlepack,/obj/item/weapon/gun/energy/beam_rifle,/turf/simulated/floor/covenant{tag = "icon-cov_floor"; icon_state = "cov_floor"},/area/om_ships/cov_ert)
"In" = (/obj/item/weapon/gun/projectile/fuel_rod_launcher,/obj/item/weapon/gun/projectile/fuel_rod_launcher,/obj/item/weapon/gun/projectile/fuel_rod_launcher,/obj/structure/closet/covenant{name = "Fuel Rod Cannon Rack"},/obj/item/ammo_magazine/fuel_rod,/obj/item/ammo_magazine/fuel_rod,/obj/item/ammo_magazine/fuel_rod,/obj/item/ammo_magazine/fuel_rod,/obj/item/ammo_magazine/fuel_rod,/obj/item/ammo_magazine/fuel_rod,/obj/item/ammo_magazine/fuel_rod,/obj/item/ammo_magazine/fuel_rod,/obj/item/ammo_magazine/fuel_rod,/turf/simulated/floor/covenant{icon_state = "cov_floor"},/area/om_ships/cov_ert)
"Jh" = (/obj/structure/weapon_rack,/turf/simulated/floor/covenant{icon_state = "cov_floor"},/area/om_ships/cov_ert)
"JA" = (/obj/machinery/door/airlock/covenant{name = "Cockpit"},/turf/simulated/floor/covenant{icon_state = "cov_floor"},/area/om_ships/cov_ert)
"Kj" = (/obj/item/weapon/wirecutters/covenant,/obj/item/weapon/wirecutters/covenant,/obj/item/weapon/wirecutters/covenant,/obj/structure/table/rack,/turf/simulated/floor/covenant{tag = "icon-cov_floor"; icon_state = "cov_floor"},/area/om_ships/cov_ert)
"KC" = (/obj/machinery/light/covenant/east,/turf/simulated/floor/covenant{icon_state = "cov_floor"},/area/om_ships/cov_ert)
"KL" = (/obj/item/turret_deploy_kit/plasturret,/obj/item/turret_deploy_kit/plasturret,/obj/item/turret_deploy_kit/plasturret,/obj/item/turret_deploy_kit/plasturret,/obj/structure/closet/crate/covenant{name = "Mounted Gun Storage Crate"},/turf/simulated/floor/covenant{icon_state = "cov_floor"},/area/om_ships/cov_ert)
"KP" = (/obj/structure/bed/chair/covenant_stool,/obj/machinery/light/covenant/east,/turf/simulated/floor/covenant{icon_state = "cov_floor"},/area/om_ships/cov_ert)
"Mp" = (/obj/structure/closet/crate/covenant{name = "Spiker Crate"},/obj/item/weapon/gun/projectile/spiker,/obj/item/weapon/gun/projectile/spiker,/obj/item/weapon/gun/projectile/spiker,/obj/item/ammo_magazine/spiker,/obj/item/ammo_magazine/spiker,/obj/item/ammo_magazine/spiker,/obj/item/ammo_magazine/spiker,/obj/item/ammo_magazine/spiker,/obj/item/ammo_magazine/spiker,/obj/item/ammo_magazine/spiker,/obj/item/ammo_magazine/spiker,/obj/item/ammo_magazine/spiker,/obj/item/ammo_magazine/spiker,/obj/item/ammo_magazine/spiker,/obj/item/ammo_magazine/spiker,/obj/item/ammo_magazine/spiker,/obj/item/ammo_magazine/spiker,/obj/item/ammo_magazine/spiker,/turf/simulated/floor/covenant{icon_state = "cov_floor"},/area/om_ships/cov_ert)
"NP" = (/obj/machinery/light/covenant/north,/obj/machinery/telecomms/relay/long_range_emergency{icon = 'code/modules/halo/icons/machinery/covenant/consoles.dmi'; icon_state = "covie_console_off"},/turf/simulated/floor/covenant{icon_state = "cov_floor"},/area/om_ships/cov_ert)
"OB" = (/obj/structure/closet/crate/covenant{name = "Energy Sword Crate"},/obj/item/weapon/melee/energy/elite_sword,/obj/item/weapon/melee/energy/elite_sword,/obj/item/weapon/melee/energy/elite_sword,/obj/item/weapon/melee/energy/elite_sword,/obj/item/weapon/melee/energy/elite_sword,/obj/item/weapon/melee/energy/elite_sword,/obj/item/weapon/melee/energy/elite_sword,/obj/item/weapon/melee/energy/elite_sword,/obj/item/weapon/melee/energy/elite_sword,/turf/simulated/floor/covenant{icon_state = "cov_floor"},/area/om_ships/cov_ert)
"OV" = (/obj/item/weapon/crowbar/covenant,/obj/item/weapon/crowbar/covenant,/obj/item/weapon/crowbar/covenant,/obj/structure/table/rack,/turf/simulated/floor/covenant{tag = "icon-cov_floor"; icon_state = "cov_floor"},/area/om_ships/cov_ert)
"Ro" = (/obj/machinery/door/airlock/multi_tile/covenant/eastwest{name = "Cargo Hold"},/turf/simulated/floor/covenant{icon_state = "cov_floor"},/area/om_ships/cov_ert)
"Sr" = (/obj/structure/closet/crate/covenant{name = "Energy Daggers Crate"},/obj/item/weapon/melee/energy/elite_sword/dagger,/obj/item/weapon/melee/energy/elite_sword/dagger,/obj/item/weapon/melee/energy/elite_sword/dagger,/obj/item/weapon/melee/energy/elite_sword/dagger,/turf/simulated/floor/covenant{tag = "icon-cov_floor"; icon_state = "cov_floor"},/area/om_ships/cov_ert)
"Su" = (/obj/machinery/door/airlock/multi_tile/covenant{name = "Cargo Hold"},/turf/simulated/floor/covenant{icon_state = "cov_floor"},/area/om_ships/cov_ert)
"Sz" = (/obj/structure/closet/crate/covenant{name = "Armour Repair Kit Crate"},/obj/item/weapon/armor_patch/cov,/obj/item/weapon/armor_patch/cov,/obj/item/weapon/armor_patch/cov,/obj/item/weapon/armor_patch/cov,/obj/item/weapon/armor_patch/cov,/obj/item/weapon/armor_patch/cov,/turf/simulated/floor/covenant{tag = "icon-cov_floor"; icon_state = "cov_floor"},/area/om_ships/cov_ert)
"ST" = (/obj/structure/bed/chair/covenant_stool,/obj/machinery/power/apc/infinite{pixel_y = 32},/turf/simulated/floor/covenant{icon_state = "cov_floor"},/area/om_ships/cov_ert)
"Tk" = (/turf/simulated/floor/covenant{icon_state = "cov_floor"},/area/om_ships/cov_ert)
"Wv" = (/obj/structure/closet/crate/covenant{name = "Energy Stave Crate"},/obj/item/weapon/melee/energy/elite_sword/honour_staff,/obj/item/weapon/melee/energy/elite_sword/honour_staff,/obj/item/weapon/melee/energy/elite_sword/honour_staff,/obj/item/weapon/melee/energy/elite_sword/honour_staff,/obj/item/weapon/melee/energy/elite_sword/honour_staff,/obj/item/weapon/melee/energy/elite_sword/honour_staff,/obj/item/weapon/melee/energy/elite_sword/honour_staff,/obj/item/weapon/melee/energy/elite_sword/honour_staff,/obj/item/weapon/melee/energy/elite_sword/honour_staff,/turf/simulated/floor/covenant{icon_state = "cov_floor"},/area/om_ships/cov_ert)
"XE" = (/obj/machinery/door/airlock/multi_tile/covenant/eastwest{name = "Cockpit"},/turf/simulated/floor/covenant{icon_state = "cov_floor"},/area/om_ships/cov_ert)
"Yw" = (/obj/machinery/light/covenant/west,/turf/simulated/floor/covenant{icon_state = "cov_floor"},/area/om_ships/cov_ert)
"ZG" = (/turf/space,/area/space)

(1,1,1) = {"
ZGZGZGZGZGZGZGZGZGZGZGZGZGZGZGZGZGZGZGZGZGZGZGZGZGZGZGZGZGZGZGZGZGZGZGZGZGZGZGZGZGZGZGZGZGZGZGZGZGZG
ZGZGZGZGZGZGZGZGZGZGZGZGZGZGZGZGZGZGZGZGZGZGZGZGZGZGZGZGZGZGZGZGZGZGZGZGZGZGZGZGZGZGZGZGZGZGZGZGZGZG
ZGZGZGZGZGZGZGZGZGZGZGZGZGZGZGZGZGZGZGZGZGZGZGZGZGZGZGZGZGZGZGZGZGZGZGZGZGZGZGZGZGZGZGZGZGZGZGZGZGZG
ZGZGZGZGZGZGZGZGZGZGZGZGZGZGZGZGZGZGZGZGZGZGZGZGZGZGZGZGZGZGZGZGZGZGZGZGZGZGZGZGZGZGZGZGZGZGZGZGZGZG
ZGZGZGZGZGZGZGZGZGZGZGZGZGZGZGZGZGZGZGZGZGZGZGZGZGZGZGZGZGZGZGZGZGZGZGZGZGZGZGZGZGZGZGZGZGZGZGZGZGZG
ZGZGZGZGZGZGZGZGZGZGZGZGZGZGZGfSfSfSfSfSZGZGZGZGZGZGZGZGZGZGZGZGZGZGZGZGZGZGZGZGZGZGZGZGZGZGZGZGZGZG
ZGZGZGZGZGZGZGZGZGZGZGfSfSfSfSfSfSfSfSfSfSfSfSfSZGZGZGZGZGZGZGZGZGZGZGZGZGZGZGZGZGZGZGZGZGZGZGZGZGZG
ZGZGZGZGZGZGZGZGfSfSfSfSfSfSfSGnfStAfSfSfSfSfSfSfSfSfSfSfSZGZGZGZGZGZGZGZGZGZGZGZGZGZGZGZGZGZGZGZGZG
ZGZGZGZGZGZGZGfSfSfSfSfSfSfSfSTkTkTkTkTkfSfSfSfSfSfSGnfSfSfSfSfSfSfSfSfSZGZGZGZGZGZGZGZGZGZGZGZGZGZG
ZGZGZGZGZGZGfSfSfSfSfSfSfSfSiSTkTkTkTkTkiSfSfSfSsWSruXfSfSfSfSfSfSfSfSfSfSfSfSfSfSfSfSZGZGZGZGZGZGZG
ZGZGZGZGZGfSfSfSfSfSfSfSfSTkTkTkTkTkTkTkTkTkfSfSTkTkTkcsqnSzfSfSfSfSfSfSfSfSfSfSfSfSfSfSfSfSZGZGZGZG
ZGZGZGZGfSfSfSfSfSfSfSfSTkazTkTkTkTkTkTkazTkTkfSTkTkTkTkTkTkTkiSTkfSTkTkTkTkTkTkTkTkBzBgZGZGZGZGZGZG
ZGZGZGZGfSfSfSfSfSfSfSfSJAfSTkTkTkTkTkTkfSSuTkfSJhTkOVwWDuEIKjhBTkaITkTkazTkTkTkTkazBzBgZGZGZGZGZGZG
ZGZGZGZGfSfSfSfSNPChfSYwTkfSBkaAaAaAaAKPfSTkKCfSYwTkTkctTkTkTkTkTkfSfSfSfSfSfSfSfSfSfSGnZGZGZGZGZGZG
ZGZGZGZGfSfSvHSTTkTkTkTkTkfSfSfSfSfSfSfSfSTkTkTkTkTkTkWvBExJxJTkTkiShjtefSfSfSfSZGZGZGZGZGZGZGZGZGZG
ZGZGZGZGfSfSlcaATkTkXETkTkfSfSfSfSfSfSfSfSTkTkRoTkTkTkOBMpxJxJTkTkazgRGRfSfSfSfSZGZGZGZGZGZGZGZGZGZG
ZGZGZGZGfSfSfSfSIfikfSYwTkfSBkaAaAaAaAKPfSTkKCfSYwTkTkctTkTkTkTkTkfSfSfSfSfSfSfSfSfSfSGnZGZGZGZGZGZG
ZGZGZGZGfSfSfSfSfSfSfSfSJAfSTkTkTkTkTkTkfSSuTkfSJhTkjSIlInoOKLuSTkaITkTkiSTkTkTkTkiSBzBgZGZGZGZGZGZG
ZGZGZGZGfSfSfSfSfSfSfSfSTkiSTkTkTkTkTkTkiSTkTkfSTkTkTkTkTkTkTkazTkfSTkTkTkTkTkTkTkTkBzBgZGZGZGZGZGZG
ZGZGZGZGZGfSfSfSfSfSfSfSfSTkTkTkTkTkTkTkTkTkfSfSTkTkTkcsfISzfSfSfSfSfSfSfSfSfSfSfSfSfSfSfSfSZGZGZGZG
ZGZGZGZGZGZGfSfSfSfSfSfSfSfSazTkTkTkTkTkazfSfSfSsWSruXfSfSfSfSfSfSfSfSfSfSfSfSfSfSfSfSZGZGZGZGZGZGZG
ZGZGZGZGZGZGZGfSfSfSfSfSfSfSfSTkTkTkTkTkfSfSfSfSfSfSGnfSfSfSfSfSfSfSfSfSZGZGZGZGZGZGZGZGZGZGZGZGZGZG
ZGZGZGZGZGZGZGZGfSfSfSfSfSfSfSGnfSkrfSfSfSfSfSfSfSfSfSfSfSZGZGZGZGZGZGZGZGZGZGZGZGZGZGZGZGZGZGZGZGZG
ZGZGZGZGZGZGZGZGZGZGZGfSfSfSfSfSfSfSfSfSfSfSfSfSZGZGZGZGZGZGZGZGZGZGZGZGZGZGZGZGZGZGZGZGZGZGZGZGZGZG
ZGZGZGZGZGZGZGZGZGZGZGZGZGZGZGfSfSfSfSfSZGZGZGZGZGZGZGZGZGZGZGZGZGZGZGZGZGZGZGZGZGZGZGZGZGZGZGZGZGZG
ZGZGZGZGZGZGZGZGZGZGZGZGZGZGZGZGZGZGZGZGZGZGZGZGZGZGZGZGZGZGZGZGZGZGZGZGZGZGZGZGZGZGZGZGZGZGZGZGZGZG
ZGZGZGZGZGZGZGZGZGZGZGZGZGZGZGZGZGZGZGZGZGZGZGZGZGZGZGZGZGZGZGZGZGZGZGZGZGZGZGZGZGZGZGZGZGZGZGZGZGZG
ZGZGZGZGZGZGZGZGZGZGZGZGZGZGZGZGZGZGZGZGZGZGZGZGZGZGZGZGZGZGZGZGZGZGZGZGZGZGZGZGZGZGZGZGZGZGZGZGZGZG
ZGZGZGZGZGZGZGZGZGZGZGZGZGZGZGZGZGZGZGZGZGZGZGZGZGZGZGZGZGZGZGZGZGZGZGZGZGZGZGZGZGZGZGZGZGZGZGZGZGZG
ZGZGZGZGZGZGZGZGZGZGZGZGZGZGZGZGZGZGZGZGZGZGZGZGZGZGZGZGZGZGZGZGZGZGZGZGZGZGZGZGZGZGZGZGZGZGZGZGZGZG
"}