"aK" = (/obj/structure/bed/chair,/turf/simulated/floor/tiled,/area/om_ships/hum_ert)
"bc" = (/obj/structure/window/reinforced/treated{tag = "icon-fwindow (SOUTHWEST)"; icon_state = "fwindow"; dir = 10},/obj/structure/grille,/turf/simulated/floor/plating,/area/om_ships/hum_ert)
"bx" = (/obj/machinery/fusion_thruster/fueled{tag = "icon-nozzle1 (WEST)"; icon_state = "nozzle1"; dir = 8},/turf/simulated/floor/plating,/area/om_ships/hum_ert)
"cC" = (/obj/structure/window/reinforced/projresist{dir = 2; icon_state = "rwindow"; tag = "icon-rwindow (WEST)"},/obj/structure/window/reinforced/projresist{dir = 4; icon_state = "rwindow"; tag = "icon-rwindow (WEST)"},/obj/structure/window/reinforced/projresist{dir = 8; icon_state = "rwindow"; tag = "icon-rwindow (WEST)"},/obj/machinery/vending/armory/police{req_access = list()},/turf/simulated/floor/tiled/dark,/area/om_ships/hum_ert)
"eW" = (/obj/structure/window/reinforced/projresist{dir = 4; icon_state = "rwindow"; tag = "icon-rwindow (WEST)"},/obj/structure/window/reinforced/projresist{dir = 1; icon_state = "rwindow"; tag = "icon-rwindow (WEST)"},/obj/structure/window/reinforced/projresist{dir = 2; icon_state = "rwindow"; tag = "icon-rwindow (WEST)"},/obj/structure/grille,/turf/simulated/floor/tiled,/area/om_ships/hum_ert)
"iN" = (/obj/effect/floor_decal/industrial/warning/dust{tag = "icon-warning_dust (NORTH)"; icon_state = "warning_dust"; dir = 1},/obj/machinery/light/spot,/turf/simulated/floor/tiled,/area/om_ships/hum_ert)
"kg" = (/obj/machinery/light/spot{dir = 4},/turf/simulated/floor/tiled,/area/om_ships/hum_ert)
"mV" = (/obj/effect/hull_segment,/turf/simulated/wall/r_wall,/area/om_ships/hum_ert)
"na" = (/obj/structure/window/reinforced/projresist{tag = "icon-rwindow (WEST)"; icon_state = "rwindow"; dir = 8},/obj/machinery/light/spot{dir = 1},/turf/simulated/floor/tiled/dark,/area/om_ships/hum_ert)
"nI" = (/obj/structure/window/reinforced/projresist,/obj/structure/window/reinforced/projresist{tag = "icon-rwindow (EAST)"; icon_state = "rwindow"; dir = 4},/turf/simulated/floor/tiled,/area/om_ships/hum_ert)
"oi" = (/turf/simulated/floor/plating,/area/om_ships/hum_ert)
"ox" = (/obj/structure/window/reinforced/projresist{dir = 1; icon_state = "rwindow"; tag = "icon-rwindow (WEST)"},/obj/structure/window/reinforced/projresist{dir = 4; icon_state = "rwindow"; tag = "icon-rwindow (WEST)"},/obj/structure/window/reinforced/projresist{dir = 2; icon_state = "rwindow"; tag = "icon-rwindow (WEST)"},/obj/structure/grille,/turf/simulated/floor/tiled,/area/om_ships/hum_ert)
"pm" = (/obj/machinery/computer/navigation{tag = "icon-engine (WEST)"; icon = 'code/modules/halo/icons/machinery/computer.dmi'; icon_state = "engine"; dir = 8},/obj/structure/computerframe{anchored = 1; dir = 8; icon = 'code/modules/halo/icons/machinery/computer.dmi'; icon_state = "computer"; layer = 2; level = 1; tag = "icon-computer (WEST)"},/turf/simulated/floor/tiled,/area/om_ships/hum_ert)
"pA" = (/obj/effect/floor_decal/industrial/warning/dust/corner{tag = "icon-warningcorner_dust (WEST)"; icon_state = "warningcorner_dust"; dir = 8},/turf/simulated/floor/tiled,/area/om_ships/hum_ert)
"pH" = (/obj/structure/sign/warning/fall,/turf/simulated/wall/r_wall,/area/om_ships/hum_ert)
"pN" = (/obj/machinery/nav_computer/npc/unsc,/turf/simulated/floor/tiled,/area/om_ships/hum_ert)
"qP" = (/obj/effect/floor_decal/industrial/warning/dust{tag = "icon-warning_dust (WEST)"; icon_state = "warning_dust"; dir = 8},/obj/structure/window/reinforced/projresist{dir = 1; icon_state = "rwindow"; tag = "icon-rwindow (WEST)"},/obj/structure/window/reinforced/projresist{dir = 2; icon_state = "rwindow"; tag = "icon-rwindow (WEST)"},/obj/structure/window/reinforced/projresist{dir = 8; icon_state = "rwindow"; tag = "icon-rwindow (WEST)"},/obj/structure/grille,/turf/simulated/floor/tiled,/area/om_ships/hum_ert)
"rs" = (/obj/machinery/light/spot,/obj/effect/floor_decal/industrial/warning/dust/corner{tag = "icon-warningcorner_dust (EAST)"; icon_state = "warningcorner_dust"; dir = 4},/turf/simulated/floor/tiled,/area/om_ships/hum_ert)
"rx" = (/obj/structure/bed/chair/comfy/captain{tag = "icon-capchair_preview (WEST)"; icon_state = "capchair_preview"; dir = 8},/turf/simulated/floor/tiled,/area/om_ships/hum_ert)
"ry" = (/obj/structure/bed/chair,/obj/machinery/light/spot{dir = 1},/turf/simulated/floor/tiled,/area/om_ships/hum_ert)
"sk" = (/obj/effect/floor_decal/industrial/warning/dust{tag = "icon-warning_dust (EAST)"; icon_state = "warning_dust"; dir = 4},/turf/simulated/floor/tiled,/area/om_ships/hum_ert)
"sy" = (/obj/machinery/light/spot{dir = 1},/obj/effect/floor_decal/industrial/warning/dust,/turf/simulated/floor/tiled,/area/om_ships/hum_ert)
"ti" = (/obj/machinery/door/airlock/halo_maint,/turf/simulated/floor/tiled,/area/om_ships/hum_ert)
"tv" = (/obj/machinery/light/spot,/obj/effect/floor_decal/industrial/warning/dust{tag = "icon-warning_dust (NORTH)"; icon_state = "warning_dust"; dir = 1},/turf/simulated/floor/tiled,/area/om_ships/hum_ert)
"tA" = (/obj/structure/window/reinforced/projresist{dir = 1; icon_state = "rwindow"; tag = "icon-rwindow (WEST)"},/obj/structure/window/reinforced/projresist{dir = 2; icon_state = "rwindow"; tag = "icon-rwindow (WEST)"},/turf/simulated/floor/tiled,/area/om_ships/hum_ert)
"ug" = (/turf/simulated/floor/tiled/dark,/area/om_ships/hum_ert)
"uu" = (/obj/machinery/door/airlock/halo{name = "Bridge"},/turf/simulated/floor/tech,/area/om_ships/hum_ert)
"wb" = (/obj/structure/window/reinforced/projresist{dir = 2; icon_state = "rwindow"; tag = "icon-rwindow (WEST)"},/obj/structure/window/reinforced/projresist{dir = 1; icon_state = "rwindow"; tag = "icon-rwindow (WEST)"},/turf/simulated/floor/tiled,/area/om_ships/hum_ert)
"wd" = (/obj/structure/window/reinforced/projresist{dir = 8; icon_state = "rwindow"; tag = "icon-rwindow (WEST)"},/obj/structure/window/reinforced/projresist{dir = 4; icon_state = "rwindow"; tag = "icon-rwindow (WEST)"},/obj/structure/window/reinforced/projresist{dir = 2; icon_state = "rwindow"; tag = "icon-rwindow (WEST)"},/obj/structure/window/reinforced/projresist{dir = 1; icon_state = "rwindow"; tag = "icon-rwindow (WEST)"},/obj/structure/grille,/turf/simulated/floor/tiled,/area/om_ships/hum_ert)
"ws" = (/obj/structure/window/reinforced/projresist{dir = 2; icon_state = "rwindow"; tag = "icon-rwindow (WEST)"},/obj/structure/window/reinforced/projresist{dir = 1; icon_state = "rwindow"; tag = "icon-rwindow (WEST)"},/turf/simulated/floor/tiled/dark,/area/om_ships/hum_ert)
"wt" = (/obj/machinery/light/spot,/turf/simulated/floor/tiled,/area/om_ships/hum_ert)
"wK" = (/obj/machinery/light/spot{dir = 1},/obj/effect/floor_decal/industrial/warning/dust/corner,/turf/simulated/floor/tiled,/area/om_ships/hum_ert)
"xF" = (/obj/structure/window/reinforced/projresist{dir = 1; icon_state = "rwindow"; tag = "icon-rwindow (WEST)"},/obj/machinery/light/spot{dir = 4},/turf/simulated/floor/tiled/dark,/area/om_ships/hum_ert)
"yE" = (/turf/simulated/wall/r_wall,/area/om_ships/hum_ert)
"Af" = (/obj/effect/floor_decal/industrial/warning/dust{tag = "icon-warning_dust (WEST)"; icon_state = "warning_dust"; dir = 8},/obj/structure/window/reinforced/projresist{dir = 1; icon_state = "rwindow"; tag = "icon-rwindow (WEST)"},/obj/structure/window/reinforced/projresist{dir = 2; icon_state = "rwindow"; tag = "icon-rwindow (WEST)"},/turf/simulated/floor/tiled,/area/om_ships/hum_ert)
"Ao" = (/obj/machinery/light/spot{dir = 1},/obj/structure/window/reinforced/projresist{dir = 4; icon_state = "rwindow"; tag = "icon-rwindow (WEST)"},/obj/structure/window/reinforced/projresist{dir = 8; icon_state = "rwindow"; tag = "icon-rwindow (WEST)"},/obj/structure/window/reinforced/projresist{dir = 1; icon_state = "rwindow"; tag = "icon-rwindow (WEST)"},/obj/structure/window/reinforced/projresist{dir = 2; icon_state = "rwindow"; tag = "icon-rwindow (WEST)"},/obj/structure/grille,/turf/simulated/floor/tiled,/area/om_ships/hum_ert)
"Aq" = (/obj/structure/window/reinforced/projresist{dir = 2; icon_state = "rwindow"; tag = "icon-rwindow (WEST)"},/obj/machinery/light/spot{dir = 4},/turf/simulated/floor/tiled/dark,/area/om_ships/hum_ert)
"AK" = (/obj/machinery/light/spot,/obj/structure/window/reinforced/projresist{dir = 4; icon_state = "rwindow"; tag = "icon-rwindow (WEST)"},/obj/structure/window/reinforced/projresist{dir = 8; icon_state = "rwindow"; tag = "icon-rwindow (WEST)"},/obj/structure/window/reinforced/projresist{dir = 2; icon_state = "rwindow"; tag = "icon-rwindow (WEST)"},/obj/structure/window/reinforced/projresist{dir = 1; icon_state = "rwindow"; tag = "icon-rwindow (WEST)"},/obj/structure/grille,/turf/simulated/floor/tiled,/area/om_ships/hum_ert)
"BQ" = (/obj/structure/bed/chair{tag = "icon-chair_preview (NORTH)"; icon_state = "chair_preview"; dir = 1},/turf/simulated/floor/tiled,/area/om_ships/hum_ert)
"DX" = (/obj/structure/window/reinforced/projresist{dir = 1; icon_state = "rwindow"; tag = "icon-rwindow (WEST)"},/obj/structure/window/reinforced/projresist{dir = 8; icon_state = "rwindow"; tag = "icon-rwindow (WEST)"},/obj/structure/window/reinforced/projresist{dir = 4; icon_state = "rwindow"; tag = "icon-rwindow (WEST)"},/obj/machinery/vending/armory/commandovend/armour,/turf/simulated/floor/tiled/dark,/area/om_ships/hum_ert)
"Er" = (/obj/structure/sign/warning/moving_parts,/turf/simulated/wall/r_wall,/area/om_ships/hum_ert)
"Fv" = (/obj/effect/floor_decal/industrial/warning/dust/corner{tag = "icon-warningcorner_dust (NORTH)"; icon_state = "warningcorner_dust"; dir = 1},/turf/simulated/floor/tiled,/area/om_ships/hum_ert)
"Hk" = (/obj/structure/window/reinforced/projresist{dir = 1; icon_state = "rwindow"; tag = "icon-rwindow (WEST)"},/obj/machinery/light/spot{dir = 8},/turf/simulated/floor/tiled/dark,/area/om_ships/hum_ert)
"Hm" = (/obj/effect/floor_decal/industrial/warning/dust{tag = "icon-warning_dust (WEST)"; icon_state = "warning_dust"; dir = 8},/obj/structure/window/reinforced/projresist{dir = 8; icon_state = "rwindow"; tag = "icon-rwindow (WEST)"},/obj/structure/window/reinforced/projresist{dir = 2; icon_state = "rwindow"; tag = "icon-rwindow (WEST)"},/obj/structure/window/reinforced/projresist{dir = 1; icon_state = "rwindow"; tag = "icon-rwindow (WEST)"},/obj/structure/grille,/turf/simulated/floor/tiled,/area/om_ships/hum_ert)
"HG" = (/obj/machinery/power/apc/infinite{dir = 4; icon_state = "apc0"; pixel_x = 32; tag = "icon-apc0 (EAST)"},/obj/machinery/light/spot{dir = 4},/obj/structure/window/reinforced/projresist{tag = "icon-rwindow (EAST)"; icon_state = "rwindow"; dir = 4},/obj/machinery/door/window/northright,/turf/simulated/floor/tiled,/area/om_ships/hum_ert)
"Im" = (/obj/structure/window/reinforced/projresist{dir = 2; icon_state = "rwindow"; tag = "icon-rwindow (WEST)"},/obj/structure/window/reinforced/projresist{dir = 4; icon_state = "rwindow"; tag = "icon-rwindow (WEST)"},/obj/structure/window/reinforced/projresist{dir = 8; icon_state = "rwindow"; tag = "icon-rwindow (WEST)"},/obj/machinery/vending/armory/hybrid{req_access = list()},/turf/simulated/floor/tiled/dark,/area/om_ships/hum_ert)
"IK" = (/turf/space,/area/space)
"IQ" = (/obj/machinery/light/spot,/turf/simulated/floor/plating,/area/om_ships/hum_ert)
"IR" = (/obj/docking_umbilical/east{pixel_x = 0},/turf/simulated/wall/r_wall,/area/om_ships/hum_ert)
"IU" = (/obj/structure/bed/chair{tag = "icon-chair_preview (NORTH)"; icon_state = "chair_preview"; dir = 1},/obj/machinery/light/spot,/turf/simulated/floor/tiled,/area/om_ships/hum_ert)
"IX" = (/obj/structure/window/reinforced/projresist{dir = 2; icon_state = "rwindow"; tag = "icon-rwindow (WEST)"},/obj/machinery/light/spot{dir = 8},/turf/simulated/floor/tiled/dark,/area/om_ships/hum_ert)
"Jh" = (/obj/structure/window/reinforced/projresist{dir = 1; icon_state = "rwindow"; tag = "icon-rwindow (WEST)"},/obj/structure/window/reinforced/projresist{dir = 8; icon_state = "rwindow"; tag = "icon-rwindow (WEST)"},/obj/structure/window/reinforced/projresist{dir = 4; icon_state = "rwindow"; tag = "icon-rwindow (WEST)"},/obj/machinery/vending/armory/heavy{req_access = list()},/turf/simulated/floor/tiled/dark,/area/om_ships/hum_ert)
"Jz" = (/obj/machinery/telecomms/relay/ship_relay,/turf/simulated/floor/tiled,/area/om_ships/hum_ert)
"JQ" = (/obj/structure/window/reinforced/projresist{dir = 2; icon_state = "rwindow"; tag = "icon-rwindow (WEST)"},/obj/structure/window/reinforced/projresist{dir = 8; icon_state = "rwindow"; tag = "icon-rwindow (WEST)"},/obj/structure/window/reinforced/projresist{dir = 4; icon_state = "rwindow"; tag = "icon-rwindow (WEST)"},/obj/machinery/vending/armory/armor{req_access = list()},/turf/simulated/floor/tiled/dark,/area/om_ships/hum_ert)
"JZ" = (/obj/structure/window/reinforced/projresist{dir = 2; icon_state = "rwindow"; tag = "icon-rwindow (WEST)"},/turf/simulated/floor/tiled/dark,/area/om_ships/hum_ert)
"Ki" = (/obj/structure/window/reinforced/projresist{dir = 1; icon_state = "rwindow"; tag = "icon-rwindow (WEST)"},/turf/simulated/floor/tiled/dark,/area/om_ships/hum_ert)
"KH" = (/obj/structure/window/reinforced/projresist{dir = 2; icon_state = "rwindow"; tag = "icon-rwindow (WEST)"},/obj/structure/window/reinforced/projresist{dir = 4; icon_state = "rwindow"; tag = "icon-rwindow (WEST)"},/obj/structure/window/reinforced/projresist{dir = 8; icon_state = "rwindow"; tag = "icon-rwindow (WEST)"},/obj/machinery/vending/armory/armor,/turf/simulated/floor/tiled/dark,/area/om_ships/hum_ert)
"KK" = (/obj/machinery/slipspace_engine/human,/obj/structure/window/reinforced/projresist,/obj/structure/window/reinforced/projresist{tag = "icon-rwindow (WEST)"; icon_state = "rwindow"; dir = 8},/turf/simulated/floor/tiled,/area/om_ships/hum_ert)
"Lm" = (/obj/effect/floor_decal/industrial/warning/dust{tag = "icon-warning_dust (WEST)"; icon_state = "warning_dust"; dir = 8},/obj/structure/window/reinforced/projresist{dir = 8; icon_state = "rwindow"; tag = "icon-rwindow (WEST)"},/obj/structure/window/reinforced/projresist{dir = 1; icon_state = "rwindow"; tag = "icon-rwindow (WEST)"},/obj/structure/window/reinforced/projresist{dir = 2; icon_state = "rwindow"; tag = "icon-rwindow (WEST)"},/obj/structure/grille,/turf/simulated/floor/tiled,/area/om_ships/hum_ert)
"LE" = (/obj/structure/window/reinforced/projresist{dir = 2; icon_state = "rwindow"; tag = "icon-rwindow (WEST)"},/obj/structure/window/reinforced/projresist{dir = 4; icon_state = "rwindow"; tag = "icon-rwindow (WEST)"},/obj/structure/window/reinforced/projresist{dir = 8; icon_state = "rwindow"; tag = "icon-rwindow (WEST)"},/obj/machinery/vending/armory/odstvend{req_access = list()},/turf/simulated/floor/tiled/dark,/area/om_ships/hum_ert)
"Mg" = (/obj/machinery/light/spot{dir = 2},/turf/simulated/floor/tiled/dark,/area/om_ships/hum_ert)
"Mh" = (/obj/effect/floor_decal/industrial/warning/dust,/obj/machinery/light/spot{dir = 1},/turf/simulated/floor/tiled,/area/om_ships/hum_ert)
"MR" = (/obj/machinery/computer/helm{tag = "icon-nav (WEST)"; icon = 'code/modules/halo/icons/machinery/computer.dmi'; icon_state = "nav"; dir = 8; icon_keyboard = ""; icon_screen = "covie_console_overlay"},/obj/structure/computerframe{anchored = 1; dir = 8; icon = 'code/modules/halo/icons/machinery/computer.dmi'; icon_state = "computer"; layer = 2; level = 1; tag = "icon-computer (WEST)"},/turf/simulated/floor/tiled,/area/om_ships/hum_ert)
"Nj" = (/obj/effect/floor_decal/industrial/warning/dust,/turf/simulated/floor/tiled,/area/om_ships/hum_ert)
"NG" = (/obj/machinery/computer/engines{dir = 8; icon = 'code/modules/halo/icons/machinery/computer.dmi'; icon_state = "nav"; tag = "icon-nav (NORTH)"},/obj/structure/computerframe{anchored = 1; dir = 8; icon = 'code/modules/halo/icons/machinery/computer.dmi'; icon_state = "computer"; layer = 2; level = 1; tag = "icon-computer (WEST)"},/turf/simulated/floor/tiled,/area/om_ships/hum_ert)
"Ol" = (/obj/machinery/telecomms/relay/long_range_emergency,/turf/simulated/floor/tiled,/area/om_ships/hum_ert)
"Pl" = (/obj/structure/window/reinforced/projresist{dir = 1; icon_state = "rwindow"; tag = "icon-rwindow (WEST)"},/obj/structure/window/reinforced/projresist{dir = 8; icon_state = "rwindow"; tag = "icon-rwindow (WEST)"},/obj/structure/window/reinforced/projresist{dir = 4; icon_state = "rwindow"; tag = "icon-rwindow (WEST)"},/obj/machinery/vending/armory/police,/turf/simulated/floor/tiled/dark,/area/om_ships/hum_ert)
"Pp" = (/obj/structure/window/reinforced/projresist{dir = 4; icon_state = "rwindow"; tag = "icon-rwindow (WEST)"},/obj/structure/window/reinforced/projresist{dir = 2; icon_state = "rwindow"; tag = "icon-rwindow (WEST)"},/obj/structure/window/reinforced/projresist{dir = 1; icon_state = "rwindow"; tag = "icon-rwindow (WEST)"},/obj/structure/window/reinforced/projresist{dir = 4; icon_state = "rwindow"; tag = "icon-rwindow (WEST)"},/obj/structure/grille,/turf/simulated/floor/tiled,/area/om_ships/hum_ert)
"PR" = (/obj/machinery/light/spot{dir = 1},/turf/simulated/floor/plating,/area/om_ships/hum_ert)
"PW" = (/obj/machinery/light/spot{dir = 1},/turf/simulated/floor/tiled/dark,/area/om_ships/hum_ert)
"Rm" = (/obj/structure/window/reinforced/projresist{tag = "icon-rwindow (WEST)"; icon_state = "rwindow"; dir = 8},/obj/machinery/door/window/northleft,/turf/simulated/floor/tiled,/area/om_ships/hum_ert)
"RI" = (/obj/structure/window/reinforced/projresist{dir = 1; icon_state = "rwindow"; tag = "icon-rwindow (WEST)"},/obj/structure/window/reinforced/projresist{dir = 8; icon_state = "rwindow"; tag = "icon-rwindow (WEST)"},/obj/structure/window/reinforced/projresist{dir = 4; icon_state = "rwindow"; tag = "icon-rwindow (WEST)"},/obj/machinery/vending/armory/commandovend,/turf/simulated/floor/tiled/dark,/area/om_ships/hum_ert)
"Sg" = (/obj/effect/floor_decal/industrial/warning/dust{tag = "icon-warning_dust (NORTH)"; icon_state = "warning_dust"; dir = 1},/turf/simulated/floor/tiled,/area/om_ships/hum_ert)
"TR" = (/obj/structure/window/reinforced/projresist{tag = "icon-rwindow (WEST)"; icon_state = "rwindow"; dir = 8},/obj/machinery/light/spot{dir = 2},/turf/simulated/floor/tiled/dark,/area/om_ships/hum_ert)
"Ww" = (/turf/simulated/floor/tiled,/area/om_ships/hum_ert)
"XH" = (/obj/machinery/telecomms/allinone,/turf/simulated/floor/tiled,/area/om_ships/hum_ert)
"Yt" = (/obj/structure/window/reinforced/projresist{dir = 2; icon_state = "rwindow"; tag = "icon-rwindow (WEST)"},/obj/structure/window/reinforced/projresist{dir = 4; icon_state = "rwindow"; tag = "icon-rwindow (WEST)"},/obj/structure/window/reinforced/projresist{dir = 8; icon_state = "rwindow"; tag = "icon-rwindow (WEST)"},/obj/machinery/vending/armory/attachment{req_access = list()},/turf/simulated/floor/tiled/dark,/area/om_ships/hum_ert)
"YP" = (/obj/structure/window/reinforced/projresist{dir = 1; icon_state = "rwindow"; tag = "icon-rwindow (WEST)"},/obj/structure/window/reinforced/projresist{dir = 8; icon_state = "rwindow"; tag = "icon-rwindow (WEST)"},/obj/structure/window/reinforced/projresist{dir = 4; icon_state = "rwindow"; tag = "icon-rwindow (WEST)"},/obj/machinery/vending/armory/odstvend/vend_2{req_access = list()},/turf/simulated/floor/tiled/dark,/area/om_ships/hum_ert)
"Zk" = (/obj/machinery/light/spot{dir = 1},/turf/simulated/floor/tiled,/area/om_ships/hum_ert)

(1,1,1) = {"
IKIKIKIKIKIKIKIKIKIKIKIKIKIKIKIKIKIKIKIKIKIKIKIKIKIKIKIKIKIKIKIKIKIKIKIKIKIKIKIKIKIKIKIKIKIKIKIKIKIK
IKIKIKIKIKIKIKIKIKIKIKIKIKIKIKIKIKIKIKIKIKIKIKIKIKIKIKIKIKIKIKIKIKIKIKIKIKIKIKIKIKIKIKIKIKIKIKIKIKIK
IKIKIKIKIKIKIKIKIKIKIKIKIKIKIKIKIKIKIKIKIKIKIKIKIKIKIKIKIKIKIKIKIKIKIKIKIKIKIKIKIKIKIKIKIKIKIKIKIKIK
IKIKIKIKIKIKIKIKIKIKIKIKIKIKIKIKIKIKIKIKIKIKIKIKIKIKIKIKIKIKIKIKIKIKIKIKIKIKIKIKIKIKIKIKIKIKIKIKIKIK
IKIKIKIKIKIKIKIKIKIKIKIKIKIKIKIKIKIKIKIKIKIKIKIKyEyEyEyEyEyEyEyEIKIKIKyEyEyEyEyEyEyEyEyEyEIKIKIKIKIK
IKIKIKIKIKIKIKIKIKIKIKIKIKIKIKyEyEyEyEIKIKIKyEyEyEyEyEyEyEyEyEyEIKIKyEyEyEyEyEyEyEyEyEyEyEIKIKIKIKIK
IKIKIKIKIKIKIKIKIKIKIKIKIKIKyEyEoioibxIKIKyEyEyEyEyEyEyEyEyEyEyEIKIKyEmVPRoioioioioiPRoibxIKIKIKIKIK
IKIKIKIKIKIKIKIKIKIKIKIKIKIKyEPRoioibxIKIKyEyEyEyEyEyEyEyEyEyEyEIKIKyEyEoioioioioioioioibxIKIKIKIKIK
IKIKIKIKIKIKIKIKIKIKyEyEyEyEyEoiyEyEyEyEyEyEyEyEyEyEyEyEyEyEyEyEyEyEyEyEoioiyEyEyEyEyEyEyEIKIKIKIKIK
IKIKIKIKIKIKIKyEyEyEyEyEyEmVyEtiyEyEyEyEyEyEaKaKaKaKryaKaKaKaKyEyEyEyEyEtiyEyEyEIKIKIKIKIKIKIKIKIKIK
IKIKIKIKIKIKyEyEyEyEyEyEWwWwwKNjsyNjNjNjNjMhNjNjNjNjNjNjNjNjNjMhNjNjNjMhpAWwyEyEyEyEIKIKIKIKIKIKIKIK
IKIKIKIKbcbcyEyEOlJzXHyEWwWwskpHHkJhKiRIKiDXKiYPKiPlKiYPKiDXKiRIKiJhxFErqPoxyEAoWwyEyEIKIKIKIKIKIKIK
IKIKIKbcbcpmrxZkWwWwkgyEWwWwsknaugugugugugugugugugugugugugugugugugugugPWAfwbtitAWwyEyEIKIKIKIKIKIKIK
IKIKIKbcbcMRWwWwWwWwWwuuWwWwskwsugugugugugugugugugugugugugugugugugugugugLmeWyEwdWwyEyEIKIKIKIKIKIKIK
IKIKIKbcbcNGrxwtWwRmHGyEWwWwskTRugugugugugugugugugugugugugugugugugugugMgAfwbtitAWwIRyEIKIKIKIKIKIKIK
IKIKIKIKbcbcyEyEpNKKnIyEWwWwskErIXKHJZYtJZImJZLEJZcCJZLEJZImJZYtJZJQAqpHHmPpyEAKWwyEyEIKIKIKIKIKIKIK
IKIKIKIKIKIKyEyEyEyEyEyEWwWwrsSgtvSgSgSgSgiNSgSgSgSgSgSgSgSgSgiNSgSgSgiNFvWwyEyEyEyEIKIKIKIKIKIKIKIK
IKIKIKIKIKIKIKyEyEyEyEyEyEmVyEtiyEyEyEyEyEyEBQBQBQBQIUBQBQBQBQyEyEyEyEyEtiyEyEyEIKIKIKIKIKIKIKIKIKIK
IKIKIKIKIKIKIKIKIKIKyEyEyEyEyEoiyEyEyEyEyEyEyEyEyEyEyEyEyEyEyEyEyEyEyEyEoioiyEyEyEyEyEyEyEIKIKIKIKIK
IKIKIKIKIKIKIKIKIKIKIKIKIKIKyEIQoioibxIKIKyEyEyEyEyEyEyEyEyEyEyEIKIKyEyEoioioioioioioioibxIKIKIKIKIK
IKIKIKIKIKIKIKIKIKIKIKIKIKIKyEyEoioibxIKIKyEyEyEyEyEyEyEyEyEyEyEIKIKyEmVIQoioioioioiIQoibxIKIKIKIKIK
IKIKIKIKIKIKIKIKIKIKIKIKIKIKIKyEyEyEyEIKIKIKyEyEyEyEyEyEyEyEyEyEIKIKyEyEyEyEyEyEyEyEyEyEyEIKIKIKIKIK
IKIKIKIKIKIKIKIKIKIKIKIKIKIKIKIKIKIKIKIKIKIKIKIKyEyEyEyEyEyEyEyEIKIKIKyEyEyEyEyEyEyEyEyEyEIKIKIKIKIK
IKIKIKIKIKIKIKIKIKIKIKIKIKIKIKIKIKIKIKIKIKIKIKIKIKIKIKIKIKIKIKIKIKIKIKIKIKIKIKIKIKIKIKIKIKIKIKIKIKIK
IKIKIKIKIKIKIKIKIKIKIKIKIKIKIKIKIKIKIKIKIKIKIKIKIKIKIKIKIKIKIKIKIKIKIKIKIKIKIKIKIKIKIKIKIKIKIKIKIKIK
IKIKIKIKIKIKIKIKIKIKIKIKIKIKIKIKIKIKIKIKIKIKIKIKIKIKIKIKIKIKIKIKIKIKIKIKIKIKIKIKIKIKIKIKIKIKIKIKIKIK
IKIKIKIKIKIKIKIKIKIKIKIKIKIKIKIKIKIKIKIKIKIKIKIKIKIKIKIKIKIKIKIKIKIKIKIKIKIKIKIKIKIKIKIKIKIKIKIKIKIK
IKIKIKIKIKIKIKIKIKIKIKIKIKIKIKIKIKIKIKIKIKIKIKIKIKIKIKIKIKIKIKIKIKIKIKIKIKIKIKIKIKIKIKIKIKIKIKIKIKIK
IKIKIKIKIKIKIKIKIKIKIKIKIKIKIKIKIKIKIKIKIKIKIKIKIKIKIKIKIKIKIKIKIKIKIKIKIKIKIKIKIKIKIKIKIKIKIKIKIKIK
IKIKIKIKIKIKIKIKIKIKIKIKIKIKIKIKIKIKIKIKIKIKIKIKIKIKIKIKIKIKIKIKIKIKIKIKIKIKIKIKIKIKIKIKIKIKIKIKIKIK
"}

