"aa" = (/turf/unsimulated/floor/rock2{density = 1; opacity = 1},/area/asteroid_listening)
"ab" = (/turf/simulated/wall{icon = 'code/modules/halo/icons/turfs/walls.dmi'; icon_state = "riveted"; tag = "icon-cult"},/area/asteroid_listening/Interiorlevel2{tag = "icon-anomaly"; icon_state = "anomaly"; requires_power = 0})
"ac" = (/obj/item/modular_computer/telescreen,/turf/simulated/wall{icon = 'code/modules/halo/icons/turfs/walls.dmi'; icon_state = "riveted"; tag = "icon-cult"},/area/asteroid_listening/Interiorlevel2{tag = "icon-anomaly"; icon_state = "anomaly"; requires_power = 0})
"ad" = (/obj/structure/filingcabinet,/turf/simulated/floor/tiled/dark,/area/asteroid_listening/Interiorlevel2{tag = "icon-anomaly"; icon_state = "anomaly"; requires_power = 0})
"ae" = (/turf/simulated/floor/tiled/dark,/area/asteroid_listening/Interiorlevel2{tag = "icon-anomaly"; icon_state = "anomaly"; requires_power = 0})
"af" = (/obj/structure/closet{name = "Sandbags Closet"},/obj/item/empty_sandbags,/obj/item/empty_sandbags,/obj/item/empty_sandbags,/obj/item/weapon/shovel,/obj/item/weapon/shovel,/obj/item/empty_sandbags,/obj/item/empty_sandbags,/obj/item/empty_sandbags,/obj/item/empty_sandbags,/obj/item/empty_sandbags,/obj/item/empty_sandbags,/obj/item/empty_sandbags,/turf/simulated/floor/tiled/dark,/area/asteroid_listening/Interiorlevel2{tag = "icon-anomaly"; icon_state = "anomaly"; requires_power = 0})
"ag" = (/obj/structure/closet{name = "Barbed Wire Closet"},/obj/item/stack/barbedwire,/obj/item/stack/barbedwire,/obj/item/stack/barbedwire,/obj/item/stack/barbedwire,/obj/item/stack/barbedwire,/obj/item/stack/barbedwire,/obj/item/stack/barbedwire,/obj/item/stack/barbedwire,/obj/item/stack/barbedwire,/obj/item/stack/barbedwire,/turf/simulated/floor/tiled/dark,/area/asteroid_listening/Interiorlevel2{tag = "icon-anomaly"; icon_state = "anomaly"; requires_power = 0})
"ah" = (/obj/structure/closet/crate/large{icon_opened = "densecrate"; icon_state = "densecrate"; name = "Marine Armor"; tag = "icon-densecrate"},/obj/item/clothing/head/helmet/marine,/obj/item/clothing/head/helmet/marine,/obj/item/clothing/head/helmet/marine,/obj/item/clothing/head/helmet/marine,/obj/item/clothing/head/helmet/marine,/obj/item/clothing/head/helmet/marine,/obj/item/clothing/head/helmet/marine,/obj/item/clothing/head/helmet/marine,/obj/item/clothing/suit/storage/marine,/obj/item/clothing/suit/storage/marine,/obj/item/clothing/suit/storage/marine,/obj/item/clothing/suit/storage/marine,/obj/item/clothing/suit/storage/marine,/obj/item/clothing/suit/storage/marine,/turf/simulated/floor/tiled/dark,/area/asteroid_listening/Interiorlevel2{tag = "icon-anomaly"; icon_state = "anomaly"; requires_power = 0})
"ai" = (/obj/structure/closet/crate/large{icon_opened = "densecrate"; icon_state = "densecrate"; name = "Marine Boots"; tag = "icon-densecrate"},/obj/item/clothing/shoes/marine,/obj/item/clothing/shoes/marine,/obj/item/clothing/shoes/marine,/obj/item/clothing/shoes/marine,/obj/item/clothing/shoes/marine,/turf/simulated/floor/tiled/dark,/area/asteroid_listening/Interiorlevel2{tag = "icon-anomaly"; icon_state = "anomaly"; requires_power = 0})
"aj" = (/obj/structure/table/steel_reinforced,/obj/machinery/photocopier/faxmachine{department = "UEG Listening Post Sierra Golf Charlie 048"},/turf/simulated/floor/tiled/dark,/area/asteroid_listening/Interiorlevel2{tag = "icon-anomaly"; icon_state = "anomaly"; requires_power = 0})
"ak" = (/obj/machinery/computer/telecomms/server,/turf/simulated/floor/tiled/dark,/area/asteroid_listening/Interiorlevel2{tag = "icon-anomaly"; icon_state = "anomaly"; requires_power = 0})
"al" = (/obj/structure/table/steel_reinforced,/obj/item/weapon/clipboard,/obj/machinery/light{dir = 8},/turf/simulated/floor/tiled/dark,/area/asteroid_listening/Interiorlevel2{tag = "icon-anomaly"; icon_state = "anomaly"; requires_power = 0})
"am" = (/obj/structure/bed/chair/office/light,/turf/simulated/floor/tiled/dark,/area/asteroid_listening/Interiorlevel2{tag = "icon-anomaly"; icon_state = "anomaly"; requires_power = 0})
"an" = (/obj/structure/table/steel_reinforced,/obj/item/weapon/paper_bin,/obj/item/weapon/pen,/turf/simulated/floor/tiled/dark,/area/asteroid_listening/Interiorlevel2{tag = "icon-anomaly"; icon_state = "anomaly"; requires_power = 0})
"ao" = (/obj/machinery/overmap_weapon_console/npc_comms_console/unsc,/turf/simulated/floor/tiled/dark,/area/asteroid_listening/Interiorlevel2{tag = "icon-anomaly"; icon_state = "anomaly"; requires_power = 0})
"ap" = (/obj/structure/table/steel_reinforced,/obj/item/modular_computer/laptop/preset/custom_loadout/advanced{tag = "icon-laptop-closed"; icon_state = "laptop-closed"},/obj/machinery/light{dir = 4; icon_state = "tube1"},/turf/simulated/floor/tiled/dark,/area/asteroid_listening/Interiorlevel2{tag = "icon-anomaly"; icon_state = "anomaly"; requires_power = 0})
"aq" = (/obj/structure/filingcabinet,/obj/machinery/light{dir = 8},/turf/simulated/floor/tiled/dark,/area/asteroid_listening/Interiorlevel2{tag = "icon-anomaly"; icon_state = "anomaly"; requires_power = 0})
"ar" = (/obj/machinery/light{dir = 4},/turf/simulated/floor/tiled/dark,/area/asteroid_listening/Interiorlevel2{tag = "icon-anomaly"; icon_state = "anomaly"; requires_power = 0})
"as" = (/obj/machinery/light{dir = 8},/obj/item/weapon/storage/firstaid/unsc,/obj/item/weapon/storage/firstaid/unsc,/turf/simulated/floor/tiled/dark,/area/asteroid_listening/Interiorlevel2{tag = "icon-anomaly"; icon_state = "anomaly"; requires_power = 0})
"at" = (/obj/structure/closet/crate/freezer{desc = "A Portable freezer."; icon_opened = "phoroncrateopen"; icon_state = "phoroncrate"; name = "UNSC MRE Packs"; tag = "icon-phoroncrate"},/obj/item/weapon/reagent_containers/food/snacks/liquidfood,/obj/item/weapon/reagent_containers/food/snacks/liquidfood,/obj/item/weapon/reagent_containers/food/snacks/liquidfood,/obj/item/weapon/reagent_containers/food/snacks/liquidfood,/obj/item/weapon/reagent_containers/food/snacks/liquidfood,/obj/item/weapon/reagent_containers/food/snacks/liquidfood,/obj/item/weapon/reagent_containers/food/snacks/liquidfood,/obj/item/weapon/reagent_containers/food/snacks/liquidfood,/obj/item/weapon/reagent_containers/food/snacks/liquidfood,/obj/item/weapon/reagent_containers/food/snacks/liquidfood,/obj/item/weapon/reagent_containers/food/snacks/liquidfood,/obj/item/weapon/reagent_containers/food/snacks/liquidfood,/obj/item/weapon/reagent_containers/food/snacks/liquidfood,/obj/item/weapon/reagent_containers/food/snacks/liquidfood,/obj/item/weapon/reagent_containers/food/snacks/liquidfood,/obj/machinery/light{dir = 4},/turf/simulated/floor/tiled/dark,/area/asteroid_listening/Interiorlevel2{tag = "icon-anomaly"; icon_state = "anomaly"; requires_power = 0})
"au" = (/obj/structure/table/steel_reinforced,/turf/simulated/floor/tiled/dark,/area/asteroid_listening/Interiorlevel2{tag = "icon-anomaly"; icon_state = "anomaly"; requires_power = 0})
"av" = (/obj/structure/table/steel_reinforced,/obj/item/modular_computer/laptop/preset/custom_loadout/advanced{tag = "icon-laptop-closed"; icon_state = "laptop-closed"},/turf/simulated/floor/tiled/dark,/area/asteroid_listening/Interiorlevel2{tag = "icon-anomaly"; icon_state = "anomaly"; requires_power = 0})
"aw" = (/obj/structure/table/steel_reinforced,/obj/item/weapon/folder{tag = "icon-folder_blue"; icon_state = "folder_blue"},/turf/simulated/floor/tiled/dark,/area/asteroid_listening/Interiorlevel2{tag = "icon-anomaly"; icon_state = "anomaly"; requires_power = 0})
"ax" = (/obj/structure/table/steel_reinforced,/obj/item/weapon/clipboard,/turf/simulated/floor/tiled/dark,/area/asteroid_listening/Interiorlevel2{tag = "icon-anomaly"; icon_state = "anomaly"; requires_power = 0})
"ay" = (/obj/structure/closet/crate/large{icon_state = "secgearcrate"; name = "Glass Crate"; tag = "icon-secgearcrate"},/obj/item/stack/material/glass/fifty,/obj/item/stack/material/glass/fifty,/obj/item/stack/material/glass/fifty,/turf/simulated/floor/tiled/dark,/area/asteroid_listening/Interiorlevel2{tag = "icon-anomaly"; icon_state = "anomaly"; requires_power = 0})
"az" = (/obj/structure/closet/crate/freezer{desc = "A Portable freezer."; icon_opened = "phoroncrateopen"; icon_state = "phoroncrate"; name = "UNSC MRE Packs"; tag = "icon-phoroncrate"},/obj/item/weapon/reagent_containers/food/snacks/liquidfood,/obj/item/weapon/reagent_containers/food/snacks/liquidfood,/obj/item/weapon/reagent_containers/food/snacks/liquidfood,/obj/item/weapon/reagent_containers/food/snacks/liquidfood,/obj/item/weapon/reagent_containers/food/snacks/liquidfood,/obj/item/weapon/reagent_containers/food/snacks/liquidfood,/obj/item/weapon/reagent_containers/food/snacks/liquidfood,/obj/item/weapon/reagent_containers/food/snacks/liquidfood,/obj/item/weapon/reagent_containers/food/snacks/liquidfood,/obj/item/weapon/reagent_containers/food/snacks/liquidfood,/obj/item/weapon/reagent_containers/food/snacks/liquidfood,/obj/item/weapon/reagent_containers/food/snacks/liquidfood,/obj/item/weapon/reagent_containers/food/snacks/liquidfood,/obj/item/weapon/reagent_containers/food/snacks/liquidfood,/obj/item/weapon/reagent_containers/food/snacks/liquidfood,/turf/simulated/floor/tiled/dark,/area/asteroid_listening/Interiorlevel2{tag = "icon-anomaly"; icon_state = "anomaly"; requires_power = 0})
"aA" = (/obj/machinery/photocopier,/turf/simulated/floor/tiled/dark,/area/asteroid_listening/Interiorlevel2{tag = "icon-anomaly"; icon_state = "anomaly"; requires_power = 0})
"aB" = (/obj/machinery/light,/turf/simulated/floor/tiled/dark,/area/asteroid_listening/Interiorlevel2{tag = "icon-anomaly"; icon_state = "anomaly"; requires_power = 0})
"aC" = (/obj/structure/closet/crate/large{icon_state = "secgearcrate"; name = "Replacment Lights Crate"; tag = "icon-secgearcrate"},/obj/item/device/lightreplacer,/obj/item/weapon/storage/box/lights,/obj/item/weapon/storage/box/lights,/turf/simulated/floor/tiled/dark,/area/asteroid_listening/Interiorlevel2{tag = "icon-anomaly"; icon_state = "anomaly"; requires_power = 0})
"aD" = (/obj/structure/closet/crate/large{icon_state = "secgearcrate"; name = "Metal Crate"; tag = "icon-secgearcrate"},/obj/item/stack/material/steel/fifty,/obj/item/stack/material/steel/fifty,/obj/item/stack/material/steel/fifty,/obj/item/stack/material/steel/fifty,/obj/item/stack/material/steel/fifty,/turf/simulated/floor/tiled/dark,/area/asteroid_listening/Interiorlevel2{tag = "icon-anomaly"; icon_state = "anomaly"; requires_power = 0})
"aE" = (/obj/machinery/door/airlock/multi_tile/halo/blast{name = "Communications Center"; req_access = list(110)},/turf/simulated/floor/tiled/dark,/area/asteroid_listening/Interiorlevel2{tag = "icon-anomaly"; icon_state = "anomaly"; requires_power = 0})
"aF" = (/obj/machinery/door/airlock/halo{name = "Archive"},/turf/simulated/floor/tiled/dark,/area/asteroid_listening/Interiorlevel2{tag = "icon-anomaly"; icon_state = "anomaly"; requires_power = 0})
"aG" = (/obj/machinery/door/airlock/halo{name = "Storage"},/turf/simulated/floor/tiled/dark,/area/asteroid_listening/Interiorlevel2{tag = "icon-anomaly"; icon_state = "anomaly"; requires_power = 0})
"aH" = (/obj/machinery/light{dir = 1},/turf/simulated/floor/tiled/dark,/area/asteroid_listening/Interiorlevel2{tag = "icon-anomaly"; icon_state = "anomaly"; requires_power = 0})
"aI" = (/obj/machinery/door/airlock/multi_tile/halo/blast{dir = 1; icon_state = "door_closed"; name = "Communications Center Acces"; req_access = list(110); tag = "icon-door_closed (NORTH)"},/turf/simulated/floor/tiled/dark,/area/asteroid_listening/Interiorlevel2{tag = "icon-anomaly"; icon_state = "anomaly"; requires_power = 0})
"aJ" = (/obj/machinery/door/airlock/multi_tile/halo/blast{dir = 1; icon_state = "door_closed"; name = "Hangar"; req_access = list(110); tag = "icon-door_closed (NORTH)"},/turf/simulated/floor/tiled/dark,/area/asteroid_listening/Interiorlevel2{tag = "icon-anomaly"; icon_state = "anomaly"; requires_power = 0})
"aK" = (/obj/machinery/door/airlock/multi_tile/halo/blast{name = "Server Room"; req_access = list(110)},/turf/simulated/floor/tiled/dark,/area/asteroid_listening/Interiorlevel2{tag = "icon-anomaly"; icon_state = "anomaly"; requires_power = 0})
"aL" = (/obj/machinery/door/airlock/halo{name = "Weapons Locker"; req_access = list(110)},/turf/simulated/floor/tiled/dark,/area/asteroid_listening/Interiorlevel2{tag = "icon-anomaly"; icon_state = "anomaly"; requires_power = 0})
"aM" = (/obj/machinery/door/airlock/halo{name = "Acces Ladder"},/turf/simulated/floor/tiled/dark,/area/asteroid_listening/Interiorlevel2{tag = "icon-anomaly"; icon_state = "anomaly"; requires_power = 0})
"aN" = (/obj/machinery/message_server,/turf/simulated/floor/tiled/dark,/area/asteroid_listening/Interiorlevel2{tag = "icon-anomaly"; icon_state = "anomaly"; requires_power = 0})
"aO" = (/obj/machinery/telecomms/relay/preset/centcom,/obj/machinery/light{dir = 1},/turf/simulated/floor/tiled/dark,/area/asteroid_listening/Interiorlevel2{tag = "icon-anomaly"; icon_state = "anomaly"; requires_power = 0})
"aP" = (/obj/machinery/telecomms/hub/preset,/turf/simulated/floor/tiled/dark,/area/asteroid_listening/Interiorlevel2{tag = "icon-anomaly"; icon_state = "anomaly"; requires_power = 0})
"aQ" = (/obj/machinery/telecomms/processor/preset_cent,/obj/machinery/light{dir = 1},/turf/simulated/floor/tiled/dark,/area/asteroid_listening/Interiorlevel2{tag = "icon-anomaly"; icon_state = "anomaly"; requires_power = 0})
"aR" = (/obj/structure/table/rack{dir = 8; layer = 2.9},/obj/item/weapon/gun/projectile/m6d_magnum,/obj/item/weapon/gun/projectile/m6d_magnum,/obj/item/weapon/gun/projectile/m6d_magnum,/obj/item/weapon/gun/projectile/m6d_magnum,/turf/simulated/floor/tiled/dark,/area/asteroid_listening/Interiorlevel2{tag = "icon-anomaly"; icon_state = "anomaly"; requires_power = 0})
"aS" = (/obj/structure/table/rack{dir = 8; layer = 2.9},/obj/item/clothing/head/helmet/marine,/obj/item/clothing/head/helmet/marine,/obj/item/clothing/suit/storage/marine,/obj/item/clothing/suit/storage/marine,/obj/item/clothing/suit/storage/marine,/obj/item/clothing/suit/storage/marine,/obj/item/clothing/head/helmet/marine,/obj/item/clothing/head/helmet/marine,/turf/simulated/floor/tiled/dark,/area/asteroid_listening/Interiorlevel2{tag = "icon-anomaly"; icon_state = "anomaly"; requires_power = 0})
"aT" = (/obj/structure/ladder/up,/obj/machinery/light{tag = "icon-bulb0 (EAST)"; icon_state = "bulb0"; dir = 4},/turf/simulated/floor/tiled/dark,/area/asteroid_listening/Interiorlevel2{tag = "icon-anomaly"; icon_state = "anomaly"; requires_power = 0})
"aU" = (/obj/machinery/telecomms/bus/preset_cent,/turf/simulated/floor/tiled/dark,/area/asteroid_listening/Interiorlevel2{tag = "icon-anomaly"; icon_state = "anomaly"; requires_power = 0})
"aV" = (/obj/structure/table/rack{dir = 8; layer = 2.9},/obj/item/weapon/gun/projectile/ma5b_ar,/obj/item/weapon/gun/projectile/ma5b_ar,/obj/item/weapon/gun/projectile/ma5b_ar,/obj/item/weapon/gun/projectile/ma5b_ar,/turf/simulated/floor/tiled/dark,/area/asteroid_listening/Interiorlevel2{tag = "icon-anomaly"; icon_state = "anomaly"; requires_power = 0})
"aW" = (/obj/structure/table/rack{dir = 8; layer = 2.9},/obj/item/clothing/shoes/marine,/obj/item/clothing/shoes/marine,/obj/item/clothing/shoes/marine,/obj/item/clothing/shoes/marine,/obj/item/clothing/gloves/thick/unsc,/obj/item/clothing/gloves/thick/unsc,/obj/item/clothing/gloves/thick/unsc,/obj/item/clothing/gloves/thick/unsc,/turf/simulated/floor/tiled/dark,/area/asteroid_listening/Interiorlevel2{tag = "icon-anomaly"; icon_state = "anomaly"; requires_power = 0})
"aX" = (/obj/machinery/telecomms/broadcaster/preset_right,/obj/machinery/light,/turf/simulated/floor/tiled/dark,/area/asteroid_listening/Interiorlevel2{tag = "icon-anomaly"; icon_state = "anomaly"; requires_power = 0})
"aY" = (/obj/machinery/telecomms/broadcaster/preset_right,/turf/simulated/floor/tiled/dark,/area/asteroid_listening/Interiorlevel2{tag = "icon-anomaly"; icon_state = "anomaly"; requires_power = 0})
"aZ" = (/obj/machinery/telecomms/receiver/preset_cent,/turf/simulated/floor/tiled/dark,/area/asteroid_listening/Interiorlevel2{tag = "icon-anomaly"; icon_state = "anomaly"; requires_power = 0})
"ba" = (/obj/machinery/telecomms/server,/obj/machinery/light,/turf/simulated/floor/tiled/dark,/area/asteroid_listening/Interiorlevel2{tag = "icon-anomaly"; icon_state = "anomaly"; requires_power = 0})
"bb" = (/obj/machinery/telecomms/allinone,/turf/simulated/floor/tiled/dark,/area/asteroid_listening/Interiorlevel2{tag = "icon-anomaly"; icon_state = "anomaly"; requires_power = 0})
"bc" = (/obj/structure/table/rack{dir = 8; layer = 2.9},/obj/item/ammo_magazine/m762_ap/MA5B,/obj/item/ammo_magazine/m762_ap/MA5B,/obj/item/ammo_magazine/m762_ap/MA5B,/obj/item/ammo_magazine/m762_ap/MA5B,/obj/item/ammo_magazine/m762_ap/MA5B,/obj/item/ammo_magazine/m762_ap/MA5B,/obj/item/ammo_magazine/m762_ap/MA5B,/obj/item/ammo_magazine/m762_ap/MA5B,/obj/item/ammo_magazine/m762_ap/MA5B,/obj/item/ammo_magazine/m762_ap/MA5B,/obj/item/ammo_magazine/m762_ap/MA5B,/obj/item/ammo_magazine/m762_ap/MA5B,/turf/simulated/floor/tiled/dark,/area/asteroid_listening/Interiorlevel2{tag = "icon-anomaly"; icon_state = "anomaly"; requires_power = 0})
"bd" = (/obj/structure/table/rack{dir = 8; layer = 2.9},/obj/item/ammo_magazine/m127_saphe,/obj/item/ammo_magazine/m127_saphe,/obj/item/ammo_magazine/m127_saphe,/obj/item/ammo_magazine/m127_saphe,/obj/item/ammo_magazine/m127_saphe,/obj/item/ammo_magazine/m127_saphe,/obj/item/ammo_magazine/m127_saphe,/obj/item/ammo_magazine/m127_saphe,/obj/item/ammo_magazine/m127_saphe,/obj/item/ammo_magazine/m127_saphe,/obj/item/ammo_magazine/m127_saphe,/obj/item/ammo_magazine/m127_saphe,/turf/simulated/floor/tiled/dark,/area/asteroid_listening/Interiorlevel2{tag = "icon-anomaly"; icon_state = "anomaly"; requires_power = 0})

(1,1,1) = {"
aaaaaaaaaaaaaaaaaaaaaaaaaaaaaaaaaaaaaaaaaaaaaaaaaaaaaaaaaaaaaaaaaaaaaaaaaaaaaaaaaaaaaaaaaaaaaaaaaaaa
aaaaaaaaaaaaaaaaaaaaaaaaaaaaaaaaaaaaaaaaaaaaaaaaaaaaaaaaaaaaaaaaaaaaaaaaaaaaaaaaaaaaaaaaaaaaaaaaaaaa
aaaaaaaaaaaaaaaaaaaaaaaaaaaaaaaaaaaaaaaaaaaaaaaaaaaaaaaaaaaaaaaaaaaaaaaaaaaaaaaaaaaaaaaaaaaaaaaaaaaa
aaaaaaaaaaaaaaaaaaaaaaaaaaaaaaaaaaaaaaaaaaaaaaaaaaaaaaaaaaaaaaaaaaaaaaaaaaaaaaaaaaaaaaaaaaaaaaaaaaaa
aaaaaaaaaaaaaaaaaaaaaaaaaaaaaaaaaaaaaaaaaaaaaaaaaaaaaaaaaaaaaaaaaaaaaaaaaaaaaaaaaaaaaaaaaaaaaaaaaaaa
aaaaaaaaaaaaaaaaaaaaaaaaaaaaaaaaaaaaaaaaaaaaaaaaaaaaaaaaaaaaaaaaaaaaaaaaaaaaaaaaaaaaaaaaaaaaaaaaaaaa
aaaaaaaaaaaaaaaaaaaaaaaaaaaaaaaaaaaaaaaaaaaaaaaaaaaaaaaaaaaaaaaaaaaaaaaaaaaaaaaaaaaaaaaaaaaaaaaaaaaa
aaaaaaaaaaaaaaaaaaaaaaaaaaaaaaaaaaaaaaaaaaaaaaaaaaaaaaaaaaaaaaaaaaaaaaaaaaaaaaaaaaaaaaaaaaaaaaaaaaaa
aaaaaaaaaaaaaaaaaaaaaaaaaaaaaaaaaaaaaaaaaaaaaaaaaaaaaaaaaaaaaaaaaaaaaaaaaaaaaaaaaaaaaaaaaaaaaaaaaaaa
aaaaaaaaaaaaaaaaaaaaaaaaaaaaaaaaaaaaaaaaaaaaaaaaaaaaaaaaaaaaaaaaaaaaaaaaaaaaaaaaaaaaaaaaaaaaaaaaaaaa
aaaaaaaaaaaaaaaaaaaaaaaaaaaaaaaaaaaaaaaaaaaaaaaaaaaaaaaaaaaaaaaaaaaaaaaaaaaaaaaaaaaaaaaaaaaaaaaaaaaa
aaaaaaaaaaaaaaaaaaaaaaaaaaaaaaaaaaaaaaaaaaaaaaaaaaaaaaaaaaaaaaaaaaaaaaaaaaaaaaaaaaaaaaaaaaaaaaaaaaaa
aaaaaaaaaaaaaaaaaaaaaaaaaaaaaaaaaaaaaaaaaaaaaaaaaaaaaaaaaaaaaaaaaaaaaaaaaaaaaaaaaaaaaaaaaaaaaaaaaaaa
aaaaaaaaaaaaaaaaaaaaaaaaaaaaaaaaaaaaaaaaaaaaaaaaaaaaaaaaaaaaaaaaaaaaaaaaaaaaaaaaaaaaaaaaaaaaaaaaaaaa
aaaaaaaaaaaaaaaaaaaaaaaaaaaaaaaaaaaaaaaaaaaaaaaaaaaaaaaaaaaaaaaaaaaaaaaaaaaaaaaaaaaaaaaaaaaaaaaaaaaa
aaaaaaaaaaaaaaaaaaaaaaaaaaaaaaaaaaaaaaaaaaaaaaaaaaaaaaaaaaaaaaaaaaaaaaaaaaaaaaaaaaaaaaaaaaaaaaaaaaaa
aaaaaaaaaaaaaaaaaaaaaaaaaaaaaaaaaaaaaaaaaaaaaaaaaaaaaaaaaaaaaaaaaaaaaaaaaaaaaaaaaaaaaaaaaaaaaaaaaaaa
aaaaaaaaaaaaaaaaaaaaaaaaaaaaaaaaaaaaaaaaaaaaaaaaaaaaaaaaaaaaaaaaaaaaaaaaaaaaaaaaaaaaaaaaaaaaaaaaaaaa
aaaaaaaaaaaaaaaaaaaaaaabababababababababababababababababababababababababaaaaaaaaaaaaaaaaaaaaaaaaaaaa
aaaaaaaaaaaaaaaaaaaaaaababacacacacacacacababababababadadadaeabafagahaiabaaaaaaaaaaaaaaaaaaaaaaaaaaaa
aaaaaaaaaaaaaaaaaaaaaaabajaeaeaeakaeaeaeajabababababaeaeaeaeabaeaeaeaeabaaaaaaaaaaaaaaaaaaaaaaaaaaaa
aaaaaaaaaaaaaaaaaaaaaaabalamanaeaeaeaoamapabababababaqadadarabasaeaeatabaaaaaaaaaaaaaaaaaaaaaaaaaaaa
aaaaaaaaaaaaaaaaaaaaaaabauavawaeaeaeauawaxabababababaeaeaeaeabayaeaeazabaaaaaaaaaaaaaaaaaaaaaaaaaaaa
aaaaaaaaaaaaaaaaaaaaaaabaAaeaBaeaeaeaeaBaAabababababadadadaeabaCaeaeaDabaaaaaaaaaaaaaaaaaaaaaaaaaaaa
aaaaaaaaaaaaaaaaaaaaaaabababababaEaeabababababababababababaFabababaGababaaaaaaaaaaaaaaaaaaaaaaaaaaaa
aaaaaaaaaaaaaaaaaaaaaaabaeaeaeaHaeaeaHaeaeaeaeaHaeaeaeaHaeaeaeaHaeaeaHabaaaaaaaaaaaaaaaaaaaaaaaaaaaa
aaaaaaaaaaaaaaaaaaaaaaabaeaeaeaeaeaeaeaeaeaIaeaeaeaJaeaeaeaeaeaeaeaeaeabaaaaaaaaaaaaaaaaaaaaaaaaaaaa
aaaaaaaaaaaaaaaaaaaaaaabababababaKaeabababababababababaLabababaMababababaaaaaaaaaaaaaaaaaaaaaaaaaaaa
aaaaaaaaaaaaaaaaaaaaaaabaNaeaOaPaeaeaeaQaPabababababaRaeaSababaTabaaaaaaaaaaaaaaaaaaaaaaaaaaaaaaaaaa
aaaaaaaaaaaaaaaaaaaaaaabaNaeaeaeaeaeaeaUaPabababababaVaeaWababababaaaaaaaaaaaaaaaaaaaaaaaaaaaaaaaaaa
aaaaaaaaaaaaaaaaaaaaaaabaNaeaXaYaZaZaebabbabababababbcaBbdabaaaaaaaaaaaaaaaaaaaaaaaaaaaaaaaaaaaaaaaa
aaaaaaaaaaaaaaaaaaaaaaabababababababababababababababababababaaaaaaaaaaaaaaaaaaaaaaaaaaaaaaaaaaaaaaaa
aaaaaaaaaaaaaaaaaaaaaaaaaaaaaaaaaaaaaaaaaaaaaaaaaaaaaaaaaaaaaaaaaaaaaaaaaaaaaaaaaaaaaaaaaaaaaaaaaaaa
aaaaaaaaaaaaaaaaaaaaaaaaaaaaaaaaaaaaaaaaaaaaaaaaaaaaaaaaaaaaaaaaaaaaaaaaaaaaaaaaaaaaaaaaaaaaaaaaaaaa
aaaaaaaaaaaaaaaaaaaaaaaaaaaaaaaaaaaaaaaaaaaaaaaaaaaaaaaaaaaaaaaaaaaaaaaaaaaaaaaaaaaaaaaaaaaaaaaaaaaa
aaaaaaaaaaaaaaaaaaaaaaaaaaaaaaaaaaaaaaaaaaaaaaaaaaaaaaaaaaaaaaaaaaaaaaaaaaaaaaaaaaaaaaaaaaaaaaaaaaaa
aaaaaaaaaaaaaaaaaaaaaaaaaaaaaaaaaaaaaaaaaaaaaaaaaaaaaaaaaaaaaaaaaaaaaaaaaaaaaaaaaaaaaaaaaaaaaaaaaaaa
aaaaaaaaaaaaaaaaaaaaaaaaaaaaaaaaaaaaaaaaaaaaaaaaaaaaaaaaaaaaaaaaaaaaaaaaaaaaaaaaaaaaaaaaaaaaaaaaaaaa
aaaaaaaaaaaaaaaaaaaaaaaaaaaaaaaaaaaaaaaaaaaaaaaaaaaaaaaaaaaaaaaaaaaaaaaaaaaaaaaaaaaaaaaaaaaaaaaaaaaa
aaaaaaaaaaaaaaaaaaaaaaaaaaaaaaaaaaaaaaaaaaaaaaaaaaaaaaaaaaaaaaaaaaaaaaaaaaaaaaaaaaaaaaaaaaaaaaaaaaaa
aaaaaaaaaaaaaaaaaaaaaaaaaaaaaaaaaaaaaaaaaaaaaaaaaaaaaaaaaaaaaaaaaaaaaaaaaaaaaaaaaaaaaaaaaaaaaaaaaaaa
aaaaaaaaaaaaaaaaaaaaaaaaaaaaaaaaaaaaaaaaaaaaaaaaaaaaaaaaaaaaaaaaaaaaaaaaaaaaaaaaaaaaaaaaaaaaaaaaaaaa
aaaaaaaaaaaaaaaaaaaaaaaaaaaaaaaaaaaaaaaaaaaaaaaaaaaaaaaaaaaaaaaaaaaaaaaaaaaaaaaaaaaaaaaaaaaaaaaaaaaa
aaaaaaaaaaaaaaaaaaaaaaaaaaaaaaaaaaaaaaaaaaaaaaaaaaaaaaaaaaaaaaaaaaaaaaaaaaaaaaaaaaaaaaaaaaaaaaaaaaaa
aaaaaaaaaaaaaaaaaaaaaaaaaaaaaaaaaaaaaaaaaaaaaaaaaaaaaaaaaaaaaaaaaaaaaaaaaaaaaaaaaaaaaaaaaaaaaaaaaaaa
aaaaaaaaaaaaaaaaaaaaaaaaaaaaaaaaaaaaaaaaaaaaaaaaaaaaaaaaaaaaaaaaaaaaaaaaaaaaaaaaaaaaaaaaaaaaaaaaaaaa
aaaaaaaaaaaaaaaaaaaaaaaaaaaaaaaaaaaaaaaaaaaaaaaaaaaaaaaaaaaaaaaaaaaaaaaaaaaaaaaaaaaaaaaaaaaaaaaaaaaa
aaaaaaaaaaaaaaaaaaaaaaaaaaaaaaaaaaaaaaaaaaaaaaaaaaaaaaaaaaaaaaaaaaaaaaaaaaaaaaaaaaaaaaaaaaaaaaaaaaaa
aaaaaaaaaaaaaaaaaaaaaaaaaaaaaaaaaaaaaaaaaaaaaaaaaaaaaaaaaaaaaaaaaaaaaaaaaaaaaaaaaaaaaaaaaaaaaaaaaaaa
aaaaaaaaaaaaaaaaaaaaaaaaaaaaaaaaaaaaaaaaaaaaaaaaaaaaaaaaaaaaaaaaaaaaaaaaaaaaaaaaaaaaaaaaaaaaaaaaaaaa
"}
